id,price,bedrooms,bathrooms,sqft_living,sqft_lot,floors,sqft_above,sqft_basement,yr_built
7129300520,221900,3,1,1180,5650,1,1180,0,1955
6414100192,538000,3,2.25,2570,7242,2,2170,400,1951
5631500400,180000,2,1,770,10000,1,770,0,1933
2487200875,604000,4,3,1960,5000,1,1050,910,1965
1954400510,510000,3,2,1680,8080,1,1680,0,1987
7237550310,1.225e+006,4,4.5,5420,101930,1,3890,1530,2001
1321400060,257500,3,2.25,1715,6819,2,1715,0,1995
2008000270,291850,3,1.5,1060,9711,1,1060,0,1963
2414600126,229500,3,1,1780,7470,1,1050,730,1960
3793500160,323000,3,2.5,1890,6560,2,1890,0,2003
1736800520,662500,3,2.5,3560,9796,1,1860,1700,1965
9212900260,468000,2,1,1160,6000,1,860,300,1942
0114101516,310000,3,1,1430,19901,1.5,1430,0,1927
6054650070,400000,3,1.75,1370,9680,1,1370,0,1977
1175000570,530000,5,2,1810,4850,1.5,1810,0,1900
9297300055,650000,4,3,2950,5000,2,1980,970,1979
1875500060,395000,3,2,1890,14040,2,1890,0,1994
6865200140,485000,4,1,1600,4300,1.5,1600,0,1916
0016000397,189000,2,1,1200,9850,1,1200,0,1921
7983200060,230000,3,1,1250,9774,1,1250,0,1969
6300500875,385000,4,1.75,1620,4980,1,860,760,1947
2524049179,2e+006,3,2.75,3050,44867,1,2330,720,1968
7137970340,285000,5,2.5,2270,6300,2,2270,0,1995
8091400200,252700,2,1.5,1070,9643,1,1070,0,1985
3814700200,329000,3,2.25,2450,6500,2,2450,0,1985
1202000200,233000,3,2,1710,4697,1.5,1710,0,1941
1794500383,937000,3,1.75,2450,2691,2,1750,700,1915
3303700376,667000,3,1,1400,1581,1.5,1400,0,1909
5101402488,438000,3,1.75,1520,6380,1,790,730,1948
1873100390,719000,4,2.5,2570,7173,2,2570,0,2005
8562750320,580500,3,2.5,2320,3980,2,2320,0,2003
2426039314,280000,2,1.5,1190,1265,3,1190,0,2005
0461000390,687500,4,1.75,2330,5000,1.5,1510,820,1929
7589200193,535000,3,1,1090,3000,1.5,1090,0,1929
7955080270,322500,4,2.75,2060,6659,1,1280,780,1981
9547205180,696000,3,2.5,2300,3060,1.5,1510,790,1930
9435300030,550000,4,1,1660,34848,1,930,730,1933
2768000400,640000,4,2,2360,6000,2,2360,0,1904
7895500070,240000,4,1,1220,8075,1,890,330,1969
2078500320,605000,4,2.5,2620,7553,2,2620,0,1996
5547700270,625000,4,2.5,2570,5520,2,2570,0,2000
7766200013,775000,4,2.25,4220,24186,1,2600,1620,1984
7203220400,861990,5,2.75,3595,5639,2,3595,0,2014
9270200160,685000,3,1,1570,2280,2,1570,0,1922
1432701230,309000,3,1,1280,9656,1,920,360,1959
8035350320,488000,3,2.5,3160,13603,2,3160,0,2003
8945200830,210490,3,1,990,8528,1,990,0,1966
4178300310,785000,4,2.5,2290,13416,2,2290,0,1981
9215400105,450000,3,1.75,1250,5963,1,1250,0,1953
0822039084,1.35e+006,3,2.5,2753,65005,1,2165,588,1953
5245600105,228000,3,1,1190,9199,1,1190,0,1955
7231300125,345000,5,2.5,3150,9134,1,1640,1510,1966
7518505990,600000,3,1.75,1410,4080,1,1000,410,1950
3626039271,585000,2,1.75,1980,8550,1,990,990,1981
4217401195,920000,5,2.25,2730,6000,1.5,2130,600,1927
9822700295,885000,4,2.5,2830,5000,2,2830,0,1995
9478500640,292500,4,2.5,2250,4495,2,2250,0,2008
2799800710,301000,3,2.5,2420,4750,2,2420,0,2003
7922800400,951000,5,3.25,3250,14342,2,3250,0,1968
8079040320,430000,4,3,1850,9976,2,1850,0,1991
1516000055,650000,3,2.25,2150,21235,1,1590,560,1959
9558200045,289000,3,1.75,1260,8400,1,1260,0,1954
5072410070,505000,3,1.75,2519,8690,2,2519,0,1973
9528102996,549000,3,1.75,1540,1044,3,1540,0,2014
1189001180,425000,3,2.25,1660,6000,1,1110,550,1979
3253500160,317625,3,2.75,2770,3809,1.5,1770,1000,1925
3394100030,975000,4,2.5,2720,11049,2,2720,0,1989
3717000160,287000,4,2.5,2240,4648,2,2240,0,2005
1274500060,204000,3,1,1000,12070,1,1000,0,1968
1802000060,1.325e+006,5,2.25,3200,20158,1,1600,1600,1965
1525059190,1.04e+006,5,3.25,4770,50094,1,3070,1700,1973
1049000060,325000,3,2,1260,5612,1,1260,0,1972
8820901275,571000,4,2,2750,7807,1.5,2250,500,1916
5416510140,360000,4,2.5,2380,5000,2,2380,0,2005
3444100400,349000,3,1.75,1790,50529,1,1090,700,1965
3276920270,832500,4,4,3430,35102,2,2390,1040,1986
4036801170,380000,4,1.75,1760,7300,1,880,880,1956
2391600320,480000,3,1,1040,5060,1,1040,0,1941
6300000287,410000,3,1,1410,5060,1,910,500,1956
1531000030,720000,4,2.5,3450,39683,2,3450,0,2002
5104520400,390000,3,2.5,2350,5100,2,2350,0,2003
7437100340,360000,4,2.5,1900,5889,2,1900,0,1992
9418400240,355000,2,1,2020,6720,1,1010,1010,1948
1523059105,356000,3,1.5,1680,8712,1,1680,0,1964
1133000671,315000,3,1,960,6634,1,960,0,1952
4232902595,940000,3,1.5,2140,3600,2,1900,240,1925
2599001200,305000,5,2.25,2660,8400,1.5,2660,0,1961
3342103156,461000,3,3.25,2770,6278,2,1980,790,2006
1332700270,215000,2,2.25,1610,2040,2,1610,0,1979
3869900162,335000,2,1.75,1030,1066,2,765,265,2006
2791500270,243500,4,2.5,1980,7403,2,1980,0,1988
5036300431,1.09988e+006,5,2.75,3520,6353,2,3520,0,2001
4168000060,153000,3,1,1200,10500,1,1200,0,1962
6021501535,430000,3,1.5,1580,5000,1,1290,290,1939
6021501535,700000,3,1.5,1580,5000,1,1290,290,1939
1483300570,905000,4,2.5,3300,10250,1,2390,910,1946
3422049190,247500,3,1.75,1960,15681,1,1960,0,1967
1099611230,199000,4,1.5,1160,6400,1,1160,0,1975
0722079104,314000,3,1.75,1810,41800,1,1210,600,1980
7338200240,437500,3,2.5,2320,36847,2,2320,0,1992
1952200240,850830,3,2.5,2070,13241,1.5,1270,800,1910
5200100125,555000,3,2,1980,3478,1.5,1440,540,1929
7214720075,699950,3,2.25,2190,107593,2,2190,0,1983
2450000295,1.088e+006,3,2.5,2920,8113,2,2920,0,1950
6197800045,290000,3,1,1210,33919,1,1210,0,1954
1328310370,375000,3,2.5,2340,10005,1,1460,880,1978
0546000875,460000,3,1,1670,4005,1.5,1170,500,1939
3530510041,188500,2,1.75,1240,2493,1,1240,0,1985
1853000400,680000,4,2.5,3140,28037,2,3140,0,1991
3134100116,470000,5,1.75,2030,12342,2,2030,0,1942
9545230140,597750,4,2.5,2310,9624,2,2310,0,1984
3362400511,570000,3,1.75,1260,3328,1,700,560,1905
2525310310,272500,3,1.75,1540,12600,1,1160,380,1980
6126500060,329950,3,1.75,2080,5969,1,1080,1000,1971
8961960160,480000,4,2.5,3230,16171,2,2520,710,2001
3626039325,740500,3,3.5,4380,6350,2,2780,1600,1900
3362400431,518500,3,3.5,1590,1102,3,1590,0,2010
4060000240,205425,2,1,880,6780,1,880,0,1945
3454800060,171800,4,2,1570,9600,1,1570,0,1950
1695900060,535000,4,1,1610,2982,1.5,1610,0,1925
7278700070,660000,3,2.5,2400,6474,1,1560,840,1964
6675500070,391500,3,2,1450,9132,1,1450,0,1987
3626039187,395000,2,1,770,6000,1,770,0,1953
3524049083,445000,4,1.75,2100,4400,1.5,1720,380,1924
3275860240,770000,3,2.25,2910,10204,2,2910,0,1990
4389200955,1.45e+006,4,2.75,2750,17789,1.5,1980,770,1914
4058801670,445000,3,2.25,2100,8201,1,1620,480,1967
8732020310,260000,4,2.25,2160,8811,1,1360,800,1978
2331300505,822500,5,3.5,2320,4960,2,1720,600,1926
7853210060,430000,4,2.5,2070,4310,2,2070,0,2004
3668000070,212000,3,1.75,1060,7875,1,1060,0,1986
9545240070,660500,4,2.25,2010,9603,1,1440,570,1986
1243100136,784000,3,3.5,3950,111078,1.5,2460,1490,1989
8929000270,453246,3,2.5,2010,2287,2,1390,620,2014
2767602356,675000,4,3.5,2140,2278,3,2140,0,2005
0921049315,199000,3,1.75,1320,17390,1,1320,0,1956
3655000070,220000,4,1.75,2020,7840,1,1010,1010,1968
4027700812,452000,4,2.25,2590,10002,1,1340,1250,1968
3992700335,382500,2,1,1190,4440,1,1190,0,1981
2767603505,519950,3,2.25,1170,1249,3,1170,0,2014
4232901525,665000,2,1,1110,3200,1,1110,0,1925
1777500060,527700,5,2.5,2820,9375,1,1550,1270,1968
1432900240,205000,3,1,1610,8579,1,1010,600,1962
6140100875,420000,3,1,1060,8097,1,940,120,1923
6071600370,500000,4,2.25,2030,8517,1,1380,650,1961
1526069017,921500,4,2.5,3670,315374,2,3670,0,1994
0809001525,890000,4,1,2550,4000,2,2370,180,1905
3224079105,430000,2,2.5,2420,60984,2,2420,0,2007
8075400570,258000,5,2,2260,12500,1,1130,1130,1960
1994200024,511000,3,1,1430,3455,1,980,450,1947
3362900810,532170,3,2,1360,3090,2,1360,0,1990
1324300398,560000,3,1,1110,5000,1.5,1110,0,1947
0537000445,282950,3,1,1250,8200,1,1250,0,1954
7855801670,2.25e+006,4,3.25,5180,19850,2,3540,1640,2006
7920100045,350000,1,1,700,5100,1,700,0,1942
8960000030,215000,3,1,1180,7669,1,1180,0,1967
6388930390,650000,5,3.5,3960,25245,2,2500,1460,1996
8731900200,320000,4,2.75,2640,7500,1,1620,1020,1967
8029200135,247000,3,2,1270,7198,1.5,1270,0,1916
1081200350,320000,4,1.75,1760,11180,1,1760,0,1968
0084000105,255000,5,2.25,2060,8632,1,1030,1030,1962
3756500060,438000,3,1.75,1780,9660,1,1780,0,1962
7215720160,900000,3,2.5,3400,16603,2,3400,0,2000
3574800520,441000,3,2.75,1910,7280,1,1160,750,1979
2617300160,420000,3,2,2020,38332,1,1010,1010,1975
2558660270,370000,3,1.75,1580,7000,1,1180,400,1976
2009000370,269950,2,1.75,1340,7250,1,700,640,1949
1836980160,807100,4,2.5,2680,4499,2,2680,0,1999
3261020370,653000,3,2.5,2680,9750,1,1610,1070,1979
1755700060,371500,3,2,1370,8336,1,1370,0,1964
4330600435,284000,3,1.75,1560,21000,1,1560,0,1954
9542800700,272000,3,1.75,2160,7140,1,1670,490,1978
1999700045,313000,3,1.5,1340,7912,1.5,1340,0,1955
1762600070,917500,4,2.5,3880,35003,2,2570,1310,1984
1687900520,673000,4,2.25,2590,8190,2,2590,0,1980
7234600798,425000,3,2.5,1120,1100,2,820,300,2008
3881900445,399950,5,2.75,1970,5400,1,1320,650,1986
2254502445,385000,3,1,1220,4800,1,1220,0,1901
5437810320,269950,3,1.5,1950,7560,1,1320,630,1975
9158100075,330000,2,1,1350,8220,1,1060,290,1949
3830630310,260000,3,2.5,1670,5797,2,1670,0,1988
8123100045,470000,4,3,2380,5125,1.5,1680,700,1925
3127200041,589000,4,3,2440,9600,2,2440,0,1961
6661200320,163500,2,1.5,1050,3419,2,1050,0,1996
0011510310,835000,4,2.75,3130,13412,2,2140,990,1993
0825059270,1.095e+006,5,3,4090,12850,1,2090,2000,1986
8731951370,269000,4,1.75,1490,10000,1,1100,390,1969
1954440060,560000,3,2.5,1900,8744,2,1900,0,1987
2264500350,615000,4,1,1330,2400,1.5,1330,0,1901
1115810060,585188,3,2.25,2230,10026,1,1430,800,1975
9477200200,305000,3,1.75,1650,9480,1,1220,430,1977
1432600560,166950,3,1,1190,8820,1,1190,0,1959
2287000060,799000,3,2.5,2140,9897,1,2140,0,1959
3663500060,400000,3,2.5,2180,7508,1,1420,760,1962
3996900125,230000,3,1,1060,10228,1,1060,0,1948
7796450200,256883,3,2.5,1690,5025,2,1690,0,2003
7549802535,423000,4,2,1970,6480,1.5,1130,840,1920
3278600320,465000,3,2.5,2150,4084,2,2150,0,2007
2824079053,440000,3,2.5,1910,66211,2,1910,0,1997
1222069094,385000,3,1.75,1350,155073,1,1350,0,1969
3542300060,210000,3,1,860,11725,1,860,0,1943
2222059065,297000,3,2.5,1940,14952,2,1940,0,1994
7551300060,470000,3,1,1010,5000,1,1010,0,1952
0100600550,226500,3,1.5,1300,7370,1,900,400,1976
3211100860,274250,3,1,910,8450,1,910,0,1962
3456000310,840000,4,1.75,2480,11010,1,1630,850,1966
9526600140,677900,3,2.5,2440,4587,2,2440,0,2010
7465900060,425000,3,1,1010,5864,1,1010,0,1915
1222000055,180250,2,0.75,900,9600,1,900,0,1941
6300000550,464000,6,3,2300,3404,2,1600,700,1920
2310030510,320000,4,2.25,1550,7579,2,1550,0,1993
1025049114,625504,3,2.25,1270,1566,2,1060,210,2014
8677300550,592500,4,2.5,2240,12032,1,2240,0,1983
4014400292,465000,3,2.5,2714,17936,2,2714,0,2005
1102000196,477000,4,2.75,1720,6270,2,1720,0,1978
0257000138,280000,2,1,850,16400,1,850,0,1923
0046100204,1.505e+006,5,3,3300,33474,1,1870,1430,1957
1909600046,445838,3,2.5,2250,5692,2,2250,0,2000
1250202145,1.072e+006,2,2.25,3900,14864,1,1950,1950,1947
7611200125,467000,2,1.5,1320,10800,1,1320,0,1947
5611500140,686000,4,2.5,2760,6440,2,2760,0,1999
7138000260,279950,3,2,1750,9750,1,1350,400,1961
0626059335,527000,4,2.25,2330,19436,2,2330,0,1987
1922059282,325000,3,2.25,2220,16020,1,1780,440,1966
0705700390,328000,3,2.25,2020,8379,2,2020,0,1994
7454001200,390000,3,2.25,1250,7500,1,1250,0,1942
8682281200,479950,2,2,1510,6516,1,1510,0,2005
7972000200,264950,4,2.25,1720,9753,1,1120,600,1978
0722059070,235000,3,1,1430,15246,1,980,450,1961
7202340400,516500,3,2.5,1480,4729,2,1480,0,2004
8096000060,655000,2,1.75,1450,15798,2,1230,220,1915
2424000060,500000,4,2.75,2280,15347,1,2280,0,1960
9264902050,315000,6,2.75,2940,7350,1,1780,1160,1978
0943100260,213000,2,1,1000,10200,1,1000,0,1961
3677400445,475000,3,1.5,2480,5280,1.5,1620,860,1947
1762600320,1.025e+006,5,4,3760,28040,2,3760,0,1983
4058000060,416000,3,2,2220,94300,1,1640,580,1976
7228500560,410000,4,1,1970,4740,1.5,1670,300,1904
0326069104,800000,3,3.5,3830,221284,2,3530,300,1993
5152100060,472000,6,2.5,4410,14034,1,2350,2060,1965
3584000310,225000,3,1.75,1430,8505,1,1430,0,1968
8150100045,210000,2,1,830,6000,1,830,0,1940
1868901275,455000,2,1,1430,5000,1.5,1430,0,1925
6131600075,225000,3,1,1300,8316,1,1300,0,1954
9468200125,480000,2,1,1030,3060,1,790,240,1918
8029510030,363000,3,2.5,2740,11872,2,2740,0,1990
2025069065,2.4e+006,4,2.5,3650,8354,1,1830,1820,2000
7899800890,181000,2,1.5,720,5120,1,720,0,1954
3021059276,250000,4,2,2010,7312,1,2010,0,1976
3797001895,481000,3,1.75,1560,3000,1,770,790,1918
3832710960,260000,3,2,1810,7209,1,1240,570,1978
1310430400,455000,4,2.5,3360,7685,2,3360,0,2001
1422300030,415000,3,2.25,1510,36224,2,1510,0,1991
1105000588,349500,3,1,1400,3538,1,800,600,1953
3830630060,245000,3,2.5,1730,7442,2,1730,0,1987
5101404898,592500,2,2,1420,9191,1.5,1420,0,1928
7972601890,385000,4,1.75,2360,7620,1,1180,1180,1955
5127001620,315000,3,1.75,1580,11455,1,1200,380,1974
9407100800,255000,3,1,1230,10170,1,1230,0,1979
1873100060,693000,4,2.5,2460,4425,2,2460,0,2006
8722101360,780000,3,1,1660,4400,1.5,1460,200,1911
8644000060,237000,3,1.75,1270,8470,1,1270,0,1960
3325069129,525000,3,2.25,2100,40510,2,1320,780,1979
1400300055,425000,2,1,770,5040,1,770,0,1930
2123039032,369900,1,0.75,760,10079,1,760,0,1936
8078560140,290000,4,2.5,1700,7280,2,1700,0,1988
3438500192,285000,3,1,1120,10701,1,1120,0,1954
7974200510,415000,2,1,1070,4500,1,1070,0,1937
2557000400,272500,3,2.5,2070,9900,1,1420,650,1979
7960900060,2.9e+006,4,3.25,5050,20100,1.5,4750,300,1982
4054500390,1.365e+006,4,4.75,5310,57346,2,5310,0,1989
6378500125,436000,2,1,1040,7538,1,1040,0,1939
1745100140,210000,3,1,1700,11390,1,1700,0,1967
2976800796,236000,3,1,1300,5898,1,1300,0,1961
4235400186,331000,3,1.75,1080,1306,1,580,500,1954
4215100060,365000,3,2.5,2653,4510,2,2653,0,2006
9189700045,450000,3,2,2290,16258,1,2290,0,1960
1126049053,770000,4,2.75,3820,26300,2,2850,970,2014
2022069200,455000,4,2.5,2210,49375,1,2210,0,1997
9412900055,405000,3,1.75,2390,6000,1,1240,1150,1908
1722059235,304900,4,1.75,2600,11325,1,1610,990,1969
6874200960,170000,2,1,860,5265,1,860,0,1931
7424700045,2.05e+006,5,3,3830,8480,2,2630,1200,1905
7202360350,780000,4,2.5,3500,7048,2,3500,0,2005
5634500392,330000,3,3,2420,13959,1,1740,680,1988
1509500060,370000,4,2.5,2720,8666,2,2720,0,1992
7214810350,467000,5,2.25,2500,13500,1,1850,650,1979
6647200060,405000,3,1.75,1670,6720,1,1140,530,1980
9552700140,675000,5,2.25,2900,10300,1,1450,1450,1985
2200500350,500000,2,1,1640,14100,1,1140,500,1954
6113400046,389999,4,2.5,1890,15770,2,1890,0,1968
6619910140,630000,4,1.75,2950,9025,1,1780,1170,1975
1115450240,360000,4,2.5,2160,9528,2,2160,0,1992
6073240060,580000,4,3,3280,11060,2,2270,1010,1986
9297300045,550000,3,2,1970,4166,2,1270,700,1929
9510920070,879000,4,2.5,3360,22111,2,3360,0,1994
5468730030,265000,3,2,1320,8959,1,1320,0,1993
8079030390,446500,3,2.5,2650,7286,2,2650,0,1990
0600000152,404000,3,1.5,2030,8880,1,1330,700,1963
1840000030,267500,3,1.75,1590,11914,1,1090,500,1957
3225069065,3.075e+006,4,5,4550,18641,1,2600,1950,2002
3260800030,335000,3,2.5,2440,7632,2,2440,0,1998
2747100024,576000,3,2.5,1940,9000,1,970,970,1948
5104530560,208633,3,2.5,2040,3810,2,2040,0,2006
4330600350,315000,3,2.25,2200,8750,1,1120,1080,1964
5016001535,725000,3,1.75,1920,3300,1,960,960,1913
7280300196,550000,4,2.75,1800,7750,1,1400,400,1965
8651520400,610750,4,2.25,2180,7297,2,2180,0,1984
7171200445,550700,2,1,1010,5000,1.5,1010,0,1908
3204800200,665000,4,2.75,3320,10574,2,2220,1100,1960
3416600800,834000,4,2.5,2370,4000,1.5,1980,390,1928
7994700030,201000,5,1.75,1660,78408,1.5,1660,0,1915
1860600135,2.384e+006,5,2.5,3650,9050,2,3370,280,1921
4139480200,1.384e+006,4,3.25,4290,12103,1,2690,1600,1997
4139480200,1.4e+006,4,3.25,4290,12103,1,2690,1600,1997
1328320800,305000,4,2.25,1950,7700,1,1350,600,1979
7771300125,487000,3,2,2590,14052,1,1720,870,1948
3422059208,390000,3,2.5,1930,64904,1,1930,0,1988
9521101455,548000,2,1,1470,3864,1,1170,300,1916
4337000335,268750,4,1,800,8775,1,800,0,1943
0325059286,819900,5,2.75,3150,7119,2,3150,0,2013
2597650240,520000,3,2.25,2030,16200,2,2030,0,1984
3353400435,230000,3,2,1450,11204,1,1450,0,2003
7972000240,240000,3,1.75,1510,10248,1,1510,0,1969
7520000520,232000,2,1,1240,12092,1,960,280,1922
7520000520,240500,2,1,1240,12092,1,960,280,1922
3530210260,274975,3,2.5,3030,45004,2,3030,0,1987
1959700550,740000,4,2,2050,4400,1.5,2050,0,1922
1665400045,186375,3,1,1000,7636,1,1000,0,1952
9542850320,790000,3,2.25,2370,10289,1,1590,780,1977
3179100060,880000,4,3.5,2800,6750,2,1890,910,1951
2946001550,279000,6,1.75,2240,11180,2,2240,0,1955
8078490390,295000,3,2,1810,10530,1,1810,0,1991
9550201550,640000,2,1,1070,5000,1,1070,0,1924
0191100045,940000,4,2,2490,9525,2,2490,0,1968
5009600070,260000,4,2.5,1960,5238,2,1960,0,2003
0200350070,559900,3,2.75,2930,5569,1,1860,1070,2004
2877103726,791500,4,2,1510,3500,1.5,1510,0,1911
0405100295,265000,3,1.75,1420,8250,1,1420,0,1954
4268200055,245000,3,1.75,1740,11547,1,1740,0,1954
3126069068,485000,4,1.75,2560,43995,2,2560,0,1962
1115300070,684000,4,3.5,3040,8414,2,2420,620,2010
6414100671,425000,3,1.75,2500,6840,1,1300,1200,1957
7004200060,309600,4,1.75,1275,20000,1,1275,0,1991
7852110140,552250,4,2.5,2580,5823,2,2580,0,2002
3969300030,165000,4,1,1000,7134,1,1000,0,1943
3969300030,239900,4,1,1000,7134,1,1000,0,1943
4048400070,320000,2,1,1070,32633,1,1070,0,1930
0808000070,206600,3,2,1390,13464,1,1390,0,1987
7374200030,387000,4,1.75,2500,7690,1,1250,1250,1973
7325600160,299000,1,0.75,560,12120,1,560,0,1967
2757000030,855000,4,2.75,2270,10460,2,2270,0,1965
0616000140,315000,3,1,1900,14400,1,1300,600,1954
3363900111,437500,2,1,990,3120,1,790,200,1907
9262800171,252000,4,1.5,1550,19800,1,1050,500,1969
6607000126,375000,4,1.75,2200,7475,1,1100,1100,1955
5416510830,300000,4,2.5,1910,4862,2,1910,0,2005
2201500030,420000,4,1,1750,9600,1.5,1750,0,1954
0325059171,900000,3,1,1330,77972,1,1330,0,1928
0952003285,679900,3,2.5,2440,5750,2,1980,460,2000
3211290370,463000,3,2.5,1640,29970,2,1640,0,1992
1072010350,380000,5,2.5,2760,11340,2,2760,0,1978
8856950070,329500,4,2.5,1820,7912,2,1820,0,1994
0925059078,604950,3,2.5,2110,5608,1,1340,770,2013
7855801090,795000,5,2.5,3040,9570,1,1640,1400,1966
0723099065,465000,3,2,1840,40438,2,1840,0,1994
6116500075,673000,4,2.5,2990,10400,2,2990,0,2002
1118500030,810000,4,2.5,3520,15420,2,3520,0,1991
0424069250,785000,4,2.75,2440,69415,1,1910,530,1989
3291800710,338000,4,3,2090,7500,1,1370,720,1986
6838700060,280000,3,2.25,1430,7222,2,1430,0,1993
2231500030,315000,4,2.25,2180,10754,1,1100,1080,1954
2231500030,530000,4,2.25,2180,10754,1,1100,1080,1954
7683900200,380000,5,3,3450,9914,2,3450,0,2004
8155830060,297000,3,2.25,1450,7562,2,1450,0,1994
0098020310,730000,4,2.5,3230,7331,2,3230,0,2004
9423400140,450000,3,1.75,1640,13500,1,1110,530,1940
1545804860,275000,3,3,1590,7750,1,1060,530,1997
2883200160,595000,4,2,2020,2849,2,2020,0,1960
7132300695,435000,3,1.5,1300,3348,1.5,1300,0,1904
1726059053,270000,2,1.5,1380,209959,1,1380,0,1954
0624111000,950000,3,3,4040,14338,2,3030,1010,1986
0808300310,389000,4,2.25,2130,5337,2,2130,0,2001
8563040160,560000,4,2.25,2550,7800,1,1580,970,1968
0713500030,1.35e+006,5,3.5,4800,14984,2,3480,1320,1998
8651600160,799000,4,2.25,2510,11585,2,2510,0,1969
9517200030,365500,3,2,1410,9600,1,1410,0,1983
2460700700,252350,3,2,1650,7352,1,1160,490,1979
1223039290,403950,4,2.5,2120,13780,2,2120,0,1993
2890100060,385000,4,1.5,2040,10726,1,1380,660,1954
7972600860,345000,4,1,1550,7620,1.5,1550,0,1957
8857320070,490000,3,2.75,1980,3128,2,1980,0,1979
4047200695,330000,3,2.5,1600,26977,2,1600,0,2005
1653500070,927000,4,2.75,3300,12090,2,3300,0,1953
1923000030,1.118e+006,4,2.5,3840,16619,2,3840,0,1983
3649100320,330000,2,1,1220,10000,1,1220,0,1950
7375300160,530000,5,2.25,2720,8800,1,1500,1220,1958
5175800060,365000,4,2,1940,25600,1,1940,0,1962
1604601375,378750,3,2.5,2160,3000,1.5,1260,900,1909
2473251090,269900,4,1.75,1530,8750,1.5,1530,0,1968
9126100861,557000,3,3.5,1710,2096,2,1290,420,2008
3420069065,360000,4,1.75,3730,16980,1,2150,1580,1974
6021501685,352000,2,1,940,5000,1,940,0,1937
1151100070,437000,3,2.5,1750,22357,2,1750,0,1994
8856950240,322500,4,2.5,1820,6753,2,1820,0,1994
9385200055,650000,3,3.25,1510,2000,2,1330,180,2001
7821200390,450000,3,2,1290,1213,3,1290,0,2001
8078520310,278500,3,2,1570,5250,1,1570,0,1998
1565950030,364950,4,2.5,1930,6957,2,1930,0,1995
1560930070,840000,4,3.5,2840,40139,1,2840,0,1986
6700400140,268000,3,2.5,1550,8134,2,1550,0,1991
2422029094,517534,2,1,833,143947,1,833,0,2006
1774220160,632925,3,2.5,2990,32239,2,2990,0,1978
1525200060,577500,3,2.5,2000,7251,2,2000,0,1995
1678400105,339000,4,1.5,2390,7480,1.5,2390,0,1920
3426059070,570000,3,1.75,2910,37461,1,1530,1380,1967
0824079032,563500,4,1.75,2085,174240,1,1610,475,1964
2697100140,423000,4,2.25,2200,9351,1,1290,910,1962
8724300030,355000,3,2.25,1860,5028,2,1860,0,2012
8678500060,1.55e+006,5,4.25,6070,171626,2,6070,0,1999
0625049299,482000,2,1,950,3960,1,950,0,1941
6073200075,625000,3,1.75,1600,9135,1,1600,0,1955
6388900710,538000,3,2.5,2250,11632,2,2250,0,1988
1442860160,380000,3,2.5,2280,10255,2,2280,0,1985
7942600310,375000,2,1,940,5120,1,940,0,1909
1545808560,245000,3,2.5,1530,8500,1,1030,500,1996
0936000060,310000,5,1.75,2190,27260,1,2190,0,1947
9808650060,1.3e+006,3,2,2350,15021,1,1770,580,1976
3754700160,397000,4,2,1440,7680,1,1200,240,1971
0305500140,365000,3,2.5,2200,4052,2,2200,0,2005
5468750060,328500,4,3,2290,8250,2,2290,0,1990
2944010240,988000,4,3,4040,19700,2,4040,0,1987
3454000060,1e+006,4,2.5,2610,3277,1.5,1920,690,1922
0646910160,237000,3,2.5,1490,2138,2,1490,0,2005
8564950390,525000,4,2.5,2450,5280,2,2450,0,2003
2268400350,749000,4,2.5,1710,9627,1,1440,270,1976
7504101040,722500,5,2.5,4870,11800,2,3470,1400,1983
0011500890,843000,3,2.5,3130,8750,2,3130,0,1991
9528102772,438000,2,2,1270,1372,3,1270,0,2000
0284000223,578000,3,1.75,2120,10875,1,1540,580,1977
3353401710,227950,3,1.5,1670,8230,1,1670,0,1954
8159610030,196000,3,2.25,2070,11576,2,2070,0,1974
3179100435,641000,2,1,1420,5332,1,1070,350,1953
0822079033,350000,3,1.5,1250,219978,1,1250,0,1980
8857600960,205000,3,1,940,7980,1,940,0,1960
1774000200,400000,3,1.75,1920,9102,1,1920,0,1968
2024069128,1.03e+006,3,2.5,3545,9816,1,2610,935,2005
1049010390,505000,3,2,1260,5460,1,1260,0,1972
7905370390,475000,5,2.5,2340,7200,1,1300,1040,1975
4140090240,520000,3,2.25,2590,9263,1,1440,1150,1977
4055700030,1.45e+006,3,4.5,3970,24920,2,3260,710,1977
3775300030,333500,3,1.75,1220,9732,1,1220,0,1965
2525300030,232000,3,1,1400,10403,1,1400,0,1976
1324059104,691100,3,2.75,2360,16117,1,1710,650,1983
2287000030,811000,3,1.75,1870,9897,1,1870,0,1960
7702010030,551000,3,2.5,2830,5802,2,2830,0,2001
1529200340,496500,3,2.5,2260,3640,2,2260,0,1994
2122039094,705000,3,3,1970,20978,2,1770,200,1980
1742800030,578000,4,2.5,3140,9225,1,1770,1370,1966
1796360350,255000,3,1.75,1240,8659,1,1240,0,1986
6154500070,1.05e+006,4,3.5,3450,7832,2,3450,0,2007
1843100340,348000,3,2.25,2570,8491,2,2570,0,1989
8944290160,230000,3,2,1510,3413,2,1510,0,1985
4166600473,359500,4,2.25,2390,11250,2,2390,0,1988
7282300125,330000,3,1,980,7000,1,980,0,1953
8658300340,80000,1,0.75,430,5050,1,430,0,1912
2419600075,465000,3,1.75,1480,6360,1,1480,0,1954
2621760350,325000,4,2.5,1850,7324,2,1850,0,1997
1723049270,340500,3,2,2270,28025,1,1920,350,1947
4123840310,342500,3,2.5,1810,5192,2,1810,0,1993
2172000075,290900,2,2,1610,17600,2,1610,0,1930
8651611170,868700,3,4.25,3840,6161,2,3840,0,2000
8820902200,1.199e+006,4,2.75,4110,8400,2,3130,980,1928
8651610890,1.15e+006,4,3.25,4190,10259,2,3150,1040,2000
1853080570,859900,4,2.75,3390,6298,2,3390,0,2011
3629920030,520000,4,2.25,1890,3006,2,1890,0,2003
1604602050,460000,3,2.5,1610,2527,2,1080,530,2005
6844700810,438924,3,1.5,1050,4590,1,850,200,1949
0066000070,315000,2,1,630,6550,1,630,0,1918
6665800030,590000,4,2.75,2910,10650,1,1780,1130,1975
2205700350,378500,4,1.75,1700,8640,1,850,850,1955
5466000030,328500,3,2.5,1950,8130,2,1950,0,1990
6189200125,849950,3,3,2990,9773,2,2990,0,1973
9169600135,525000,3,1.5,1350,6000,1,900,450,1950
2625069070,1.385e+006,4,3.25,4860,181319,2.5,4860,0,1993
8732131090,295000,4,2.5,2160,7725,1,1460,700,1978
9286000240,1.067e+006,6,3.5,4860,11793,2,3860,1000,1998
1895000260,207950,2,2,890,5000,1,890,0,1917
8691370400,699900,4,2.75,2810,7302,2,2810,0,2002
5423010350,1.28e+006,5,2.5,3400,9500,2,3400,0,1977
8562501040,452000,4,1.5,1580,7350,1,960,620,1963
2475200140,370000,3,2,1680,5036,1,1680,0,1987
7942100310,232000,3,1.75,1300,11230,1,1300,0,1968
3760000030,669950,5,2.5,2820,14062,2,2380,440,1960
1727500340,397500,3,2,1510,6710,1,1070,440,1972
9828702519,490000,2,2.5,1230,1391,2,870,360,2004
4432600075,725000,4,2,2110,4140,2,1710,400,1925
7806300030,299000,3,2.75,3080,19635,1,1610,1470,1958
9274202270,625000,2,1.5,1490,5750,1.5,1190,300,1900
7852030960,437500,3,2.5,2120,4500,2,2120,0,2000
7852170140,650000,4,2.5,3180,5438,2,3180,0,2003
7518503335,475000,2,1,1490,3825,1,860,630,1929
5467900070,342000,3,2,1930,11947,1,1930,0,1966
1245002952,1.19735e+006,4,2.5,2770,7800,2,2770,0,1999
8906200070,280000,3,1.5,1670,11610,1,1670,0,1963
5379805885,240000,2,1.75,1330,7200,1,1330,0,1993
2769600560,529000,3,1,1210,3328,1.5,1210,0,1924
9238901420,442000,3,1,1190,5100,1,1030,160,1941
5113400431,615000,2,1,1540,6872,1,820,720,1946
3885805665,1.485e+006,4,3.75,4030,10800,2,4030,0,2006
8121200810,585000,4,1.75,2430,7559,1,1580,850,1981
5126310400,480000,4,2.5,2600,7787,2,2600,0,2005
7322910030,1.095e+006,5,3.5,4410,57063,2,4410,0,1990
2827100070,290000,4,1,1330,8184,1.5,1330,0,1949
9276201895,615000,3,1.75,1900,5000,1,950,950,1951
4402700070,300000,2,1,1100,7680,1,1100,0,1950
1922059046,308000,3,1,1980,39150,1.5,1580,400,1932
0925059288,750000,3,2.5,2400,7745,2,2400,0,2001
4386700135,2.25e+006,4,2.25,4760,8036,2.5,3390,1370,1916
1923069078,890000,4,3.25,3180,194278,2,3180,0,2005
1432400335,288000,3,1,1190,7560,1,1190,0,1958
1180003090,190000,2,1,630,6000,1,630,0,1943
0726049331,515000,5,3,2530,5105,1,1520,1010,2005
3340401555,235000,4,1.5,1690,11054,1,1690,0,1930
7453000070,275000,2,1,940,5000,1,940,0,1951
4348800030,727500,2,2,1240,9119,1,1240,0,1952
7202331420,650000,4,2.5,3040,6587,2,3040,0,2003
3225079035,1.6e+006,6,5,6050,230652,2,6050,0,2001
6381500700,365000,4,1,1590,7085,1.5,1590,0,1944
0339500160,662000,3,1.75,2500,36947,1,2500,0,1984
1545807610,270500,3,2.5,1780,7848,1,1320,460,1978
1843200240,200000,2,1.5,1360,1898,2,1360,0,1978
4403600270,970000,4,3.25,4740,76230,2,4740,0,1987
2008200060,160000,3,1.5,1010,9600,1,1010,0,1962
1521069070,204000,3,1,1040,7405,1,1040,0,1971
2459500310,358000,3,2.25,1610,6655,2,1610,0,1985
6204420070,452000,4,1.75,1570,8268,1,1570,0,1979
5694500105,595000,2,2,1510,4000,1,1010,500,1900
5466410030,249000,3,2,1360,6082,1,1360,0,1994
9485740340,346900,4,2.5,1970,5106,2,1970,0,1999
0622049114,2.125e+006,3,2.5,5403,24069,2,5403,0,1976
2270000070,280000,4,2.5,1560,4350,2,1560,0,2003
1310900260,318888,4,1.75,2320,12000,1,2270,50,1973
0224069094,530000,3,2.25,2120,40518,1,2120,0,1967
7800800160,375000,3,2.25,2120,18500,2,2120,0,1983
2944000240,910000,4,2.5,3350,29242,2,3350,0,1988
4139400710,782000,4,2.5,2380,9614,2,2380,0,1991
7899800860,259950,2,2,1070,649,2,720,350,2008
2473420140,315000,4,2.75,2300,18360,1,1560,740,1979
5000500055,215000,2,1,1320,8865,1,1320,0,1943
4099500935,705000,3,1.75,2180,10221,1,1140,1040,1946
1373800295,1.45e+006,3,3,4380,6320,2,3580,800,1952
4025300135,451000,3,1.75,1790,9813,2,1790,0,1949
3294700310,261000,2,1,750,8125,1,750,0,1943
8718500075,396000,3,1.5,1300,8280,1,1300,0,1956
4309710240,725000,4,2.5,2990,29170,2,2990,0,1999
5486800070,1.95e+006,7,3.5,4640,15235,2,2860,1780,1965
0236400320,238000,4,1,1400,7242,1.5,1400,0,1959
4376700570,750000,6,1.75,2750,9563,2,2750,0,1973
8648100200,331500,4,2.5,2050,10271,2,2050,0,1998
3624079046,460000,4,3,2230,108900,1,1410,820,1978
1921069084,404950,4,2.25,2340,217014,1,2340,0,1982
6431500140,880000,3,2.5,2870,5163,2,2870,0,2014
2725069050,863000,4,2.5,4120,22370,2,4120,0,1997
5307100060,638700,3,1.75,2080,9162,1,1370,710,1960
7203102050,435000,3,2.5,1840,5680,2,1840,0,2008
0561000075,260000,3,1,1180,5350,1.5,1180,0,1959
2436701180,671500,5,2.75,2160,4000,1.5,1530,630,1927
0809002765,610000,3,1,1180,3400,1.5,1180,0,1907
4045500710,405000,2,0.75,1160,15029,1,870,290,1937
5104510270,338900,4,2.5,1830,5612,2,1830,0,2003
0098020350,720000,4,4,3200,7708,2,3200,0,2004
1714900060,442000,5,3,2560,5445,1.5,1760,800,1927
1189000030,650000,5,2.75,2550,5040,1.5,2550,0,1902
2473360060,263500,3,1.75,1330,9917,1,1040,290,1981
0222069082,300000,2,1,1220,75794,1,1220,0,1963
8669160310,266000,3,2.5,1805,3402,2,1805,0,2009
1526069135,930000,4,4,6050,84942,2.5,4150,1900,2009
1088650310,530000,4,2.5,2320,5493,2,2320,0,2004
8945200860,180000,3,1,1384,8960,1,1384,0,1965
7853240200,619000,3,2.5,2720,6439,2,2720,0,2005
7511800070,264000,3,1.5,1820,10608,1,1820,0,1962
2998800125,730000,2,2.25,2130,4920,1.5,1530,600,1941
3876300310,439000,4,2.25,2060,10070,2,2060,0,1975
5419800510,268500,4,1.75,1420,7500,1,1080,340,1981
0192460060,330000,3,1.75,1510,15744,1,1510,0,1985
7942601895,640000,3,2.5,2160,4000,1.5,1960,200,1903
7504010570,900000,3,2.5,3180,12600,2,3180,0,1978
1442740140,370000,3,2.25,2110,13300,2,2110,0,1985
6909200575,685000,3,2,2060,2900,1.5,1330,730,1931
2525069041,505000,3,1.5,1830,217800,1,1010,820,1981
3620069036,265000,3,1.75,1820,32666,1,1820,0,1966
2781280390,290000,3,2.5,1610,2937,2,1610,0,2006
9542830350,296000,4,2.5,1780,3600,2,1780,0,2006
1123049053,360000,4,2.5,1840,9611,2,1840,0,1996
8018600765,240500,3,1.75,1460,10584,1,990,470,1997
3278600240,372500,2,2.5,1400,2958,2,1400,0,2007
7846200070,595000,3,2.5,3370,14402,2,3370,0,2004
0662310400,515000,4,3,3590,8249,2,3590,0,1997
8651100140,1.22e+006,4,2.25,3200,15367,2,3200,0,1962
8682250350,507000,2,1.75,1670,6460,1,1670,0,2004
3211230260,399950,4,2,2420,31465,1,2420,0,1984
4233400340,185000,3,1.75,1430,10816,2,1430,0,1994
7199350340,460000,3,1.75,1440,7070,1,1440,0,1980
3904901710,435500,3,2.25,1450,4789,2,1450,0,1985
0240000058,469000,4,2.75,3550,13938,1,2100,1450,1966
6865200444,531000,2,3,1270,1175,2,1110,160,2000
9498200046,443500,2,1,940,6804,1,940,0,1949
1796380960,223000,3,2,1670,6824,1,1300,370,1990
5631500868,590000,4,3.5,3100,15842,2,2400,700,1996
3126049411,340000,2,2.5,1100,1760,3,1100,0,1997
2321300390,650000,3,2,1870,3388,1,1230,640,1925
3905040800,533600,3,2.5,1930,5080,2,1930,0,1990
4379400260,695000,3,2.75,2540,4694,2,2540,0,2005
5115000160,242000,3,1.75,1280,7524,1.5,1280,0,1988
2826049234,425000,3,2.25,1820,8814,1,1280,540,1967
6600700030,525000,3,2.25,1490,9414,2,1490,0,1981
3904930240,485000,3,2.5,1880,5502,2,1880,0,1988
9407110700,175000,3,1,1250,9775,1,1250,0,1971
1682500160,210000,3,2,1440,7210,1,1440,0,1983
8078570390,260000,3,2.5,1920,7415,2,1920,0,1989
3010300240,577000,3,2.5,2060,5750,1,1330,730,1976
9500900135,200000,3,1.5,1210,10588,1,1210,0,1958
0461001615,605000,2,1.75,1760,5000,1,940,820,1927
6411600069,325000,3,1,990,6750,1,990,0,1947
7812800565,289500,3,1,960,6400,1,820,140,1944
7548300731,559950,3,2.5,1660,1458,3,1660,0,2014
8925100390,1.0425e+006,3,1.75,1900,9375,1,1330,570,1941
7010700292,543500,3,2.25,1270,2790,1,990,280,1970
9485951170,480000,4,2.25,3250,34293,2,3250,0,1983
5437820310,218000,3,1,960,9633,1,960,0,1982
0582000135,565000,2,1.75,1330,6000,1,960,370,1914
3204800370,426700,3,1.75,2080,7700,1,1600,480,1968
8832900550,650000,3,2.5,2690,11575,1,2130,560,1957
9550204515,542000,2,1,890,3060,1,770,120,1910
7199330390,415000,3,1.75,1070,8000,1,1070,0,1977
6131600060,214000,3,1,1200,8316,1,1200,0,1953
5379805460,245000,3,1.5,1360,8910,2,1360,0,1949
7212652180,314500,3,2,2050,13303,1,2050,0,1993
6379500640,1.12e+006,3,1.5,3000,5750,2,2000,1000,1924
4315700060,378000,2,2,1300,3850,1,800,500,1963
3329500060,305000,4,2.5,2250,9091,1,1340,910,1982
4140090320,595000,5,2.75,3740,6750,1,1980,1760,1978
9385200045,729500,3,2.5,1660,1091,3,1530,130,2015
7852180340,430000,3,2.5,2360,6699,2,2360,0,2003
1545804340,240000,3,1.75,1760,6500,1,1150,610,1987
2490200320,545000,3,1.75,1680,6200,1.5,1680,0,1916
2218000335,530000,3,1.75,1320,2500,1,870,450,1918
0922049078,157000,1,1,870,26326,1,870,0,1939
2586800270,425000,4,1,1260,7645,1.5,1260,0,1925
4338800370,220000,3,1,1000,6020,1,1000,0,1944
7214700350,521000,4,1.75,2020,36400,1,1550,470,1976
3226200105,325000,3,1,1920,6862,1,1120,800,1952
2324039036,597500,3,2,2150,5400,1.5,1380,770,1911
7849202231,337000,3,2.5,1470,3976,2,1470,0,1999
5196410260,1e+006,3,2.5,3180,10492,2,3180,0,1991
3760500116,3.07e+006,3,2.5,3930,55867,1,2330,1600,1957
2985800030,495000,3,1,990,6000,1,990,0,1943
0259900160,748000,4,3.5,2770,3330,2,1970,800,2001
0708000030,888000,3,1.5,1250,8710,1,1250,0,1953
0192460310,269900,3,1.75,1140,22267,1,1140,0,1986
9412200260,496500,4,2.5,2250,14440,1,1550,700,1967
1062100116,475000,3,2.5,1640,5097,2,1640,0,1969
6798100662,312000,3,1.5,1255,1374,3,1255,0,2004
1775920350,323000,3,1,1290,12231,1,1290,0,1976
2525500260,331000,3,1.75,1300,9079,1,1300,0,1986
6145600041,306000,3,1.5,1220,1086,3,1220,0,2007
3300701615,655000,4,2.5,2630,4000,3,2630,0,2002
5151600340,290000,3,1.5,1950,15954,1,1950,0,1959
7613700521,1.25e+006,4,3.25,3160,5000,2,2360,800,1965
2710600045,460000,3,1.75,1550,4708,1,860,690,1949
5101405124,435000,4,2.5,1700,6380,1,850,850,1940
6067910030,664000,4,2.75,2510,11880,1,1630,880,1978
1959701890,865000,4,1.75,1800,4180,2,1800,0,1921
1402200340,385000,3,1.75,1800,18000,1,1200,600,1968
3558900070,497000,3,2.25,1870,9315,1,1350,520,1975
7846700310,280000,2,1,1010,3000,1,1010,0,1925
3348401740,188000,2,1.5,1120,17487,1,1120,0,1924
3013300288,478500,3,1,2090,4755,1,1200,890,1969
7852070060,1.145e+006,4,3.5,4370,18361,2,4370,0,2001
5029450160,222000,3,2,1440,7187,1,970,470,1981
3526069070,799000,4,3,2580,209523,2,2580,0,1984
5104540240,609900,4,2.5,3190,7399,2,3190,0,2006
3438500486,413000,4,3.5,2380,5809,2,1750,630,1995
5102400105,400000,4,1,1420,4875,1.5,1420,0,1930
2346200030,802541,5,2.75,2990,6768,2,2990,0,2014
1321710030,320000,3,2.5,2680,7757,2,2680,0,1990
7853290030,507000,4,2.5,2730,7649,2,2730,0,2006
1566100400,387500,3,1,1220,8329,1,1220,0,1946
1775800800,396000,3,1,1500,12616,1,1500,0,1967
9133600075,373000,3,1.75,1830,11788,1,1430,400,1958
5450900060,1.4849e+006,5,2.5,4570,19252,2,4570,0,1965
1402600700,359900,4,2.25,2470,7698,2,2470,0,1983
8024200350,410000,2,1,800,4342,1,670,130,1927
3121500340,690000,4,2.5,2900,23488,2,2900,0,1992
7697870860,245000,3,2,1410,5760,1,1410,0,1985
7527200030,700000,5,2.5,2830,25958,1,1610,1220,1979
2013200390,268000,4,1.75,1680,9966,1,1100,580,1977
0766500030,225000,3,1.75,1760,26055,1,920,840,1979
6664000030,980000,4,2.25,2240,11034,2,2240,0,1976
9349900105,795000,2,1,1380,5000,1.5,1380,0,1905
1895000045,195000,2,1,820,5100,1,820,0,1953
6205500030,480000,4,2,2180,10575,1,1730,450,1950
7011200260,485000,4,2,1400,3600,1,1100,300,1900
0041000454,130000,2,1,880,9000,1,880,0,1928
7203600550,325000,2,1,1060,5703,1,1060,0,1946
9477200560,440000,3,1.75,1530,7245,1,1530,0,1984
4022907770,550000,4,1.75,2480,14782,1,1460,1020,1958
5231000060,310000,3,1.75,1490,7150,1,1490,0,1967
6055000310,530000,3,2.5,3660,39478,2,3260,400,1989
3216900060,390000,4,2.5,2340,8548,2,2340,0,1993
7967200060,243000,3,1.75,1450,12125,1,1450,0,1981
8077210350,639000,4,2.5,2210,9875,2,2210,0,1990
7203000640,215000,4,1,1130,7400,1,1130,0,1969
2988000070,405000,5,1.75,1550,10500,1,1100,450,1961
3832200070,250000,4,1.75,1710,7140,1,1010,700,1968
3670500710,405500,3,1.5,1010,8108,1,1010,0,1954
8820903380,452000,6,2.25,2660,13579,2,2660,0,1937
8820903380,730000,6,2.25,2660,13579,2,2660,0,1937
4233400400,267000,3,2,1300,9644,1,1300,0,1994
3793500550,289950,3,2.5,1670,6186,2,1670,0,2002
6431000270,565000,2,1,960,4080,1,960,0,1911
2225059214,1.578e+006,4,3.25,4670,51836,2,4670,0,1988
7694800270,636000,3,2.5,2140,2770,2,1770,370,2007
2171400197,350000,5,3,2520,5500,1,1550,970,2004
2473400340,320000,3,1.5,1650,9380,1,1130,520,1978
3530490070,210000,2,1.75,1440,5680,1,1440,0,1978
1932300075,245000,2,1,1050,5900,1,1050,0,1950
2525000510,328000,3,1.75,1470,7650,1,1130,340,1983
1853000510,985000,4,2.25,4230,37769,2,4230,0,1989
1742800060,501000,3,1.75,1970,7972,1,1370,600,1976
2723089104,315000,3,2.25,1540,17424,2,1540,0,1992
2619950350,403000,3,2.75,2090,8354,2,2090,0,2012
4021100045,550000,3,2,2380,17950,2,2110,270,1934
0731500200,347500,4,2.5,2156,3562,2,2156,0,2012
2591820310,365000,4,2.25,2070,8893,2,2070,0,1986
3626039299,588000,3,1,1910,8167,1,1270,640,1951
9346980140,605000,3,1.75,1920,7400,1,1260,660,1977
6613000140,1.3e+006,3,3.25,3400,5979,2,2290,1110,1937
8159610060,233000,3,2,1400,9177,1,1400,0,1974
7830800339,360000,4,2.5,2210,17715,2,2210,0,1997
1588600045,459000,2,1.75,1170,4887,1,1020,150,1929
0826069046,740000,3,2,2100,72745,1,2100,0,1995
1771000890,305000,3,1,1160,9750,1,1160,0,1967
3300701170,395000,3,1,1500,4000,1,900,600,1925
7340500270,560000,4,2.5,2940,6000,2,2940,0,2000
9277200111,650000,4,1.75,2010,5070,1,1300,710,1963
0293720140,449950,3,2.5,2170,4912,2,2170,0,2003
0579003610,517500,3,1.5,1430,5200,1,1250,180,1940
1138020200,435000,4,1.5,1510,6460,1,1070,440,1970
3432500200,329999,3,1,1150,6908,1,800,350,1952
1563102435,950000,3,1.75,2150,4200,1,1140,1010,1960
3959400710,447000,3,1,1370,6001,1,1230,140,1944
8682300890,699800,2,2.5,2380,6600,1,2380,0,2010
4385700765,850000,3,1.75,1370,3850,1,770,600,1911
5149300200,316500,3,1.75,1600,14250,1,1070,530,1979
9323600060,942500,5,3.5,3750,9612,1,2030,1720,1981
9273200140,1.31e+006,2,2.25,3950,3938,2,2910,1040,1991
9542300320,856600,4,2.25,2400,13430,1,2400,0,1964
0770000045,405600,5,1.5,2830,4000,2.5,2830,0,1918
6979900390,565000,4,2.5,2440,22594,2,2440,0,1996
6379500159,400000,3,2.25,1190,1149,2,1050,140,2008
0826079094,330000,3,2,1400,218252,1,1400,0,1997
8856940060,374950,4,2.75,2730,4683,2,2730,0,2005
2972300060,405300,3,2.75,2390,7939,1,1610,780,1983
3575200070,560000,3,2.25,2060,31400,2,2060,0,1984
8146100270,824000,4,2.25,2490,9864,1,1290,1200,1961
8648200030,260000,3,1.75,1100,10968,1,1100,0,1984
0208500160,760000,4,2.5,2430,6099,1,1470,960,1965
1196003428,405000,3,2.5,3170,12750,2,2360,810,1995
5104450990,429900,4,2.5,2640,8625,2,2640,0,1987
3343901234,341500,3,1.5,1130,7223,1,1130,0,1961
0226039214,465250,5,2,1940,7642,1.5,1940,0,1957
1623300160,450000,2,2,1100,3000,1.5,1100,0,1912
2205500575,390000,3,1,1200,10800,1,1200,0,1955
4040800810,420000,3,2.25,2000,8030,1,1000,1000,1963
2612000390,269950,3,2.5,1890,4838,2,1730,160,2002
3814400125,493000,4,2,1910,2874,1,1060,850,1910
7300400060,370000,4,2.5,2710,5880,2,2710,0,1998
1954700695,2.25e+006,5,4.25,4860,9453,1.5,3100,1760,1905
7230200340,305000,3,1,1250,23680,1,1250,0,1967
3191000240,400000,3,1.75,1590,8219,1.5,970,620,1938
1139000069,320000,3,1.5,1240,1221,2,1050,190,2009
5693500270,715000,4,1,2000,4800,2,2000,0,1911
0686500030,650000,6,2.75,3610,10003,1.5,3610,0,1966
8731901940,218000,5,1.75,1930,8040,1,1930,0,1966
2688100071,500000,2,1,1280,5400,1,1280,0,1964
2423069155,460000,4,2,2090,40419,1,2090,0,1984
2329500260,232500,3,1.5,1940,9887,1,1140,800,1969
2608300030,408200,3,2.5,1800,5761,2,1800,0,1990
1494300060,522000,3,1.75,1730,8400,1,1400,330,1980
7504101230,675000,4,2.5,2810,11120,2,2810,0,1982
8081020370,1.355e+006,4,3.5,3550,11000,1,2260,1290,1999
1446800511,249950,4,1,1330,7980,1.5,1330,0,1952
1623049062,210000,2,1,750,34133,1,750,0,1950
6145601000,429950,4,1,1760,7216,1,1090,670,1947
0205000520,737500,4,2.5,3200,36276,2,3200,0,1993
3885805935,710000,4,2,1740,9000,1,1740,0,1958
7852020640,470000,3,2.5,2100,4700,2,2100,0,1999
6838800140,1.1e+006,4,3.5,4270,40097,1,4270,0,1993
4083305445,650000,3,2,1340,2720,1.5,1340,0,1913
7855801610,1.216e+006,4,2.5,3190,8684,1,1680,1510,1967
7940700260,422120,3,2.5,1630,4534,2,1630,0,1987
8854100350,625000,5,2.5,2990,15085,2,2990,0,2007
4365200860,385200,4,1,1550,7740,1.5,1550,0,1954
3904980030,500000,3,2.25,1690,4964,2,1690,0,1989
7843500070,308000,4,2.25,1960,12243,2,1960,0,1989
6067900060,565000,3,2.75,2390,9966,1,1360,1030,1977
7202340960,581000,3,2.5,2600,4438,2,2600,0,2004
1786640070,361000,3,2,1950,8698,1,1950,0,1999
0259600260,345000,3,1,1250,7210,1,1250,0,1964
7234600903,419000,2,2.25,1180,1253,2,840,340,2008
4307350200,347000,3,2.5,1680,4308,2,1680,0,2004
3276930400,625000,4,2.25,2220,36085,2,2220,0,1989
4045100075,2.4e+006,4,4.25,4890,15188,2,3090,1800,1999
1421069208,379000,3,3.25,2660,17852,2.5,2660,0,2014
4057300200,310000,3,1.5,1150,3323,2,1150,0,1988
1922059135,250000,2,2,1130,5500,1,1130,0,1941
5014600240,682000,5,2.75,2760,5000,2,2760,0,2005
1565900070,246500,3,2,1430,8919,1,1430,0,1992
3121059033,325000,3,1,1490,57381,1.5,1490,0,1932
6799300270,310950,4,2.5,2030,4997,2,2030,0,2004
2021200370,1.1e+006,3,2,3010,5000,2,1890,1120,1931
0726049190,287500,3,1,1810,7200,1,1130,680,1954
0726049190,431000,3,1,1810,7200,1,1130,680,1954
4006000251,226000,3,1,970,5000,1,970,0,1968
3362400640,825000,3,1.75,2010,3090,1.5,1510,500,1926
1610000016,175000,4,1,1300,6030,1.5,1300,0,1947
7376300060,465750,3,1.5,1260,10350,1,1260,0,1959
7300200550,659000,4,2.25,2610,24931,2,2610,0,1983
2061100570,595000,3,1.75,1910,5753,1,1110,800,1941
8856890200,350000,3,2.25,1780,16290,2,1780,0,1987
8731951670,270000,4,2.25,1900,8600,1,1900,0,1975
4037200075,662500,6,2.25,2450,25600,1,1340,1110,1957
5066400483,249900,3,1.75,1380,14000,1,1380,0,1939
4167300310,324500,3,1.75,1920,11340,1,1230,690,1977
8682262400,430000,2,1.75,1350,4003,1,1350,0,2004
8682262400,419950,2,1.75,1350,4003,1,1350,0,2004
6777800160,285000,4,1.75,2510,7440,1,1290,1220,1962
1402950550,332000,4,2.5,2470,7780,2,2470,0,2002
2843200070,282000,4,1.75,1660,10725,1,960,700,1956
6450303785,320000,3,1,1340,5175,1,940,400,1987
9429500045,428750,3,1,1620,30736,1.5,1620,0,1911
1443300140,330000,3,2.25,2300,35287,2,2300,0,1977
0108000127,456500,4,3.5,2000,2309,3,2000,0,2008
1081300200,352000,3,2.25,1640,11050,1,1640,0,1972
8818900060,664000,4,2,1530,4080,1.5,1530,0,1912
3395050060,628000,3,1.75,4000,11894,1,2190,1810,1987
7197350070,512000,3,1.75,1610,12555,1,1080,530,1977
9510900270,254000,3,2,2070,9000,1,1450,620,1969
3905081070,535800,4,2.5,1900,5790,2,1900,0,1994
2322069114,287653,3,1,1050,16050,1,1050,0,1960
5637500070,438000,3,2.5,1520,1304,2,1180,340,2006
4164100160,450000,4,1.75,2390,23899,1,1750,640,1949
4136890260,327000,5,2.75,2400,8050,2,2400,0,1998
3056800160,370500,4,2.5,1790,6120,2,1790,0,2005
3654800200,265000,3,2.5,1720,6271,2,1720,0,1993
2296500036,450000,4,2.75,2980,13260,1,1800,1180,1979
0623069068,425000,3,1,1520,213444,1.5,1520,0,1988
1865820370,166600,3,1.75,1150,8690,1,1150,0,1977
1723049033,245000,1,0.75,380,15000,1,380,0,1963
2359300030,565000,3,1,910,5212,1,910,0,1951
6403310060,539900,3,1.75,1650,10150,1,1230,420,1976
1937300270,910000,3,3.5,2480,3200,2,2480,0,2010
4137050060,280000,4,2.5,2050,7416,2,2050,0,1990
2310000240,275000,3,2.25,1420,8549,2,1420,0,1989
3955900830,467000,3,2.5,3460,6590,2,3460,0,2001
8665050060,457500,3,2.5,1500,4445,2,1500,0,1996
3330500875,381156,2,1,1320,3090,1,1320,0,1908
3327020400,289999,5,2.5,2180,8240,1,1220,960,1977
1250700060,642450,3,1.75,1830,4160,1,1230,600,1919
4039300400,469950,3,2.25,1620,8701,1,1220,400,1962
6665800060,795000,3,2,2920,13650,1,1460,1460,1975
7504110030,785000,4,2.5,3300,10514,2,3300,0,1984
7805450810,860000,3,2.25,3060,12095,2,3060,0,1983
6306400140,1.095e+006,0,0,3064,4764,3.5,3064,0,1990
8802400416,147500,3,1,1530,8498,1,1530,0,1959
6204400270,390000,3,2,1910,11576,1,1410,500,1978
9536602080,229000,3,1,1020,8100,1,1020,0,1954
3826000070,185000,3,1,1150,8100,1,1150,0,1932
5101405335,414900,3,1.5,1260,9570,1,870,390,1941
2349300060,200000,4,2,1920,4822,1,920,1000,1914
7749500370,225000,4,2.25,1800,9350,1,1800,0,1969
2436701200,720000,3,1.75,2040,4000,2,1360,680,1924
7871500070,930000,4,2.5,2200,4000,2,1430,770,1908
3323500030,1.27e+006,5,2.5,3200,17204,1,2160,1040,1952
2110200036,700000,5,3.25,2400,3118,2,1780,620,1928
0510002519,466000,2,1.5,1140,1058,3,1140,0,2005
1387300070,374000,3,1.5,1330,10640,1,1330,0,1976
9465910070,480000,3,2.5,1940,10035,2,1940,0,1994
2324800070,740000,3,2.5,3000,25341,2,3000,0,1995
1962200435,1.01e+006,4,1,1820,5400,1.5,1820,0,1923
8562890700,395000,4,2.5,2910,5000,2,2910,0,2002
3298700946,340000,2,1,1090,6771,1,1090,0,1954
0880000189,209000,3,2,1230,1340,2,1020,210,2003
0643500030,431650,5,2.5,1710,7700,1.5,1710,0,1962
8566100200,980000,5,2.5,3160,11470,1,1780,1380,1971
4298100240,660000,3,2.5,2680,28243,2,2680,0,1993
3275780030,730000,4,2.25,2190,9009,2,1840,350,1977
8648220270,291500,3,1.75,1260,9600,1,1260,0,1988
1923000160,905000,4,3.5,2970,14486,2,2340,630,1997
7574910860,800000,4,2.5,2570,50308,1.5,2570,0,1993
2296500136,839900,4,3.5,3810,13592,1,2560,1250,2013
3278600710,200000,1,1.5,1010,1157,2,950,60,2007
2460700260,300000,3,2,1480,6698,1,1080,400,1979
3188100400,530000,3,1.75,1250,6041,1.5,1250,0,1942
9406520830,314950,3,2.25,1654,8479,2,1654,0,1995
3387900390,255000,3,1.75,1410,9315,1,1410,0,1960
1596600024,550000,5,2.75,2160,5720,1,1500,660,1950
7625701891,435000,3,1,1400,4800,1,700,700,1917
3224800075,234000,3,1.75,1420,8738,1,1420,0,1966
7526800200,615000,4,2.25,2500,10062,1,1600,900,1975
3329530200,205000,3,2,1410,8384,1,1410,0,1985
2115200125,384000,4,1.75,2100,7135,1,1050,1050,1955
6623400135,324000,3,2.5,1750,7208,2,1750,0,1994
0103000116,645000,3,1.75,2070,5500,1,1130,940,1946
2768301525,570000,3,3.25,1570,1777,2,1260,310,2007
0739980260,324000,3,2.5,1920,5322,2,1920,0,1999
4302200695,270000,2,1,1000,10320,1,1000,0,1943
1431700370,290000,5,1.5,2120,7700,1.5,2120,0,1962
7524000030,250000,3,2,1440,9220,1,1440,0,1965
4046500320,342000,3,1.75,1660,16275,2,1660,0,1990
4325000125,255000,3,1.5,1340,8450,1,1340,0,1958
3456000160,800000,3,2.25,2380,11824,1,1450,930,1972
9297301580,451000,3,1.75,1560,4049,1.5,1000,560,1926
2465400036,990000,4,2.5,2780,10480,1,1390,1390,1967
5412200270,288400,4,2.5,1860,6687,1,1220,640,1983
1109000390,420000,3,1.5,2390,4600,2,1750,640,1920
8730000270,359000,2,2.75,1370,1140,2,1080,290,2009
7937600830,390000,4,3,2570,262018,1,1420,1150,1988
3395070640,300000,3,2.5,1320,2614,2,1320,0,2005
8663280160,545000,5,2.5,2520,7863,1,1500,1020,1981
6151800624,288349,3,1,1250,18616,1,1250,0,1972
8594400370,299900,3,2.25,1560,35026,1,1290,270,1985
2301400640,891000,4,2,2330,5000,1.5,1720,610,1925
4441300240,1.2e+006,3,2,3660,22410,1,1830,1830,1947
7714000070,378000,4,2.5,2790,4650,2,2790,0,2004
3432500486,299995,2,1,1060,7200,1,1060,0,1951
5466420030,253000,3,2.5,2020,6564,1,1310,710,1994
1324079046,350000,3,2.25,1580,47916,1,1580,0,1979
2768301715,565000,4,3,2020,4300,1.5,2020,0,1900
3332000135,315000,2,1,970,5665,1,970,0,1908
0065000400,570000,4,3,1490,6766,1.5,1490,0,1915
8820901670,971000,5,3.5,4390,10140,2,3350,1040,2005
8712100575,915000,5,2.5,2750,5589,1.5,1840,910,1910
6116500341,419000,4,1.5,2150,23568,1,2150,0,1950
4167300030,260000,4,1.75,1810,7480,1,1230,580,1977
2925059135,1.3215e+006,3,3,2230,12968,2,2230,0,1990
7708300140,369950,3,1,2430,10720,1,2430,0,1977
4139430340,1.0299e+006,3,2.5,3680,13384,2,3680,0,1994
3812400070,435000,5,1,1410,6750,1.5,1410,0,1929
9455200445,601000,3,1.75,1330,6743,1,1330,0,1958
6203000160,460500,3,1,1490,10650,1,1150,340,1963
7517500611,720000,3,2.5,2020,1159,3,2020,0,2000
8691300860,851000,4,2.5,3130,13202,2,3130,0,1996
5489200435,550000,4,3,2670,5000,2,2670,0,1916
0510002065,700000,4,1,1980,4560,1.5,1980,0,1920
0252000400,323000,3,1.75,2100,14850,1,2100,0,1963
7279300070,345500,3,1,1350,8581,1,1350,0,1944
8113101670,378000,4,1.5,2140,7920,1,1190,950,1959
7578200310,650000,4,2,2208,5000,3,2208,0,1917
7715800570,385000,3,2,1010,7380,1,1010,0,1982
6852700478,425000,2,1,970,2970,1,970,0,1910
1917300260,210000,4,2,1520,6174,1.5,1520,0,1920
4298100070,630000,4,2.5,2740,43101,2,2740,0,1993
1842000140,335000,3,1.75,1570,7500,1,1300,270,1953
5462100240,196500,3,1,1320,9000,1,1320,0,1966
8651520510,582800,4,2.75,2550,7636,1,1440,1110,1986
3578110200,440000,3,1.75,1560,7207,1,1250,310,1983
7555210340,752500,4,2.25,2360,8616,2,2360,0,1974
2313900510,532500,3,1.75,1330,5000,2,1210,120,1909
2009001600,265000,3,1,1070,9000,1,1070,0,1950
1455100116,397500,3,1.25,1510,13737,1,810,700,1961
3629790160,524250,3,2.5,1710,3469,2,1710,0,1999
1778350070,765000,4,2.75,2790,10819,2,2790,0,1996
1703050200,648000,4,2.5,2620,5450,2,2620,0,2001
5469700570,469500,5,2.5,2970,24759,1,1670,1300,1969
0100600860,237500,3,1.75,1050,7854,1,1050,0,1975
0421049116,216000,3,1,1280,8712,1,1280,0,1956
3205200640,427200,3,1,1030,8400,1,1030,0,1963
8899200570,280000,3,2.25,1900,7800,1,1390,510,1977
1777500160,718000,5,3,3070,9804,1,1740,1330,1968
7853340860,420000,2,2.75,1760,4139,2,1760,0,2010
1862400132,379000,2,1,930,5400,1,930,0,1952
6380500135,326100,2,1,880,7683,1,880,0,1942
9528104108,535000,3,2.5,1360,1016,3,1310,50,2003
2571910160,283000,4,2.75,2130,8560,1,1560,570,1992
0316000160,260000,3,1,1480,7469,1.5,1120,360,1940
2695600505,399000,4,1,1500,6388,1.5,1500,0,1951
3904910320,484950,3,2.25,1670,5004,2,1670,0,1987
4100000140,640000,4,1.75,2060,9828,1,2060,0,1960
3226049270,585000,4,2.5,2160,8158,1,1660,500,1952
1455600030,645000,4,2,2780,11583,1,1190,1590,1955
5559600140,253000,3,2,1490,7651,1,1490,0,1988
5147600105,178500,2,1,740,6460,1,740,0,1953
7437100570,291000,4,2.5,1860,6325,2,1860,0,1991
8856004730,199950,2,2.75,1590,20917,1.5,1590,0,1920
3856902996,553500,2,1,850,2340,1,850,0,1922
1442800370,189950,2,1,1030,4188,1,1030,0,1981
8001400340,289000,3,2,1850,9550,1,1850,0,1988
3131200640,700000,4,2,1830,4590,2,1830,0,1908
0984000710,270000,3,2,1560,8853,1,1560,0,1967
4167300350,258000,4,1.75,1730,8320,1,1230,500,1977
2826049282,530000,3,2.5,1930,7214,2,1930,0,2005
8946750030,245000,3,2.25,1422,3677,2,1422,0,2012
0461004720,563000,3,2,1380,5000,1.5,1380,0,1917
7852090810,515000,3,2.5,2430,4203,2,2430,0,2001
9264960340,325000,4,2.5,2610,7091,2,2610,0,1987
1624079104,540000,3,2.25,2000,217800,2,2000,0,1996
4310700570,280300,2,1,920,5000,1,490,430,1949
1254200075,460000,4,1.75,1750,5500,1.5,1050,700,1926
7214820030,475000,3,1.75,2020,8970,1,1180,840,1981
0865100055,900000,4,2.25,2460,44431,1,2460,0,1957
0686201000,538200,4,3,1780,7260,1,1780,0,1964
0342000570,429000,2,1,1080,3600,1,1080,0,1922
5476200160,164808,3,1,1250,5411,1,1250,0,1980
7199320570,520000,4,2.25,1870,7700,2,1870,0,1977
6414100560,475000,3,1.75,1700,8432,1,1230,470,1977
1623049214,283000,4,1.5,1480,47045,1,1480,0,1942
2379300340,321500,4,2.5,1930,6228,2,1930,0,2000
7701990560,840000,4,2.75,3130,21810,2,3130,0,1993
2025700860,287000,3,2.25,1370,6000,2,1370,0,1992
8562500200,375000,3,1.75,960,8106,1,960,0,1962
8143100350,349500,3,1.75,1260,7128,1,1260,0,1969
0037000335,446450,3,1.5,1480,7749,1,1480,0,1960
1862900350,315000,4,2.5,1930,9643,2,1930,0,1992
1498302774,271310,2,1,870,5340,1.5,870,0,1906
2224700136,315000,4,1,1300,8400,1.5,1300,0,1953
7697920160,245000,3,1.75,1490,6930,1,1490,0,1990
1370804430,543115,2,1,1380,5484,1,1030,350,1947
2267000160,900000,4,2,1190,8190,1.5,1190,0,1945
5700004028,2.45e+006,4,4.25,4250,6552,2,2870,1380,2008
8682231170,554000,2,2,1920,6045,1,1920,0,2003
3353400860,249900,3,1.75,2080,12522,1,2080,0,1950
2424059035,768000,3,2.5,3220,54160,2,2690,530,1981
2021201000,980000,4,3,3680,5854,1,2060,1620,1967
3919000030,395000,5,2.5,2070,9600,1,1270,800,1962
0789000550,415000,3,1.75,1480,2200,2,1480,0,1995
5104511040,380000,4,2.5,2000,6921,2,2000,0,2003
7215722010,566000,3,2.5,1560,5259,2,1560,0,1999
0016000435,218500,2,1,1600,8961,1,1390,210,1949
7197300105,550000,4,2.5,1940,10500,1,1140,800,1976
2877101031,512031,3,1.75,1540,3000,1,770,770,1920
2892600016,197500,2,1,820,8860,1,820,0,1950
2423020270,470000,3,2.25,1780,8784,1,1230,550,1977
1825079070,590000,3,1.75,1560,242629,1,1560,0,1981
5255710160,465000,4,2.25,2210,8862,1,1270,940,1977
0723069135,499000,2,1.75,2040,114562,1,2040,0,1968
2024059094,515000,3,2.25,1920,11500,1,1920,0,1972
7613700860,716500,3,1.75,1930,5000,1,1230,700,1936
2771101200,410000,3,2,1700,4250,1,890,810,1944
7625704510,850000,4,3.25,3450,6500,2,2450,1000,1994
1762600260,1.05e+006,4,3.25,3440,35021,2,3440,0,1983
2553300030,648000,4,2.5,2380,13435,2,2380,0,1992
5309101200,620000,4,2.25,2400,5350,1.5,1460,940,1929
5416300240,935000,4,4.5,5670,84267,2,5670,0,2008
3756600240,379000,3,1,1140,10320,1,1140,0,1963
8127700445,699000,3,1.75,1670,5375,1,1270,400,1952
9421500070,528000,4,2.25,1910,8005,1,1280,630,1960
9477710160,425000,3,1.75,1560,9452,1,1560,0,1974
1795500240,249500,2,1.75,1500,8645,1,1500,0,1963
7203220260,1.03548e+006,5,3.25,4475,6642,2,4475,0,2014
3524039204,790000,4,2.75,2840,11900,1,1640,1200,1961
5706200060,399950,3,1,1020,18050,1,1020,0,1969
7283900012,275000,3,1.5,1410,9000,1,1410,0,1953
0809001070,550000,3,1,1520,2500,1.5,1520,0,1912
3340401535,140000,1,1,730,6890,1,730,0,1926
1607100139,250000,3,1,1190,6250,1,990,200,1954
8699800060,318000,3,2.25,1410,8909,2,1410,0,1988
0524069037,505000,2,1,1240,57000,1,1240,0,1962
6072600200,470500,5,2.5,2500,9248,1,1300,1200,1966
5144000036,360000,3,1,1050,9206,1.5,1050,0,1954
7855300200,1.2425e+006,4,2.75,2680,8500,1,1480,1200,1962
2485000202,986000,3,2.5,2380,16080,1,1340,1040,1964
9209900270,515000,2,1,1060,4228,1,860,200,1906
6099400030,320000,3,1.75,2300,41900,1,1310,990,1939
9368700223,310000,4,3,2010,7426,1,1090,920,1951
1782000160,356700,2,1,1090,5000,1,730,360,1942
0269001360,775000,4,1.75,2320,5595,1,1510,810,1956
0390100060,325000,3,1,1040,7541,1,1040,0,1951
7888400560,208000,4,2.75,1810,8677,1.5,1810,0,1962
7567600045,825000,2,1,1150,12775,1,1150,0,1908
7764200030,515000,3,2.5,2360,11254,1,2360,0,1990
9828202545,490000,3,1.5,1970,3400,1.5,1420,550,1929
6114600030,675000,4,3,2690,28300,1,2690,0,1954
9834200885,360000,4,2.5,2080,4080,1,1040,1040,1962
9834200885,550000,4,2.5,2080,4080,1,1040,1040,1962
3509600070,225000,3,1.5,1370,9000,1,1370,0,1962
2473002080,500000,3,2.75,3410,9360,1.5,3410,0,1967
1081300370,385000,4,2,1850,11700,1,1850,0,1969
0011501160,837700,5,2.75,3010,12611,2,3010,0,1994
7202330370,448000,3,2.25,1530,3056,2,1530,0,2003
7000100631,730000,5,1.75,2690,21357,1,1420,1270,1952
2484200171,575000,4,1.5,2810,7140,1,1490,1320,1954
9477201040,430000,3,1.75,1810,7300,1,1240,570,1976
7202290160,435000,3,2.5,1560,3987,2,1560,0,2002
4366700140,241000,3,1,1010,9611,1,1010,0,1973
5457300478,453500,2,1.75,1000,1760,1,600,400,1924
9158100116,285000,2,1.5,990,1380,3,990,0,2001
7227500830,151000,2,1,720,4222,1,720,0,1942
7237500390,1.57e+006,5,4.5,6070,14731,2,6070,0,2004
2197600451,631000,5,2,2270,2400,2,2270,0,1905
3278604400,285000,2,2.5,1380,1073,2,1140,240,2011
1788700160,195000,3,1,1260,8378,1,840,420,1959
3276930270,817500,4,2.5,2910,35679,2,2910,0,1987
7374600060,550000,3,2,1810,12825,1,1810,0,1960
2505500030,1.127e+006,4,2.5,3160,8281,2,3160,0,1995
2770604942,609850,2,2.75,1910,1369,3,1910,0,2002
7831800505,200000,3,1,1230,4380,1,1230,0,1947
5416510060,367000,4,2.5,2960,6219,2,2960,0,2006
4137010260,285167,3,2.25,2200,8375,2,2200,0,1988
7683800200,275000,2,1.5,1270,32175,1,1270,0,1947
1509500160,350900,4,2.5,2540,12843,2,2540,0,1992
3904940200,660000,4,3.25,3030,9273,2,3030,0,1988
4037200295,525000,3,1.75,1520,8835,1,1520,0,1957
7258200055,262000,4,2.5,1560,7800,2,1560,0,1997
9178600560,690000,2,1,970,4560,1,970,0,1907
0255520260,624000,5,3.75,3570,14648,2,3570,0,2005
0751000060,353000,3,1,1350,7740,1,860,490,1947
3343900326,552500,4,3.5,3710,10400,2,2290,1420,2002
7137900320,224500,4,1,1430,8355,1.5,1430,0,1983
2641800060,239000,3,1,940,8571,1,940,0,1950
0293760310,975000,5,4.5,4300,12250,2,4300,0,2004
7237501180,1.2e+006,4,1.75,3990,13470,2,3990,0,2006
5332200550,505000,3,1,1380,4000,1.5,1380,0,1910
3450300240,302000,4,1.75,2020,7865,1,1010,1010,1963
9352900695,170000,3,1,1480,5670,1,780,700,1944
3324069070,195000,2,1,1190,27007,1,1190,0,1910
8062900070,272000,5,1.5,2550,6300,1,1560,990,1959
8062900070,369000,5,1.5,2550,6300,1,1560,990,1959
4427100030,332500,3,1.5,1500,6332,1,1500,0,1953
4039100400,515000,3,2.5,3000,8250,1,1760,1240,1963
2171400126,269000,3,1,1690,4250,1,1020,670,1967
7135520810,1.278e+006,4,4,4390,17832,1,2430,1960,1994
2475201180,303000,3,2.5,1560,4100,2,1560,0,1985
4024100951,420000,7,3,2940,8624,1,1690,1250,1977
6021502830,400000,3,1,1130,4100,1,990,140,1941
7710100083,225000,3,1,1020,8437,1,1020,0,1987
2781270550,219000,2,2,1310,2550,2,1310,0,2004
0200510060,605000,3,2.5,2570,9487,2,2570,0,1989
9554200105,625000,4,2,2020,6867,1,1010,1010,1942
3320000810,380000,5,2,1680,3240,1,840,840,1906
0643500060,620000,4,2,1770,7700,1.5,1770,0,1962
2537500140,687500,4,2.75,3190,10970,2,3190,0,1994
5112800421,225500,4,2,1440,7950,1,1440,0,1962
3352402236,252500,3,2,1150,6000,1,1150,0,1956
3905100520,510000,3,2.5,1860,3658,2,1860,0,1994
6332940070,510000,4,2.5,2430,5203,2,2430,0,2003
0809002435,725000,3,2.5,1940,4000,1.5,1940,0,1906
3421079032,75000,1,0,670,43377,1,670,0,1966
3797000295,492000,2,1,880,2970,1,880,0,1927
1775801260,425000,4,2.5,1930,14196,1,1330,600,1977
4055701200,1.955e+006,4,2.75,3120,7898,1,1560,1560,1963
7137960030,298900,3,2.5,1830,6162,2,1830,0,1994
7880010060,699000,4,2.5,3230,40319,2,3230,0,1987
3797001920,310000,2,1,700,3000,1,700,0,1918
3901100055,350000,3,1.75,1010,8580,1,1010,0,1961
8069000075,790000,4,1.75,2460,10061,1,1410,1050,1961
1541700240,305000,4,2.5,2230,5000,2,2230,0,2003
6064800710,315000,3,2.5,1570,2865,2,1570,0,2003
1865810060,267500,5,3.5,2390,6600,2,2390,0,1977
7533800295,1.75e+006,4,3.25,3460,7749,2,3020,440,1950
5415300060,435000,6,3.5,2400,8620,2,1640,760,1987
3876100320,482500,6,4.5,2940,7500,1.5,2940,0,1966
1247600105,5.1108e+006,5,5.25,8010,45517,2,5990,2020,1999
3705900238,439995,3,1.75,1570,8400,1,1570,0,1959
3876200070,460000,3,3,1520,7500,1,1180,340,1967
4388000140,194000,3,1,1070,6440,1,1070,0,1971
3523029041,290000,2,0.75,440,8313,1,440,0,1943
3110800260,274700,4,2,2440,9600,1,1220,1220,1963
3131201290,900000,4,2.5,2660,3672,2,1800,860,1910
1117200390,1.15e+006,4,4,4460,103382,2,4460,0,2001
8956000350,605000,3,2.5,2010,3667,2,2010,0,2008
7853210140,359000,3,2.5,1450,3850,2,1450,0,2004
3250500140,850000,3,1.75,1400,9900,1,1400,0,1951
2767601375,505000,3,2,1500,2500,2,1500,0,2002
9465910320,565000,3,2.5,2500,7394,2,2500,0,1990
3334000055,585000,2,1.75,1280,7110,1,1000,280,1955
7893800335,328000,4,3.25,3380,7500,2,2420,960,1990
3586500700,749950,4,2.75,2910,18700,1,2210,700,1957
3630180400,826000,4,2.5,3060,7140,2,3060,0,2006
3210950510,535000,3,1,1330,40259,1,1330,0,1977
1224069074,925000,4,2.5,3300,101930,2,3300,0,1991
7625700935,875000,3,3.5,3250,6000,2,2500,750,2001
7856610200,902000,4,2.25,2530,9200,1,1570,960,1976
7287100135,423000,3,1,1830,13900,1,1830,0,1951
1023059324,235000,3,1,1170,11100,1,1170,0,1968
6398000171,545000,2,2,2930,14057,1,1680,1250,1980
6149700350,343000,2,1,1230,7560,1,1230,0,1961
9558020890,334950,3,2.5,1620,2930,2,1620,0,2002
2624049185,405000,3,1.75,1760,5355,1,1160,600,1956
0236400260,220000,4,1,1440,8250,1,1440,0,1959
3826000560,173000,2,1,1740,8100,1,1050,690,1947
7011201245,655000,3,1,1270,3600,1.5,1270,0,1906
9222400510,406000,2,1,880,3000,1,880,0,1924
9455200570,632000,6,2.5,2560,8320,1,1370,1190,1961
2112700030,357000,5,2.75,1540,4000,1,1140,400,1990
8658300260,361000,3,1.75,1150,17585,1,1150,0,1964
3996900160,277000,2,1,770,8149,1,770,0,1948
5561400340,630000,4,3.75,4610,40202,1,2500,2110,1980
0011900140,254000,3,2.5,1850,4597,2,1850,0,2003
6071600340,472800,3,2.25,1840,8400,1,1290,550,1961
1231000510,263000,3,1.75,1490,3800,1,700,790,1913
1231000510,510000,3,1.75,1490,3800,1,700,790,1913
7683800192,179950,3,1,960,10125,1,960,0,1952
4123400340,525000,4,2.25,1580,7307,1,1160,420,1973
5458300685,479000,3,2.5,1260,889,3,1260,0,2008
0194000505,651000,3,2,1940,6440,1,970,970,1940
3885804305,949000,4,1.75,2490,7834,1,1240,1250,1958
3971700560,392400,5,2.5,2520,27951,1.5,1890,630,1942
8585400135,585000,4,1.75,1760,5356,1,920,840,1950
8691500990,460000,4,2.5,4190,7504,2,4190,0,2004
2770606685,470000,3,1,1170,4400,1,870,300,1951
8856971000,245000,3,2.5,1600,4271,2,1600,0,2003
1026049082,500000,4,2,2760,27631,2,1800,960,1978
2095800400,455000,3,2.5,2090,8653,2,2090,0,1989
7852030240,485500,4,2.5,2320,3974,2,2320,0,1999
6321000045,1.875e+006,5,3.25,4110,7920,2,3150,960,1921
3751600030,100000,2,1,770,17334,1,770,0,1978
4046500510,307000,3,1.75,1410,16105,1,1410,0,1982
8029520240,475000,4,3.5,3660,14401,2,2660,1000,1994
7016310030,330000,4,2.5,2180,7210,1,1190,990,1972
1238500451,130000,3,1,1110,7520,1,1110,0,1960
4401150070,320000,3,2.5,2280,7417,2,2280,0,1998
3331000070,735000,4,2.5,2820,6180,2,2050,770,2013
2636900126,365000,4,2.5,1570,9600,1,800,770,1972
1842900030,234000,3,1.5,1200,11935,1,1200,0,1968
1761300310,211000,4,2,1710,8288,1.5,1710,0,1970
5249800729,680000,6,3.5,3000,6320,2,2400,600,1969
5104511600,457000,4,3,2800,7845,2,2800,0,2002
8663370060,349000,3,2.25,1640,7261,2,1640,0,1989
0613400030,360000,3,2.75,2030,6840,1,1210,820,1979
6004510240,350000,4,2.5,2530,10155,2,2530,0,1998
1450100070,208000,3,1,990,7420,1,990,0,1960
6117501820,250275,2,1,790,11234,1,790,0,1942
6117501820,435000,2,1,790,11234,1,790,0,1942
5420300240,270000,3,1.75,1800,7763,1,1470,330,1984
4140900140,438000,3,1.75,1650,12940,1,1650,0,1961
1630700135,659000,4,2,1980,23625,2,1980,0,1938
5166700055,645000,4,2.75,2340,6350,1,1310,1030,1974
3224600310,685100,4,2.5,2790,5423,2,2790,0,1999
7227802030,350000,7,3,2800,9569,1,1400,1400,1963
0226059078,375000,2,1,1840,81892,1,1840,0,1955
1796100140,170000,3,1.5,1350,81549,1,1350,0,1966
5309100140,880000,4,2.5,3030,3841,3,3030,0,2005
8658300510,410500,4,2.5,1980,5000,2,1980,0,2008
8691300060,780000,4,2.5,3690,13609,2,3690,0,1996
9103000393,1.225e+006,5,4.5,3732,4426,2.5,2932,800,2001
8682281170,449000,2,1.75,1510,6852,1,1510,0,2005
0472000055,546000,3,1.75,2000,5000,1,1110,890,1921
2473400570,317000,3,2,1760,11410,1,1060,700,1977
3449500135,276900,3,1,1270,7566,1,1270,0,1958
1926049355,399000,5,2,2620,7030,1,1420,1200,1965
8650000070,495000,5,2.75,2630,10165,1,1690,940,1976
8732131200,258000,3,1.75,2270,9000,1,1330,940,1978
1624079051,600000,2,2.5,2410,102366,1,1940,470,1912
0993001629,265000,3,2.75,1120,881,3,1120,0,1999
3832711040,321000,5,2.75,3030,7000,1,1540,1490,1978
5244801230,682000,5,2.25,2120,4000,1.5,1720,400,1910
2798600240,295700,4,2.5,1720,5805,2,1720,0,2000
5701800030,609000,4,2.5,2150,37981,2,2150,0,1985
7636800041,995000,3,4.5,4380,47044,2,3720,660,1968
3904901200,530000,3,2.25,2010,11817,2,2010,0,1986
4109600055,614000,5,2.5,3150,5150,2,1870,1280,1907
3339400349,390000,3,2.5,2500,21780,1,1770,730,1986
7202340370,467000,3,2.5,1690,6642,2,1690,0,2004
9477500060,484000,6,2.5,3300,13501,1,2060,1240,1980
4310701600,340000,3,2.5,1240,1115,3,1240,0,2003
2215450060,302495,3,2.5,2200,7201,2,2200,0,1994
2919702075,532500,3,1.75,1620,3360,1,980,640,1927
8079030350,441500,3,2.5,2420,9592,2,1780,640,1993
7893804340,470000,4,2.5,2680,8062,1,1530,1150,1967
4389200765,2.3e+006,4,3.25,4250,8570,2,4250,0,2004
1822069116,590000,3,2.5,2400,99752,1,2400,0,1996
7276100282,320000,3,1.75,2300,12000,1,1770,530,1942
0567000392,363000,2,2,920,1201,2,800,120,2009
5729200030,747500,4,2.25,2350,18600,2,2350,0,1977
8682220390,750000,2,2.5,2630,7957,2,2630,0,2003
9828700200,831000,4,3,2170,4000,2,1610,560,1982
7852180560,403000,3,2.5,1700,4125,2,1700,0,2004
3655400060,445000,3,2.5,2470,4565,2,2470,0,2005
7955030060,345000,3,1,1250,17380,1,1250,0,1970
8964800445,2.26e+006,3,3.5,3110,14872,1,3110,0,2003
6204410200,371025,3,2,1530,8925,1,1530,0,1977
7625702400,355000,2,1,960,6250,1,960,0,1916
5113200310,270000,3,1,1240,14110,1,1240,0,1972
7893802800,425000,4,2.75,2440,15349,2,2440,0,1957
2473003210,364808,3,1.75,2320,7875,1,1620,700,1967
1402600570,320000,3,2.25,1580,6561,1,1200,380,1981
8944460030,325000,4,2.5,2963,5797,2,2963,0,2006
2473480560,350000,3,2.25,2470,10290,2,2230,240,1984
3365900465,170000,3,1.5,1370,10176,1,1370,0,1947
5341600030,255000,2,1,960,28717,1,960,0,1984
6073500160,550000,3,1,1130,7500,1,880,250,1947
2025760160,835000,4,4.25,4930,25714,2,4930,0,2005
9393700140,420000,3,1,1150,5120,1,800,350,1946
5458800125,925000,4,2.5,2190,7350,2.5,2190,0,1958
2492200435,389250,2,1.5,1490,4080,1,930,560,1956
3759500046,748000,3,2.5,2600,10183,1,1300,1300,2004
8648220260,284000,3,1.75,1530,9600,1,1200,330,1988
6392001670,588000,4,2,1680,5000,1,980,700,1950
2026049155,372500,3,1.75,1680,8648,1,1680,0,1963
2329800240,285000,4,3,1900,7194,2,1900,0,1988
3380900125,360000,3,1,1570,9467,1,1570,0,1954
1324079041,275000,3,1,1370,17859,1,1150,220,1930
8682230550,428000,2,2,1350,4225,1,1350,0,2003
0853400240,847000,6,2.5,3010,17864,2,3010,0,1969
2130702075,316000,3,1,1010,7838,1,1010,0,1977
3260810260,375000,3,2.5,2050,7205,2,2050,0,2000
2878600200,533000,3,1,1670,4080,1,1170,500,1967
7298040310,556000,5,2.5,3840,16905,2,3840,0,1991
0766000240,225000,4,2,2220,14120,1,1200,1020,1966
3459700340,537250,4,2.5,2590,9530,1,1640,950,1978
2473251180,255000,3,1,1180,13650,1,1180,0,1967
2407900200,530000,4,2.5,2950,4836,2,2950,0,2006
7558700030,5.3e+006,6,6,7390,24829,2,5000,2390,1991
0203600140,595000,3,2.75,2150,31238,2,2150,0,1996
4037800140,548000,4,2,2100,8880,1,2100,0,1958
1683600240,234975,3,1.75,1650,8073,1,1100,550,1980
1962200036,600000,3,1.75,1620,1325,2.5,1430,190,2005
1775800510,432000,4,1,1750,12528,1,1750,0,1967
1822350070,455000,3,1.5,1380,6657,2,1380,0,1986
7772400160,279950,3,1.75,1510,11234,1,1210,300,1965
0273900030,267500,3,1.5,1600,9072,1,1600,0,1963
3323069084,620000,4,2.5,1840,220308,2,1840,0,2000
4337000160,110000,2,1,830,7590,1,830,0,1943
9126100550,625000,3,3.5,1810,1846,2,1440,370,2009
5101405274,389000,2,1,910,7000,1,910,0,1952
4232400860,1.2e+006,4,2,2120,3360,2,2120,0,1905
2723069082,788500,4,2.25,2510,133729,2,2510,0,1977
7436500270,567000,5,2.25,2100,6936,1,1600,500,1974
5153200030,515000,2,2.25,2690,15000,1,1870,820,1987
4022900125,605000,4,2.5,2430,11870,1,1590,840,1968
7841300505,430000,4,3.75,2452,4800,2,2452,0,1936
0573000685,805000,2,1.75,1550,6000,1,1550,0,1920
8961990160,567500,3,2.5,2080,4556,2,2080,0,1999
1250202255,647500,3,1.75,1290,3870,1,1290,0,1916
7234600796,495000,2,1.75,1850,2530,2.5,1850,0,1903
3630180340,825000,4,2.5,3370,5000,2,3370,0,2006
5104450070,435000,4,2.25,2730,7506,2,2730,0,1987
9477100060,445950,3,1.75,1300,7800,1,1300,0,1968
4139440830,960000,5,2.75,3040,10257,2,3040,0,1993
6772200055,780000,4,3,2440,3600,1.5,1480,960,1929
8731982190,274500,3,2.25,1720,9000,1,1320,400,1969
6300000335,729953,5,3,3230,5167,1.5,2000,1230,1909
9301300751,464950,3,1.5,1200,890,2,1030,170,2008
9542100135,620000,4,1.75,2350,18800,1,2350,0,1959
8691410700,735000,4,3.5,3100,5600,2,3100,0,2005
0217500135,450000,4,2.25,2040,9565,1,1400,640,1959
3731800055,450000,4,1,2000,4676,1.5,1250,750,1916
7234600786,842500,4,2.5,2160,5298,2.5,2160,0,1902
2423059104,360000,3,2,1970,79714,1,1070,900,1979
1823039205,585000,3,2.5,2270,100545,2,2270,0,1998
2423020260,461000,3,2.25,1850,7923,1,1150,700,1977
2695600070,345000,2,1,1350,4494,1,920,430,1949
6844703240,1.075e+006,3,2.5,3280,10302,1,1680,1600,1970
3904940070,643000,4,2.5,2270,8391,2,2270,0,1988
1939130070,690000,4,2.5,2820,8307,2,2820,0,1990
5589300370,282000,4,1,1200,11111,1.5,1200,0,1949
3526039116,549000,3,1.75,2000,6130,1,1120,880,1951
6821600390,815000,3,2,2310,6000,2,1560,750,1926
1925069082,2.2e+006,5,4.25,4640,22703,2,2860,1780,1952
8100400160,700000,3,2.25,2330,11424,2,2330,0,1984
5556300102,933399,3,2.5,3940,10360,2,3110,830,1992
7222000393,290000,3,1,1440,11250,1,1440,0,1967
9407001860,372000,4,1.75,1960,9300,1,1340,620,1979
9468200140,450000,2,1.75,1250,2890,1,790,460,1920
3295950240,303700,3,2.5,1981,5700,2,1981,0,2010
3905000340,672000,4,2.5,2440,10049,2,2440,0,1989
3374300070,334000,4,1.5,1150,9360,1.5,1150,0,1970
7812800310,260000,2,1,1120,5650,1,1120,0,1944
7015200685,749950,3,1.75,1800,5700,1,1000,800,1941
3521069051,330000,4,2.25,2380,122038,2,2380,0,1984
8032700140,830000,5,3,2920,2808,2,2140,780,1960
6117500320,1.131e+006,3,2.25,2790,13791,1,2790,0,2006
7305300045,320000,3,1,1560,7552,1,910,650,1948
0922069139,260000,2,1,1550,15250,1.5,1550,0,1920
0084000335,225000,3,2,1700,11475,1,970,730,1945
9232400055,279200,1,1,640,6350,1,640,0,1939
1453600202,520000,4,3.5,2680,10000,2,2040,640,1942
3904910520,505000,3,2.5,1860,8060,2,1860,0,1987
5469300270,234000,3,1.75,1490,8366,1,1010,480,1975
8681660060,503000,4,2.5,2470,5044,2,2470,0,2005
3902300350,606000,4,2.25,2390,8858,1,1740,650,1979
6392003490,433500,3,1,1230,6000,1,780,450,1937
3342700465,250000,3,1.5,2840,10182,1,1510,1330,1951
2592210160,719000,3,2.5,2120,9307,2,2120,0,1984
0616000160,381000,3,2,1770,14400,1,1770,0,1959
1687000270,267000,3,2.5,2495,4400,2,2495,0,2007
4102000075,275000,1,0.75,1170,14149,1,880,290,1962
8078460550,651000,4,2.5,2740,7140,2,2740,0,1993
2710600070,439000,2,1,1050,5671,1,850,200,1949
0037000435,325000,2,1,1130,5070,1,1130,0,1955
5100401414,490000,2,1,880,6380,1,880,0,1938
5631500254,519900,4,2.5,2403,6172,2,2403,0,1999
8567300140,545000,4,2.75,3410,35040,2,3410,0,1984
0098000060,1.0625e+006,4,4,5320,20041,2,5320,0,2003
2205500400,542000,4,1.75,1900,8250,1,950,950,1955
1726069084,465000,4,1.75,1810,21650,2,1810,0,1961
8682291840,408000,2,2,1200,3900,1,1200,0,2006
5003600240,292000,4,2.5,2060,5950,2,2060,0,2000
5636000400,253000,3,1.75,1250,10122,1,1250,0,1994
3298700125,280000,2,1,910,4662,1,910,0,1942
7880000060,658588,3,2.25,2560,41346,2,2560,0,1986
7811200310,635000,4,2.25,1920,8910,1,1200,720,1969
5255690160,439000,4,2.25,2240,8300,2,2240,0,1978
0869700320,300000,3,2.5,1260,3855,2,1260,0,1999
6052401631,345000,3,1.5,1360,13496,1,1360,0,1960
5089700260,283500,4,2.25,2100,8050,2,2100,0,1978
9473200105,425000,2,1,2110,4920,1.5,1460,650,1911
6678900140,685000,3,1.75,2210,8955,1,1560,650,1974
9552700550,750000,3,2.5,2360,12987,2,2360,0,1983
2171400218,245000,4,1.5,1280,8000,1,1280,0,1960
9122001231,585444,6,3.75,2740,6924,1,1640,1100,1962
6639900012,706000,4,2.5,2740,7571,2,2740,0,2009
8151601090,445000,4,2,2630,9099,1.5,1830,800,1944
6664900260,241000,3,2,1650,6000,1,1650,0,1990
7663700030,1.175e+006,2,2.5,1770,7155,2,1770,0,1957
0952000055,530000,3,1,1500,5750,1.5,1050,450,1927
4292300024,350000,3,1.5,1430,12199,1,1130,300,1948
8073000550,1.7e+006,4,3.75,3190,17186,2,3190,0,1999
9238450160,389000,3,1,1280,9630,1,1280,0,1968
6127600036,799000,4,2.75,2390,6820,2,2140,250,1945
1370801331,1.4e+006,4,2.5,4040,9630,1,2020,2020,1951
3500100226,340895,2,1,920,8612,1,920,0,1947
0319500570,780000,4,2.5,2730,10281,2,2730,0,1996
3751604974,350000,2,1.5,1320,73600,1,1320,0,1993
7852030320,470000,3,2.5,2620,4874,2,2620,0,1999
2481630070,914600,4,3,3180,80837,2,3180,0,1985
4299000030,354000,4,2.5,2900,4762,2,2900,0,2005
3886902590,470000,5,2,1900,6000,1.5,1900,0,1920
9178601000,715000,3,2,1760,5400,1,1160,600,1927
2861100030,265000,2,1,760,4000,1,760,0,1950
9471200370,2.537e+006,4,3,3710,20000,2,2760,950,1936
0625049286,640000,3,1,1530,4944,1,1530,0,1950
0133000135,290000,4,1.75,1990,18900,2,1870,120,1929
7214700830,480000,5,4.75,3830,35000,1,2130,1700,1976
4473400045,535000,3,2,2040,5600,1,1120,920,1954
9413600350,907000,3,1.75,2170,12220,1,2170,0,1965
1138010520,459000,3,1.75,1620,7330,1,1090,530,1974
7431500341,1.355e+006,3,2.5,3600,21399,1,2310,1290,1950
8830400135,264950,3,1.5,1470,11599,1,1070,400,1967
5694000710,352950,3,1,1760,3000,1.5,1760,0,1900
1951820070,491500,3,2.25,2230,13100,1,1510,720,1974
6137500320,1.229e+006,4,3.5,3770,37034,2,2830,940,1989
6703100070,369500,3,1,1200,9194,1,1200,0,1952
0339350070,566000,3,2.5,2090,6294,2,2090,0,2004
7399300860,290000,3,2.25,1500,7308,1,1210,290,1968
8907500070,5.35e+006,5,5,8000,23985,2,6720,1280,2009
8651430560,180000,3,1,870,5330,1,870,0,1969
2228900270,215000,2,1,1010,6000,1,1010,0,1944
2228900270,302000,2,1,1010,6000,1,1010,0,1944
6880200030,352500,3,1.75,1860,7881,1,1160,700,1986
7227501170,235867,4,2,1330,5926,1,1330,0,1942
7504460200,500000,3,2.25,1760,11946,2,1760,0,1978
1559900200,382000,3,2.25,1800,4500,2,1800,0,1995
0546000400,515000,5,2.5,1690,2402,1.5,990,700,1930
1596600060,250000,1,1,660,2600,1,660,0,1919
6021501920,672500,3,2.25,2400,5300,1.5,1250,1150,1939
3275860270,755000,3,2.25,3020,13031,2,3020,0,1989
5457300703,707500,3,1,1500,2555,2,1500,0,1910
2919700885,459000,4,2,1560,3840,1,960,600,1924
1951500030,140000,3,1,1090,10620,1.5,1090,0,1959
9550200310,495000,2,1,970,4284,1,970,0,1905
3630120700,757000,3,3.25,3190,5283,2,3190,0,2007
3630120700,765000,3,3.25,3190,5283,2,3190,0,2007
6370000070,359000,4,1.5,1890,6052,1,1890,0,1955
7935000125,440000,3,1,1050,7500,1,1050,0,1900
3034200058,400000,4,1.5,1390,7200,1,1140,250,1965
2856102336,652000,3,2,1700,4080,1,850,850,1941
2523039239,260000,3,1.75,1050,5850,1,1050,0,1980
5452800310,1.328e+006,5,3,3340,10796,1,2120,1220,1964
2724069070,519500,4,2,1540,17859,1,1540,0,1964
6690500320,650000,3,1,1710,5992,1.5,1560,150,1928
2413301070,280000,4,2.25,2100,8075,2,2100,0,1978
1562100030,515000,4,1.75,1730,7980,1,1730,0,1965
7941140070,400000,3,2.25,1500,2692,2,1500,0,1986
1703050520,652100,3,2.5,2380,5017,2,2380,0,2003
2412600030,235000,6,3,2180,7956,2,2180,0,1980
5266300140,701000,4,1.5,1840,10080,2,1840,0,1907
0011520030,640000,4,2.5,2341,9594,2,2341,0,1997
7202290140,455800,3,2.5,1690,4584,2,1690,0,2002
8161010060,504750,3,2.5,2490,21937,2,2490,0,1993
8562900710,483000,3,3,2440,15540,2,2440,0,1992
8888000055,530000,3,0.75,920,20412,1,920,0,1950
3395800295,250000,2,1,1030,8786,1,1030,0,1956
5557320030,229950,5,2.75,2000,5885,1,1260,740,1994
2909300640,884744,4,3.5,4210,9414,2,4210,0,2001
5202500030,514000,3,1.5,1610,9964,1,1080,530,1977
5561300640,532000,3,2.25,1910,35015,1,1430,480,1977
3449900030,423000,4,2.5,2660,5539,2,2660,0,2004
0952003435,420000,2,1,820,4025,1,820,0,1922
6204200340,521000,3,1.75,1730,18250,1,1730,0,1988
1737100830,577000,4,2.25,2360,7490,2,2360,0,1979
2207200520,425000,3,1,970,8040,1,970,0,1956
3818400060,495000,4,2.5,2460,4862,2,2460,0,2004
9264960560,340000,3,2.5,2690,8577,2,2690,0,1987
6362900172,499950,3,3.5,1820,1991,2,1430,390,2014
9272200810,1.218e+006,4,3,3470,4750,2,2370,1100,2014
3629160060,720000,4,2.75,3370,7634,1,2110,1260,1977
4324200060,249000,3,1.5,1700,8247,1,1010,690,1970
3830620710,206135,3,1,1340,11070,1,1340,0,1978
3276900030,300000,5,2.75,2000,9276,2,2000,0,1968
4058800830,612000,6,3,3840,14040,1.5,2460,1380,1949
6202600070,1.10203e+006,5,2.5,3890,27311,2,3890,0,1950
8581200030,230000,4,2,1220,9100,1.5,1220,0,1970
2771601940,850000,3,1,2280,4600,1,1250,1030,1936
2214800270,355000,4,2.5,2770,7000,1,1940,830,1979
7312000240,442000,4,2.5,2520,7253,2,2520,0,1990
8562890560,399000,4,3,3060,5000,2,3060,0,2001
4136930310,360000,4,2.5,2390,7115,2,2390,0,1999
1328330350,390000,3,1.75,1320,7725,1,1320,0,1978
5255690060,413000,5,2.5,2900,8711,1,1650,1250,1977
0402000260,190000,2,1,700,9500,1,700,0,1951
7787110060,432900,3,2.5,2210,9226,2,2210,0,1998
8651580310,621138,3,2.25,2180,7741,2,2180,0,1986
3705000060,270000,3,2.25,2080,4252,1.5,1550,530,2003
7525410060,610000,4,2.25,2090,35040,1,1490,600,1980
3295700060,500000,3,2,1720,5525,1,960,760,1941
8121500060,715000,4,2.25,2460,40635,1,2460,0,1968
3728800320,264000,3,1.5,1470,14821,1,1470,0,1958
6003501535,550000,3,1.75,1650,3200,1.5,1650,0,1901
2621750340,337000,3,2,1690,9087,1,1690,0,1997
3445000274,170000,3,1,970,8710,1,970,0,1962
3288200030,405000,4,2.5,2030,9095,1,1130,900,1972
4188000640,775000,4,2.5,2540,28563,1,2540,0,1984
2558730070,425000,3,2.25,1570,7475,1,1200,370,1983
7923500060,713000,5,2.75,2580,9242,2,1720,860,1967
8016300030,555000,5,2.5,2090,8712,1,1420,670,1966
3629920830,810000,4,2.5,3260,5608,2,3260,0,2003
4054510270,1.25e+006,4,3.75,3830,41263,2,3830,0,1990
2864600105,819000,3,3.5,2130,6150,2,1530,600,1908
8165500830,409900,3,2.5,1690,1200,2,1410,280,2013
4395600060,935000,2,2.5,1780,2067,2,1780,0,1974
4444800045,657500,4,1.75,1620,7560,1,1380,240,1947
1115300270,900000,6,3.75,4210,6105,2,3280,930,2008
5363200200,932800,5,3.25,2980,7095,2.5,2980,0,1998
6067900640,391000,3,2,1490,9000,1,1490,0,1977
4279200060,420000,4,2.5,2110,9825,2,2110,0,2000
3425059222,1.3e+006,6,3.5,6563,32670,2,5153,1410,2002
5253300397,415000,3,1.5,1510,16800,1,1510,0,1956
1769600204,350000,3,1.75,1830,9425,1,1590,240,1946
1176001195,375000,2,1,1230,1820,2,830,400,1948
1239400570,860000,3,1.75,2180,14135,1,1300,880,1947
6071600270,495000,4,2.25,2220,8872,1,1110,1110,1961
1311100520,250000,4,2.25,1730,8400,1,1730,0,1962
1402200070,365000,4,2.25,1990,21312,1,1990,0,1968
1419700270,503000,3,2.75,1540,6760,1,1210,330,1980
5126900310,150000,2,1,1100,7200,1,1100,0,1944
8816400885,450000,4,1.75,1640,1480,1,820,820,1912
5412100550,355000,4,3,2590,7213,2,2590,0,2001
7203000465,245000,3,2,1450,9333,2,1450,0,1972
1862900160,265900,3,2,1180,7793,1,1180,0,1992
0984220240,299000,4,2.5,1820,7575,1,1220,600,1975
4458800060,957500,4,2.25,2360,11523,2,2360,0,1968
1138000160,343000,3,1,1120,7250,1,1120,0,1972
9406520550,307500,3,2.25,1646,7364,2,1646,0,1994
7852160070,937500,5,3.75,4210,14599,2,4210,0,2004
7214700160,610000,3,3,2480,45302,1,1620,860,1976
2483700160,720000,3,1.5,1590,7080,1,1310,280,1952
1972201820,610000,4,2,2130,2620,1.5,1650,480,1919
9477000060,434500,3,1.75,1650,7965,1,1650,0,1967
7932000041,602500,2,2.5,3090,47044,1,2250,840,1979
1231000520,607010,4,2.5,2180,4000,2,1700,480,2002
7522500070,610000,3,1,1800,5750,1,1040,760,1947
4215250310,828500,4,2.5,3720,35000,2,3720,0,1983
5560000070,199990,3,1,1100,8560,1,1100,0,1961
1545804460,294000,3,1.75,1530,9362,1,1530,0,1987
9510970310,789500,4,2.5,3010,6100,2,3010,0,2005
0098030160,797000,3,3.5,3500,9473,2,3500,0,2008
7853300070,539950,5,3,3100,5250,2,3100,0,2006
0934300140,284950,4,1.5,2000,6778,1,1170,830,1962
1245001820,776500,4,1.5,2290,10372,1,1510,780,1965
1974200060,525000,4,2.5,2400,10070,1,1510,890,1967
7300410060,303000,3,2.5,1850,4957,2,1850,0,1999
1939110310,722080,3,3.25,3680,7650,2,2340,1340,1988
7888000390,140000,3,1,1060,7473,1,1060,0,1959
7888000390,235000,3,1,1060,7473,1,1060,0,1959
1529300435,440000,3,1,1610,5500,1.5,1610,0,1903
2960900045,605000,3,1.75,2330,6000,1.5,1630,700,1940
3959400135,380000,2,1,1210,4800,1,1060,150,1950
7972600765,352000,4,1,1530,8890,1,980,550,1925
7214810550,420000,4,2.25,2270,12000,1,1360,910,1979
3271801090,1.175e+006,4,2,2590,7220,2,2590,0,1930
8964800370,1.375e+006,3,1.5,1850,10572,1,1850,0,1953
8019200030,300000,3,1.5,1500,14750,1.5,1500,0,1933
2954400400,1.15e+006,4,3.25,4740,49091,2,4740,0,1990
3013301525,453500,2,1.5,1710,4189,1,1160,550,1951
3303100075,443500,3,2,1920,7598,1,1920,0,1972
2004100075,332000,2,1,1150,8138,1,1150,0,1954
4221270340,655000,3,2.5,2320,4721,2,2320,0,2004
7177300575,475000,4,1,1420,6000,1.5,1420,0,1950
1471630350,372500,3,1.75,1550,12956,1,1210,340,1988
1250203335,1.05e+006,4,2.5,2920,7200,1,1470,1450,1921
8815400105,500000,3,1.75,1620,4200,1,830,790,1945
5315100737,900000,6,2.75,2300,24773,1.5,2300,0,1950
3333002440,327500,3,1,1070,7140,1,1070,0,1989
2130702205,390000,3,1.75,1790,7123,1,1790,0,1913
2159900060,451101,2,1.5,1510,1962,2,1510,0,1985
0194000575,455000,4,1,1340,5800,1.5,1340,0,1914
1531000140,650000,4,2.5,3350,46748,2,3350,0,2004
2125049139,895000,3,2.5,2500,7746,2,1910,590,1993
3623500135,800000,4,2.25,2350,10664,1,1510,840,1952
7805460310,703770,4,2.25,2550,12918,2,2550,0,1987
3021059244,249950,3,1.75,1320,10454,1,1320,0,1968
0925049360,512000,2,2,1270,3881,1,610,660,1926
3286800260,780000,5,2.5,3480,74052,1,1980,1500,1972
4137010240,336000,3,2.25,2820,11625,2,2820,0,1986
9368700341,285000,3,2,2110,6900,1.5,1220,890,1955
3832310350,229900,3,1.75,1100,7224,1,1100,0,1981
0324000350,667500,4,3,1920,4000,1.5,1540,380,1931
9407101840,378000,4,2.5,1890,12236,1,1230,660,1978
1422300140,454000,3,2.5,2530,43733,2,1530,1000,1991
6127011000,537500,4,2.5,2550,4630,2,2550,0,2005
2624049117,425000,3,1,1550,4160,1.5,1550,0,1926
3295750550,290000,3,2,1760,6600,1,1760,0,1998
7960100260,349500,3,2,1270,3600,1,1270,0,1963
7625700012,370000,3,2.75,1250,1655,2,830,420,2006
5418200295,549500,3,1.75,1620,8438,1,1620,0,1961
7454000295,245000,2,1,710,6322,1,710,0,1942
8100000060,208000,3,1.75,1070,7200,1,1070,0,1994
1310500550,248000,4,2.25,2320,8760,1,1160,1160,1966
9485950310,610000,4,3.25,5450,37058,1.5,5450,0,1984
4213910030,550000,4,2.5,1670,5116,2,1670,0,1999
1223089083,750000,3,2.75,3010,206910,2,3010,0,2001
2143700861,192000,2,1.75,1340,7380,1,1340,0,1940
5016003230,169317,2,1,790,4000,1,790,0,1908
1338801019,1.198e+006,4,3.5,3400,3850,2.5,2790,610,2008
3592500565,880000,2,1,1530,6350,1.5,1530,0,1923
6414600070,210000,1,1,930,7129,1,930,0,1948
8645500160,180500,3,1.5,1540,9800,1,1010,530,1973
8651520240,540000,4,2,1990,29078,2,1990,0,1984
9408300310,520000,3,1.75,2300,35722,1,2300,0,1984
4202400135,177500,3,1.5,1220,6000,1,1220,0,1968
7129300935,415000,3,1.75,2380,5650,1,1190,1190,1956
8143000310,495000,4,2.5,2020,7200,1,1010,1010,1968
6082400152,325000,3,2.25,1890,9646,1,1890,0,1966
6838000520,440000,2,1.75,1330,4903,1,1330,0,1985
4023500118,411000,3,1.75,1490,9844,1,1190,300,1959
8952900204,810000,5,3.5,3550,9600,2,2550,1000,1998
7922800320,561750,5,1.75,2040,8996,1,1020,1020,1962
9542000030,835100,4,2.5,2380,12573,1,2380,0,1963
3787000140,450000,3,2.25,1780,9969,1,1450,330,1985
0646910030,238000,3,2.5,1650,2807,2,1650,0,2004
5515600075,299000,3,1,1510,142803,1,1510,0,1974
1377300135,570000,2,1,1100,6240,1,1100,0,1941
5469501940,340000,3,1.75,2190,12626,2,2190,0,1978
9276200890,450000,2,1.75,1760,2275,1.5,1040,720,1912
6385910260,272750,4,1.5,1800,8786,1,1330,470,1966
5101402482,520000,4,2,2000,6380,2,1860,140,1949
9353300140,284950,3,1,990,10723,1,990,0,1960
5379801600,255000,2,1.5,1480,9660,1,1480,0,1949
6082400260,231500,2,1,1200,9488,1,1200,0,1941
2025079033,415000,1,2,3000,204732,2.5,3000,0,1979
6181430800,330000,4,2.5,3504,6000,2,3504,0,2006
3649100473,365000,3,1.5,1300,12240,1,1300,0,1963
2011400791,425000,4,2,1330,9188,1.5,1330,0,1928
7549802030,400000,4,1.75,1850,6480,1,1120,730,1958
1898200030,335000,4,2.5,2240,9701,2,2240,0,1989
0567000672,342000,3,3,1260,1251,2,1040,220,2003
9126101740,490000,8,5,2800,2580,2,1880,920,1997
5127001600,331500,4,1.75,1820,14319,1,1820,0,1969
1925069121,960000,3,2.5,1730,4102,3,1730,0,1996
7511210310,720500,4,2.5,3350,35298,2,3350,0,1985
0065000260,830000,3,2.5,3370,6550,2,2840,530,1912
6372000060,662990,3,1.75,1240,3600,1.5,1240,0,1926
2005300140,220000,4,2,2340,10507,1.5,2340,0,1959
5649600435,349950,5,2,1880,4179,1,940,940,1952
2249500059,550000,3,2,1810,2159,1,1010,800,1922
1773100510,396000,3,1.75,2340,5668,1,1200,1140,1941
9521100960,635000,4,1.5,2820,4000,2,2820,0,1911
1785500132,293000,3,1,1020,7650,1,1020,0,1940
8645530060,339000,3,2.25,2090,10120,1,1290,800,1979
7697920060,285000,4,2.25,1830,8734,2,1830,0,1991
9550202010,775000,6,2.75,2980,5000,1.5,2480,500,1916
1821059264,224000,4,1.5,1600,9289,1,1600,0,1959
5700003985,2.25e+006,4,3.5,4440,8125,2,3140,1300,1922
2320069248,165050,3,1,1200,8514,1,1200,0,1959
2658000335,275000,3,1.25,1230,4500,1.5,1230,0,1913
1702901557,445000,5,3,2930,5500,1,1750,1180,1951
1774220350,510000,3,2.25,2370,38639,1,1930,440,1978
7355700171,1.23e+006,4,2.5,3040,7000,2,3040,0,2001
3971701922,390000,3,1.5,1610,13500,1,1060,550,1970
3583300135,460000,3,2.25,2350,10450,1,1390,960,1977
9542000075,700000,3,1.75,2000,14733,1,2000,0,1958
4055700955,874150,4,3.5,3530,14406,2,2570,960,1987
4022902505,470000,3,2.25,2220,9800,2,2220,0,1987
8680100030,374000,3,1.75,2000,9416,1,2000,0,1961
2923039017,510000,2,1.75,1210,131115,1.5,1210,0,1950
2767604247,467000,2,2.5,1140,1181,3,1140,0,2007
5631500505,576000,4,2.5,2440,28405,2,2440,0,2002
3356406510,196440,3,2,1560,7352,1,1560,0,1992
7701990700,825000,4,2.5,3210,18901,2,3210,0,1993
8835200800,281000,2,1,930,2600,1,930,0,1981
8902500118,326000,3,2.5,1782,1577,3,1782,0,2000
2822079012,340000,3,1.75,1740,46580,1,1740,0,1980
9485950060,440000,5,1.75,3690,36036,1,1890,1800,1985
0424069264,749000,4,2.5,2930,18199,2,2930,0,1998
3581000340,340000,4,1,1230,8316,1.5,1230,0,1963
7625704005,561000,3,2,2000,7000,2,2000,0,1916
1545803240,270000,3,2.25,1520,7930,1,1160,360,1988
8080400045,600000,2,1,1040,3600,1,1040,0,1919
8651402920,219900,4,1.5,1120,5427,1,1120,0,1969
3121069036,617000,3,1.75,3020,360241,2,3020,0,1992
2540800390,469000,3,2.25,1820,8446,2,1820,0,1978
7978800621,229000,3,1,1370,56628,1,1370,0,1942
1336300445,1.265e+006,4,3,3130,2646,2.5,2290,840,1906
6159400060,365000,3,1.5,1640,8301,1,1290,350,1958
9510930350,429000,4,2.5,2650,9301,2,2650,0,2001
5535600520,550000,4,2.5,2850,6809,2,2850,0,2003
7634800070,453000,3,2.5,1820,16300,1,1220,600,1955
8581200350,187500,3,1.5,1180,7000,1,1180,0,1977
6190701146,520500,6,2.5,1880,14350,1,1640,240,1955
0522059299,300000,3,1.75,1280,12776,1,1280,0,1977
1513800036,799000,4,3.25,3120,5000,2,2370,750,2005
6699930550,338000,3,2.5,2470,4948,2,2470,0,2003
9839300875,800000,3,1,1700,4400,1.5,1700,0,1906
2493200435,360000,2,2,1180,3200,1,590,590,1945
0226039282,442500,6,2.5,2800,10490,1,1400,1400,1968
1020069017,700000,4,1,1300,1651359,1,1300,0,1920
5450900140,830000,5,3,3040,9601,1,1970,1070,1968
8093800200,360400,3,2.5,1630,11592,2,1630,0,1987
3205000310,345000,3,1,1340,9339,1,1340,0,1960
7230000350,300000,3,1.75,1830,51836,1,1430,400,1966
1066600045,350000,3,1,1240,10800,1,1240,0,1959
2822069078,368000,4,2,2500,36900,1,1540,960,1972
8731900340,264000,3,1.75,1760,7482,1,1760,0,1966
5088500310,435000,3,2,2660,16677,1,2210,450,1990
1823059205,200000,3,1.5,2060,15837,1.5,2060,0,1903
0225039082,620000,5,2.5,2540,3832,2,1760,780,1929
5021900140,1.679e+006,5,4.25,4830,11466,2,3720,1110,2014
7883603750,337000,3,1.75,1400,6000,1,700,700,1919
8081500060,1.928e+006,4,3.25,4280,20296,2,4280,0,1984
8099900260,544500,4,2.5,2230,10414,1,1450,780,1974
0913000340,252000,1,1,680,1638,1,680,0,1910
2115200160,445000,4,2.5,2340,3784,2,2340,0,2008
5095600310,379500,3,2.25,2070,14196,2,2070,0,1989
5402100045,189950,4,2,1910,4225,1,910,1000,1919
2258500049,469000,3,1,950,4250,1.5,950,0,1948
0626100023,600000,5,2.75,2910,53898,1,1510,1400,1979
4309720160,785000,3,2.5,2930,33981,2,2930,0,2000
1843100070,372000,4,2.75,2610,8967,2,2610,0,1990
4307350520,445000,5,3,3880,7180,2,3880,0,2004
5561401260,508000,4,2.25,3320,53392,2,2000,1320,1986
2883200966,780000,5,1.5,1940,4800,2,1940,0,1905
7214800240,541100,4,2.25,2510,9800,2,2510,0,1978
3629920860,729000,4,2.5,2660,5608,2,2660,0,2003
1320069179,397000,3,2,1710,134489,1,1710,0,1952
9424400200,451555,2,1,1320,4520,1,1320,0,1912
3500100189,300000,2,1,960,8153,1,960,0,1947
2787720140,416000,3,2.5,1790,11542,1,1190,600,1969
3856904740,490000,2,1,950,3060,1,810,140,1925
0254000445,480000,6,3.75,2940,5054,2,2940,0,1942
6821101837,368000,2,2,930,1662,1,670,260,2002
5608000700,1.038e+006,3,2.5,4570,10615,2,4570,0,1991
7784400060,545000,3,2.5,2370,9000,1,1570,800,1952
3295610350,850000,5,2.75,3430,15119,2,3430,0,1998
3260570260,550000,4,3.5,3540,4750,2,3540,0,2003
1592000260,600000,3,2.25,2240,9314,2,2240,0,1984
8670000060,535000,4,2.5,2710,12138,1,1700,1010,1968
8113600004,599950,3,2.5,2660,4975,2,2660,0,2014
0235000075,531000,5,2.75,2540,5022,1,1540,1000,1955
1951700700,530000,4,2.25,2210,7665,2,2210,0,1968
1832100030,597326,4,4,3570,8250,2,2860,710,2015
8565000030,805000,4,2.5,3450,33460,2,3450,0,1997
2473350710,390000,4,1.75,2330,8364,1,2330,0,1968
9521101221,487250,4,2,1690,3250,1.5,1550,140,1901
6152900273,301000,3,1.5,1030,8414,1,1030,0,1967
2721600125,1.175e+006,5,2.75,2560,5618,1.5,2220,340,1923
1180002378,299000,4,2.5,1950,3000,2,1950,0,2002
0625059051,2.35e+006,4,2.25,4370,22863,2.5,3670,700,1907
2113700060,400000,4,2.5,2350,3904,2.5,2350,0,1999
7016100570,467500,4,2.5,3160,7210,1,1880,1280,1969
2944500710,305000,4,2.5,2430,9103,2,2430,0,1990
1549500370,210000,3,1,1340,306848,1,1340,0,1953
7211340030,300000,3,1,1010,10168,1,1010,0,1979
2473480520,327500,3,2.25,1770,8755,1,1330,440,1981
1722059326,269000,3,2,1210,7136,1,1210,0,2003
9414100030,975000,4,3.25,3330,17533,1,1750,1580,1969
8911000030,355000,3,1,1240,5400,1,1060,180,1940
2264500890,712000,3,1,1250,4620,1.5,1150,100,1900
2481630200,883000,4,2.5,2960,41656,2,2960,0,1985
7299500200,190000,2,1,840,12252,1,840,0,1994
8598900125,443000,3,1.75,1530,8028,1,1200,330,1967
7504010560,920000,4,3,3750,11025,2,3750,0,1976
8732130140,285000,4,2.25,2150,8250,1,1240,910,1978
2492200335,901000,4,3.25,1560,4080,1,1560,0,1916
2770606602,552500,3,1.75,2040,5775,1,1410,630,1958
7211400990,256000,2,1,860,5000,1,860,0,1915
7148700160,341000,3,1.5,1720,7119,1.5,1720,0,1952
0984220370,279000,4,2.25,2090,8941,2,2090,0,1975
2600000510,686000,4,2.25,2130,10650,2,2130,0,1977
7123400045,225000,2,1,1300,11867,1.5,1300,0,1975
3751602329,215500,2,1.75,1220,15600,1,1220,0,1972
6819100310,950000,4,3,2420,4800,1.5,1520,900,1919
2925079012,503000,4,2.5,2940,156988,2,1870,1070,1996
7202430060,780000,3,2.5,2610,7567,2,2610,0,1997
0185000118,212000,4,2,1880,7500,1,980,900,1946
1139000685,580000,4,2.75,2330,6703,1.5,1710,620,1983
5312100060,465000,4,2.5,2200,3141,2,2060,140,1994
3356404330,206000,4,2,1720,7560,1,1720,0,1959
7805460030,615000,3,2.5,2250,10171,2,2250,0,1987
1705400055,519000,4,1,1640,6305,1.5,1640,0,1907
3303980520,1.135e+006,4,3.25,4130,11444,2,4130,0,2001
2538410140,330000,5,2.5,2600,3839,2,2600,0,2005
3810000860,240000,4,1.5,1920,7973,1,1920,0,1955
8079100370,574000,3,2,2060,7000,1,2060,0,1988
2025770560,930000,4,4.25,5710,24663,2,5710,0,2007
0225069017,850000,4,3,2720,183823,2,2720,0,1975
1138010510,415000,3,1.5,1490,7275,1,1090,400,1974
4358700135,480000,3,2.5,2360,9005,1,1340,1020,1929
4327100045,300000,5,1,1940,8875,1,1940,0,1957
6804600550,439000,4,2.25,2570,9503,2,2570,0,1980
5634500251,450000,3,1,1160,36831,1,1160,0,1938
3125079062,589000,3,2.5,2660,206480,1,2660,0,1989
3629920140,477000,3,2.25,1260,3000,2,1260,0,2003
6844703410,587500,4,2.25,1780,6120,1,1310,470,1951
1337300070,1.315e+006,4,2.25,3180,6105,2,3180,0,1905
9290900160,1.43e+006,4,2.5,3380,27589,2,3380,0,1966
2251500270,700000,4,2.25,2690,15000,2,1890,800,1978
0414100295,275000,2,1,1180,6552,1,1180,0,1949
1771110640,367500,3,1,1660,11783,1,1160,500,1978
0808300550,453250,4,2.5,2260,6300,2,2260,0,2001
4322500055,607000,5,1.75,1910,5428,1,1390,520,1954
3810000565,255000,4,2,2430,8960,1,1430,1000,1960
0461002025,501000,2,2,1300,2500,1,770,530,1926
8559900140,450000,3,1,1060,4650,1,910,150,1950
8899210320,360000,3,2.25,2200,8000,2,2200,0,1981
0952002765,460000,4,1.75,1720,3050,1.5,1040,680,1929
7101100055,753000,3,1.75,2360,8290,1,1180,1180,1950
3013300510,389950,2,1,820,4234,1,820,0,1951
1623300765,469000,2,1,1030,4400,1,1030,0,1924
9322800260,550000,4,1.75,2030,5688,2,1730,300,1939
6141600140,565000,5,3.5,2700,11675,1.5,1950,750,1948
9315300260,189650,2,1.75,1100,7600,1,1100,0,1980
7015200335,1.525e+006,4,3.25,3620,5131,2,2350,1270,1927
1545806510,260000,3,1.75,1340,8000,1,1340,0,1980
8643200055,243000,3,1.75,1790,12000,1,1040,750,1960
7855000550,1.1e+006,4,2.5,3830,13800,1,2030,1800,1969
1313500070,249000,3,1.5,1580,7200,1,1080,500,1976
0290000055,720000,2,1,2020,7200,1,1700,320,1947
4139460200,905000,4,2.5,3330,9557,2,3330,0,1995
3931900295,824500,4,2.5,2610,3500,1.5,1610,1000,1927
7365600070,762500,4,2.75,2610,8760,1,1760,850,1978
9274200320,580000,3,2.5,1740,1280,3,1740,0,2008
8856920260,380000,3,2,1840,8580,1,1840,0,1990
4083306175,805000,3,1.75,1080,3200,1,880,200,1926
7588700204,520000,4,1.75,1240,4532,1.5,1240,0,1944
3271800295,1.5695e+006,5,4.5,5620,5800,3,4700,920,1999
6052400575,175000,2,1,1170,8925,1,1170,0,1911
7861300140,353500,4,2.25,1760,9602,2,1760,0,1987
6117501176,500000,4,2.5,2230,26989,1,1400,830,1962
2592400140,386500,3,1.75,1520,7350,1,1140,380,1972
7135300046,210000,2,1,1450,4750,1,850,600,1950
8665900295,439500,3,2.5,1600,6510,1,940,660,1983
6699000810,315000,5,2.5,3220,5751,2,3220,0,2002
5104510240,339000,4,2.5,1830,8601,2,1830,0,2003
7856700990,655000,4,2.25,2200,9163,1,1430,770,1971
8682300640,740000,2,2.5,2170,8678,1,2170,0,2008
6918700320,685000,5,2.5,1900,7843,2,1900,0,1966
9560700055,550000,5,2.5,2960,9877,1,1480,1480,1960
3013300055,405000,2,1.75,1710,4234,2,1330,380,1920
9201000320,765000,4,2.25,2620,17366,1,1430,1190,1984
9151600695,625000,3,2,2140,3600,2,1680,460,1911
2143700830,207000,4,2.5,2100,19680,1.5,2100,0,1914
2143700830,370000,4,2.5,2100,19680,1.5,2100,0,1914
2591020140,475000,3,2.5,1460,4961,1,1150,310,1988
6414600262,365000,2,1,990,8250,1,990,0,1955
1387301360,411800,4,2.25,2190,6800,1,1340,850,1969
5561400260,668000,5,3.5,3990,42436,2,2710,1280,2002
7942601805,618000,3,2.5,2340,3630,2,2340,0,1998
1887500045,247500,4,2,2460,5921,1,1230,1230,1948
5505700055,345000,5,3,2080,6150,1,1040,1040,1950
3886902505,616300,3,2,1700,8400,2,1700,0,1927
6703100135,348000,3,1.5,1330,6768,1,1330,0,1952
1552520070,425000,3,2.5,1630,10762,1,1630,0,1994
8163300320,850000,5,2.75,2920,11880,1,1660,1260,1968
1853081000,820000,5,2.75,2830,6137,2,2830,0,2010
4403600240,832000,4,2.25,3190,52953,2,3190,0,1980
3885803625,835000,3,1.75,1490,3840,2,1490,0,1984
0869700370,350000,3,2.5,1630,3425,2,1630,0,1999
4307301160,349000,4,2.5,2280,4096,2,2280,0,2003
2402100575,1.125e+006,6,3.75,3010,4360,2,2000,1010,2014
4307350990,320000,3,2.5,1590,3480,2,1590,0,2004
2873000260,150000,3,1,1250,7210,1,1250,0,1968
0795001600,340000,3,1,1710,10190,1,1310,400,1949
0098030140,785500,4,4,3280,8448,2,3280,0,2007
5409800140,410500,4,2.5,3362,8601,2,3362,0,2004
9253900354,580000,3,2.5,2200,11000,2,2200,0,1978
3319500922,345000,2,1.5,830,920,2,830,0,2005
3404700041,550000,3,2.25,2160,37000,1.5,1760,400,1933
2314300200,449500,4,3,2580,7299,2,2580,0,1998
9265700045,300000,3,1,2150,7007,1,2150,0,1954
3528000260,915000,4,2.5,3510,28052,2,3510,0,1988
3066120030,1.575e+006,4,3.75,3810,9916,2,3810,0,1989
4278900055,599000,4,2.75,2020,2750,1,1010,1010,1917
9512000140,755000,4,2.5,2120,10202,1,1620,500,1960
6381500505,400000,3,1,1250,7157,1,1250,0,1944
1697000400,133000,3,1,980,9115,1,980,0,1968
2548100140,330000,4,1.5,1250,8400,1,960,290,1951
7225000140,330000,4,1,1100,5000,1.5,1100,0,1904
2126049032,375000,3,1.75,1330,9417,1,710,620,1936
3876300890,485000,4,2.75,2560,8956,1,1500,1060,1968
7715800710,470000,4,2.5,1850,11250,1.5,1210,640,1981
2397101200,1.045e+006,4,3,2790,3600,2,1880,910,1905
5100401160,548800,4,1,1660,4704,1.5,1260,400,1930
2741100800,315000,2,1,1080,2674,1,720,360,1919
0034001160,590000,3,2,3030,9374,1,2100,930,1959
5637200200,439950,4,2.5,2380,12067,2,2380,0,2002
3410600335,325000,3,1.75,2250,26337,1,2250,0,1980
8024201370,400000,2,1,880,5111,1,880,0,1931
3066410800,685000,4,2.5,2770,10051,2,2770,0,1987
5306100240,339950,3,2,1340,10200,1.5,1340,0,1953
9334800140,315000,3,1.75,1660,8160,1,1660,0,1951
7203101260,411753,3,2.5,1710,3795,2,1710,0,2009
7577700070,577000,2,1.75,1620,4879,1,1040,580,1924
6072100140,500000,3,1.75,1530,8829,1,1530,0,1972
3874000240,210000,3,2,1440,10111,1,1440,0,1963
6151800135,640000,4,1.75,2020,16120,1,2020,0,1969
1826049225,460000,4,1.75,1870,8663,1,1870,0,1949
8150100240,265000,2,1,620,4760,1,620,0,1941
5152960710,740000,5,5,5774,31675,1,4490,1284,1984
4027701275,230000,3,1,1240,6195,1,1240,0,1948
1545807990,315000,3,1.75,1890,10661,1,1460,430,1978
1726069179,432000,3,1.75,2410,51763,1,1410,1000,1981
3905100070,467000,3,2.5,1530,3984,2,1530,0,1995
7316400070,255000,5,3.75,2800,9900,1,2800,0,1964
2113700335,316500,3,1.75,1460,6360,1,1010,450,1979
3972900160,190000,4,2,1580,6250,1,860,720,1977
2767603215,490000,3,2,1450,2400,1.5,1450,0,1900
3664500041,378000,4,1.75,1990,23200,1,1990,0,1976
5379804150,598800,6,4,4470,17877,3,3230,1240,2013
9188200570,333800,5,3,1980,3868,1,1220,760,1990
3905010140,690000,4,2.5,2920,9904,2,2920,0,1990
5141000685,320000,4,1.75,1660,6200,1,830,830,1948
6738700320,1.249e+006,4,3.5,3190,6000,1.5,2410,780,1912
1246700152,335000,3,1.5,1560,9600,1,1560,0,1961
2926069062,840000,3,2.5,3050,33920,1,3050,0,2004
6114400136,608250,4,2.75,3030,21780,2,3030,0,1986
6127010800,550000,3,2.5,2260,4165,2,2260,0,2005
4222000320,240000,3,1,1260,7920,1,1260,0,1966
2600010070,998000,3,2.25,3370,11757,2,3370,0,1980
3826500570,275000,3,1.75,1490,8000,1,1490,0,1978
8159620160,284200,3,2.5,1570,9292,1,1110,460,1977
1118001805,1.715e+006,4,3.75,4490,7623,2,3090,1400,1941
3398800055,2.4e+006,4,3.75,4090,24825,2,3400,690,1926
3528000510,930800,5,2.5,4150,96574,2,4150,0,1988
0627300105,930000,4,3,2900,10400,1,1530,1370,1959
3279000070,215000,4,1.5,1430,8775,1,1030,400,1979
1922039062,480000,2,1.5,1008,26487,1,1008,0,1943
0312000135,483945,2,1.75,1480,5120,1,840,640,1951
6054650510,347000,3,1.75,1240,8050,1,1240,0,1978
3279000240,232500,3,2,1370,9760,1,1110,260,1979
1402000070,390000,4,2.25,1770,33132,1,1190,580,1965
1562200240,550000,3,2.25,2160,15360,1,1410,750,1965
3904921070,590000,4,2.5,2340,8971,2,2340,0,1987
4045500510,420850,1,1,960,40946,1,960,0,1945
8849300160,345000,4,2.5,2280,8190,1,1390,890,1983
4123810140,429800,3,2,1970,7000,1,1970,0,1986
2473251170,302000,4,1.75,1530,17664,1.5,1530,0,1968
6430500186,800000,4,1.5,1790,3952,1.5,1790,0,1932
4136950140,250000,3,2.5,1700,6000,2,1700,0,1997
1370802650,605000,3,2,2660,4500,1,1330,1330,1922
1721069036,412000,3,1.75,1950,52256,1,1950,0,1985
8637100370,252000,3,2,1340,5670,2,1340,0,1994
8952900260,375000,3,1,1130,12500,1.5,1130,0,1954
1972202080,725000,2,1.75,1950,2719,1,1010,940,1919
9476200350,471750,5,3.5,3790,8200,1,2120,1670,2001
1523069204,490000,4,2.25,2020,85813,2,2020,0,1995
2856100125,439000,2,1,800,5100,1,800,0,1945
2968800626,355000,4,2,1770,8890,1,1770,0,1949
2129700320,250000,1,0.75,940,87120,1,940,0,1944
8965500320,780000,4,2.25,2260,16188,1,2260,0,1984
0952005224,409000,2,1,890,3271,1,890,0,1918
4443801160,420000,2,1,860,3880,1,860,0,1916
5101404170,200000,1,0.75,680,9600,1,680,0,1947
1241500350,830000,2,1.5,2130,35679,1,2130,0,1963
4379400560,695000,3,2.5,2390,4555,2,2390,0,2006
0629810350,815000,4,2.75,3488,9614,2,3488,0,1998
5466400550,210000,3,1.75,1260,6223,1,820,440,1983
3619600132,635000,3,1.75,2940,6000,1,1590,1350,1957
4113800550,562500,4,2.5,2440,7322,2,2440,0,1991
7298020240,402500,4,2.5,2600,11951,2,2600,0,1988
0434000030,555000,3,2,2080,7020,1,1040,1040,1951
1138000830,310000,3,1,1990,7173,1,1990,0,1972
8568000070,500000,4,2.5,2840,18001,2,2840,0,1994
8822901200,430000,6,3,2630,8800,1,1610,1020,1959
1118002090,1.6e+006,3,4.25,2820,7200,2,2460,360,1930
3856901525,627500,4,1,1560,4080,1.5,1560,0,1923
1180500070,335000,4,2.5,2330,7050,2,2330,0,1998
7856560320,962000,4,2.25,3320,20100,1,1810,1510,1981
5103900045,299000,3,1.75,1730,14270,1,1730,0,1959
8562890370,399950,4,2.5,3110,5868,2,3110,0,2001
8807600340,322000,3,1,1230,9660,1,1230,0,1968
0993002325,430000,2,1.5,950,4625,1,950,0,1949
1022059082,307000,3,1.75,1890,13860,1,1890,0,1966
0179000350,194000,3,1.5,1010,5000,1,1010,0,1943
3915500045,180000,3,1,1010,8581,1,1010,0,1920
3578400030,465000,4,2.25,2340,13383,1,1170,1170,1983
9346700320,722500,4,2.5,2460,9296,2,2460,0,1978
3856901715,470450,2,1,1010,3400,1,1010,0,1921
8700120520,280000,3,2.5,1650,6000,2,1650,0,1990
7335400400,176250,4,2,1440,6702,1,1440,0,1966
4319200505,560000,5,1,1710,9100,1.5,1320,390,1926
1426049083,830000,3,2.5,2760,11287,2,2000,760,1991
7795400046,276900,2,1,1350,10096,1,1350,0,1952
1337800045,625000,3,1.75,1660,4800,2,1660,0,1906
2207500695,1.015e+006,4,2.5,2960,4760,2,2160,800,1900
1112000125,463500,1,1,1090,8750,1,1090,0,1924
2472930270,485000,3,2.5,3110,9015,2,3110,0,1990
5651500140,272000,3,2,1380,7476,1,1380,0,1989
7203102080,305000,2,1,1290,3140,2,1290,0,2008
3626500045,760000,3,2.5,1980,13964,1,1980,0,1959
3226049117,387500,2,1,870,6126,1,870,0,1938
6699940140,352000,4,2.5,2470,5015,2,2470,0,2004
7702600160,507000,3,1.75,2140,40098,1,1490,650,1950
5379804730,156000,3,1,770,9750,1,770,0,1941
3383900058,580000,3,3.25,1490,857,3,1220,270,2001
0629600030,630000,4,2.5,2510,35020,1,1610,900,1977
1823049171,275000,5,1.5,1950,9000,1,1130,820,1964
3760500516,835000,5,4,3600,14720,1,1800,1800,1960
2641400160,340000,4,2.5,2380,7850,2,2380,0,1995
0534000075,329350,2,1,720,6687,1,720,0,1942
3892500070,1.48e+006,3,3.5,4070,26000,2,4070,0,1991
0224069084,475000,3,1,1250,150117,1,1250,0,1975
2767600400,719950,3,2.25,2190,2416,3,2190,0,2014
5347200160,235000,1,1,810,2451,1,810,0,1941
9553200125,875000,3,1.5,2440,5750,1,1320,1120,1939
5379804888,380000,4,1.75,1740,9150,1,1740,0,1974
0421079105,325000,3,2.25,1480,97138,1.5,1480,0,1984
4215250030,475000,4,2.5,2120,57050,2,2120,0,1989
2420069017,152900,1,1,900,4368,1,900,0,1915
2414600400,210000,2,2,1190,7570,1,1190,0,1939
2461900510,350000,4,1,1010,6000,1,750,260,1925
7695500200,505000,3,2.5,2100,17882,2,2100,0,1985
0251200200,464900,4,2.25,2020,8424,1,1380,640,1979
0513000550,650000,3,2,2520,5980,1,1790,730,1957
8730000260,369950,2,2.75,1370,1140,2,1080,290,2009
3395040550,250000,3,2.5,1530,2890,2,1530,0,2001
3395040550,320000,3,2.5,1530,2890,2,1530,0,2001
9471200200,2.532e+006,4,4.25,5040,16048,1,3420,1620,1950
5469700260,340000,4,2.25,2530,24700,2,2530,0,1974
2767600171,440000,2,1.5,1010,1968,1.5,1010,0,1906
0898000200,219950,3,1,1200,7727,1,1200,0,1959
5315100806,940000,4,3,2720,11740,1,2720,0,1957
9269200786,399950,4,1.5,1850,6125,1.5,1110,740,1945
1118001370,1.568e+006,3,2.75,2340,8828,1,2340,0,1954
3558910640,528000,4,1.75,1860,9750,1,1460,400,1969
3761100341,545000,4,1.75,1940,8990,1,1560,380,1956
8682261070,575000,2,2,1680,6194,1,1680,0,2004
8732040810,235000,4,2.75,1770,10184,1,1250,520,1979
2991000400,272000,3,2.5,1790,6371,2,1790,0,1998
2155500030,380000,4,1.75,1720,9600,1,1720,0,1969
5727500102,195000,3,1,1280,6967,1.5,1280,0,1949
5104510370,297000,3,2.5,1690,4988,2,1690,0,2002
1895450200,349000,4,2.5,2190,7294,2,2190,0,2003
8122101146,320000,2,1,710,5200,1,710,0,1942
7789900030,319990,4,1.5,1890,10707,1,1890,0,1962
6893300350,439900,2,2,1410,12282,1.5,1410,0,1909
4073800140,429000,3,3.25,2210,3600,2,1820,390,1995
0538000030,272500,3,2,1540,6250,1,1540,0,1998
6632300478,400000,4,2,1350,7255,1,1350,0,1959
4083800340,462000,5,2,1380,4300,1.5,1380,0,1916
9214400135,510000,2,1,890,6095,1,890,0,1947
8944600200,550000,3,2.5,1900,3255,2,1900,0,1988
8651430370,150000,3,1,1240,5200,1,1240,0,1969
2296700260,460000,3,2.5,1730,8490,1,1210,520,1969
3066400140,632500,4,2.5,2090,10306,2,2090,0,1986
1771100240,361000,3,1.75,1650,11220,1,1650,0,1969
0461003251,437000,3,2.25,1130,1221,2,1030,100,2004
8699100240,370000,6,2.75,3240,5750,1,2160,1080,1950
8691350200,884250,4,2.5,3840,12151,2,3840,0,1998
2525300550,225000,3,1,1200,9936,1,1200,0,1969
7452500045,235000,2,1,870,5000,1,870,0,1949
2489200070,767500,6,3.5,2410,6000,2,2220,190,1916
3623500260,1.2e+006,3,1.75,1560,8078,1.5,1560,0,1928
0425069104,715000,3,2.5,2410,46609,2,2410,0,1989
2239800070,417000,4,2.25,2300,7700,1,1380,920,1959
2618300350,199000,3,1,1390,12145,1,1390,0,1964
1336800160,875000,5,2.5,2920,5568,2,2320,600,1906
7519000570,545000,4,1.5,1370,3708,1.5,1370,0,1926
0257000105,192500,2,1,950,7692,1,950,0,1926
4401200350,822500,3,2.5,3090,7708,2,3090,0,1999
6402300070,800000,4,2.5,2390,10000,1,1590,800,1975
5317100570,1.25e+006,3,2.5,2070,4944,2,2070,0,1930
8106100105,3.85e+006,4,4.25,5770,21300,2,5770,0,1980
9407150240,295000,3,2.5,1460,7936,2,1460,0,1995
8682291940,419000,2,1.75,1510,4980,1,1510,0,2006
4139420070,1.195e+006,5,3.25,5180,19606,1,2610,2570,1993
0629400340,750000,4,2.75,3430,13907,2,3430,0,1995
3380900160,502000,4,1.5,1700,8400,1,1700,0,1953
2175100270,1.025e+006,3,1.75,2640,8000,1,1320,1320,1960
3448000270,398500,3,1,1200,15960,1.5,1200,0,1945
8701600510,700000,2,1.5,1850,4945,1.5,1850,0,1907
6083000083,248000,5,1.5,1510,9078,1,1510,0,1959
9178600135,800000,4,2,2130,2800,1,1070,1060,1922
1721059286,383000,4,2.5,2640,8055,2,2640,0,2004
8161600135,688000,4,3,3000,4000,1.5,1970,1030,1913
2568300132,521000,3,2,1870,5455,1,1060,810,1926
6414100111,365000,2,1,990,9223,1,990,0,1949
9818700320,491000,3,2,2005,7000,1,1605,400,1980
0686200510,643000,3,2.75,2030,7700,1,1400,630,1965
3279000370,279000,3,2.5,1500,7350,1,1060,440,1979
2767601031,583500,4,1,1530,3900,1.5,1530,0,1908
4142450510,310000,3,2.5,1990,3600,2,1990,0,2004
3291800510,310000,3,1.75,1420,7650,1,1100,320,1984
7893203450,280000,3,1,1400,13975,1,1400,0,1956
0908000260,272000,4,2.5,1870,5692,2,1870,0,2004
3225069239,870000,4,3,3040,36246,1.5,2680,360,1923
8645540320,307000,3,2,1790,7259,1,1390,400,1980
9280200030,490000,2,1.5,1590,4500,1,920,670,1946
6159400030,399950,3,2,2050,9396,1,1170,880,1960
7787400030,1.635e+006,5,3.5,4220,26784,1,2110,2110,1958
1888120140,989000,5,4.5,4030,13474,2,4030,0,2000
2916620240,264950,4,1.75,1770,9011,1,1050,720,1983
0251200240,491500,4,2.75,2100,7236,1,1400,700,1979
7695500240,345000,3,2.25,2120,15003,2,2120,0,1984
7749500070,339900,4,1.75,2600,18042,1,2020,580,1969
6762700340,852000,3,3,2400,4000,2,1860,540,1905
0824069121,585000,5,3.5,3180,40946,1,1690,1490,1968
2600100370,723000,4,2,2790,8793,1,1640,1150,1977
2326059082,594000,3,2.25,2080,70567,2,2080,0,1990
2591010240,405000,2,1.5,1370,4102,2,1370,0,1987
1085610030,725500,4,2.5,2790,74495,2,2790,0,1997
9551202025,800000,2,1,1740,5719,1,1740,0,1955
4379600030,1.325e+006,3,3.75,6400,76665,1,3810,2590,1966
4345000510,180500,3,2.5,1800,8518,2,1800,0,1996
4345000510,325000,3,2.5,1800,8518,2,1800,0,1996
3327000140,235000,3,1.75,1190,7280,1,1190,0,1968
7100000135,330000,2,1,860,8308,1,860,0,1948
2483200060,678500,3,2,2460,6600,1,1370,1090,1952
2592400550,463000,4,2.5,1980,6660,2,1980,0,1974
2113701200,250000,2,1,670,4640,1,670,0,1943
5249804510,655000,3,2,1410,4800,1.5,1410,0,1927
9264901040,239900,4,2.25,1860,7000,1,1120,740,1979
7967600069,185000,3,1,980,9135,1,980,0,1955
4219400520,1.735e+006,4,2.25,3040,5000,2,2080,960,1926
3810000202,251700,3,2.25,1810,11800,1,1240,570,1977
1226039129,400000,4,2,1560,8250,1,1320,240,1964
8146100370,735000,4,1.75,2100,7960,1,1340,760,1955
1224059053,1.7e+006,5,2,2500,15250,2,2500,0,1942
1623049041,82500,2,1,520,22334,1,520,0,1951
0098020140,765000,4,4,3010,7221,2,3010,0,2004
9510900070,292500,4,1.75,2140,8162,1,1420,720,1968
2473381090,270000,3,2.25,2390,7000,1,1990,400,1970
6378500105,415000,2,1,1510,6807,1,1090,420,1939
3861400030,950000,4,1.75,2210,19025,1,1460,750,1952
0705700640,353000,3,2.75,2170,8396,2,2170,0,1995
2767603210,670950,3,2.5,1790,2375,3,1790,0,2007
3294700030,280950,3,1.75,1390,8700,1,840,550,1912
7524950830,585000,3,1.75,1850,7735,1,1850,0,1983
2124069078,525000,2,1.5,1480,43645,1,1480,0,1974
5728000060,605000,3,1.75,1850,8823,1,1370,480,1973
2880100160,1.01e+006,4,3.5,3350,3752,2,2550,800,2007
4435000520,245990,3,1,1040,8410,1,1040,0,1942
8856900310,535000,4,2.25,2810,12607,2,2810,0,1985
4315700390,410000,1,1.5,1010,5750,1,1010,0,1911
2095800520,550000,3,2.5,2250,7752,2,2250,0,1988
4193500140,665000,3,1.75,1800,8000,1,1800,0,1972
3582200200,455000,3,1,2400,17239,1,1890,510,1940
9521100106,440000,4,1,1780,4000,1.5,1780,0,1922
7351000160,332000,3,2.25,2120,14915,1,1720,400,1979
5422420140,280000,3,2.5,1860,6607,2,1860,0,1989
7234601162,570000,3,3.5,1460,1021,2,1150,310,2006
6623400217,250000,3,1,1230,10350,1,1230,0,1957
3354400060,238000,2,1,1088,8453,1,1088,0,1952
0408100105,265000,3,1,800,5760,1,700,100,1949
7297700055,306000,3,1,1190,10350,1,1190,0,1959
8029740060,345000,5,2.75,1940,4182,1,1240,700,2002
1355200060,765000,4,2.5,3300,10764,1,1720,1580,1971
4136890560,346300,4,2.5,2590,11018,2,2590,0,1998
1320069271,342500,3,2,2080,11375,1,2080,0,2002
9269260240,501000,4,2.25,2680,5439,2,2680,0,2000
1796381070,270000,3,2.5,1670,8364,1,1300,370,1990
6840701125,638000,3,1,1830,4400,1.5,1720,110,1930
7443000640,460000,3,1.75,1400,2003,1,700,700,1908
6344000060,760000,4,1.75,2770,8521,1,1470,1300,1953
3317500030,1.085e+006,3,2.5,3630,11019,1,2150,1480,1972
2130702270,234000,3,1,1040,8128,1,1040,0,1983
3343301920,1.65e+006,3,2.75,2690,8890,2,2690,0,1975
2688100075,488000,5,2,2020,5000,1.5,2020,0,1938
6448600060,1.55e+006,5,2.5,2450,20805,2,2450,0,1963
6619510060,499000,4,3,2030,12675,2,2030,0,1982
4058802105,150000,3,1,1450,6776,1,1450,0,1952
7212660640,333000,4,2.5,2400,7270,2,2400,0,1993
8026700105,700000,4,2.75,2870,8625,1,1860,1010,1959
8018600640,275000,4,1,1340,22500,1.5,1340,0,1926
0623049315,330000,3,2.5,1680,11312,1,1080,600,1959
6632900340,360000,4,2,1850,8827,1,1850,0,1969
6798100070,467000,3,1,1220,8040,1.5,1220,0,1965
8644400060,568000,3,2.5,2320,57063,1,1790,530,1979
4388600030,605000,5,2.25,3220,9603,2,3220,0,1972
0629420260,750000,4,2.75,3190,9023,2,3190,0,2005
1117200550,760000,3,2.75,3530,69834,2,3530,0,1994
7461420060,265000,3,1.75,2050,10519,1,1240,810,1979
5566100060,490000,3,1.75,1720,12540,1,1720,0,1956
7714000340,360000,4,2.5,2850,4650,2,2850,0,2004
5149300400,311750,4,2.25,2270,12000,1,1290,980,1976
3815500045,399000,3,2.25,1880,12473,1,1420,460,1958
1843100520,347000,4,2.5,2770,9751,2,2770,0,1989
1329000030,1.68e+006,4,3.75,4490,34982,2,4490,0,1998
7853240560,585000,4,2.5,3110,6479,2,3110,0,2005
8078100260,340000,4,2.5,2360,7475,2,2360,0,1992
3905120830,612000,3,2.5,2180,5496,2,2180,0,1994
1442800400,230000,2,1.75,1910,3376,2,1910,0,1980
3905000200,604000,4,2.5,2260,7753,2,2260,0,1989
4399200075,250000,3,1.75,1770,8868,1,1770,0,1959
1545802830,258500,3,2,1460,7930,1,1460,0,1989
1370804100,783000,4,2.75,2080,5000,1,1470,610,1940
0269000240,1.05e+006,5,2.25,2960,7680,1,1550,1410,1958
2619920030,760000,4,2.5,3220,4031,2,3220,0,2002
3438500339,276000,3,1,1140,5000,1,1140,0,1960
8563001070,550000,4,2,1660,12377,1,1660,0,1966
4427100105,398000,4,1,1430,6240,1.5,1430,0,1953
2767800140,775000,3,3,1820,4300,1.5,1620,200,1914
2600140070,1.0275e+006,4,3,3540,10202,2,2720,820,1988
7231501610,327000,4,1,1620,6000,1.5,1620,0,1905
2787250240,564500,4,2.75,3100,14568,2,3100,0,1995
5309100295,782000,4,1.75,1500,6820,1.5,1500,0,1905
2781260370,398000,4,2.5,2820,5510,2,2820,0,2005
1926059155,257000,3,1.75,1850,10920,1.5,1850,0,1915
7137900960,235000,4,2,1570,9415,2,1570,0,1984
2817100570,453000,4,2.75,2300,37533,1,1550,750,1979
3886902445,535000,2,1,920,9000,1,920,0,1954
2215902010,275000,3,2.5,1600,7000,2,1600,0,1993
1778350270,665000,3,2.5,2630,10047,2,2630,0,1996
1449000270,670000,4,2.75,3020,13530,1,1540,1480,1977
3755100520,465000,3,1.75,1490,10757,1,1060,430,1966
8651441620,210000,3,1.5,1160,5200,1,1160,0,1970
1321970240,265000,4,2.5,2040,4443,2,2040,0,2001
6816300060,426000,2,2.5,1550,2657,2,1550,0,1987
8563000520,529219,4,2.25,1990,7610,1,1290,700,1966
3663000070,600000,3,2.25,1900,46609,1.5,1440,460,1969
0255400070,875000,5,3.5,3840,8279,2,3840,0,2001
0269000070,608000,4,3,2400,7680,1,1200,1200,1956
1163400070,220000,3,1,1660,21514,1,1660,0,1973
4139420370,1.76e+006,4,5,6055,21630,1,3555,2500,1996
2599200160,295450,3,2,2030,17120,1,1890,140,1966
1704900135,315000,2,1,840,5087,1,840,0,1925
6648701420,205000,4,2,1450,8175,1,1450,0,1967
6123000070,310000,3,1.5,1460,9908,1,1460,0,1952
7015200136,1e+006,5,1,2010,5210,1.5,1890,120,1927
5104531820,525000,4,2.5,2910,7631,2,2910,0,2006
6620400631,284000,4,1.75,1880,8800,1,1130,750,1960
3582500240,510000,3,1.75,2170,26460,1,1450,720,1986
1529300160,405000,2,1,1260,4377,1,1260,0,1947
4027700844,509950,3,2.5,1970,9153,2,1970,0,2007
0425069139,600000,4,2.25,2090,45738,2,2090,0,1987
3047700105,990000,4,3.75,3450,4940,2,2570,880,2006
2976800550,280005,3,1.5,1130,7200,1,1130,0,1954
6151800070,700000,3,1.75,2600,7668,1,1300,1300,1968
4364700105,330000,3,1,1030,7620,1,1030,0,1953
7893804845,340000,2,1,1700,6718,1,1230,470,1956
7694800070,468000,2,2.5,1480,2167,2,1390,90,2007
1922000070,1.339e+006,4,2.5,4250,19387,2,3260,990,1972
4035900060,515000,3,1.75,1600,20873,1,1600,0,1955
8880600070,245000,4,2,1870,8750,1,1870,0,1977
0739800070,265000,3,2.5,1440,7741,1,1000,440,1983
1561910270,372400,3,2.5,2720,11937,2,2720,0,1990
7305300370,390000,3,1.5,1240,8410,1,1240,0,1948
7345000340,208000,3,1,1020,6120,1,1020,0,1967
3971701455,273000,2,0.5,1180,7750,1,590,590,1945
8035350260,455000,5,3.5,3080,7759,2,2310,770,2003
0104550520,270000,4,2.5,1750,6397,2,1750,0,1988
4037400295,618000,4,2.25,2530,8736,1,1210,1320,1958
5413200140,213550,3,2.5,1580,8541,2,1580,0,1990
0522049104,210000,5,1.75,2340,9148,2,2340,0,1957
3859900060,2.75e+006,5,4,6300,16065,2,4360,1940,2004
6145601715,403500,4,2.75,2400,3844,1,1200,1200,1974
1645000310,235000,3,1.5,1300,7600,1,1300,0,1963
7471900045,287500,3,2,1760,7147,1,880,880,1936
7697100030,546800,4,1.5,1520,5910,1,1020,500,1946
3313600340,183000,3,1.75,1070,8100,1,1070,0,1957
1921069082,560000,3,2,2560,216777,1,2560,0,1986
4263200030,299500,3,1,1280,6726,1,1280,0,1958
6918700370,610000,4,2.25,1660,7350,1,1660,0,1965
8125200483,288350,3,1.5,1860,7963,1,1200,660,1963
1930301555,500000,2,1,950,4500,1,850,100,1926
7974200776,625000,4,2.75,2140,4000,1,1190,950,1951
2719100013,418000,2,1.5,1480,1349,2,1240,240,2007
7234601544,660000,3,3,2260,1825,2,1660,600,2002
5652601455,775000,4,2.5,2300,6158,2,2300,0,1999
2558600060,429500,3,2.75,1650,7272,1,1230,420,1972
5017000575,569000,3,2,1990,3000,1.5,1230,760,1908
2796100160,250000,4,2,1960,7560,1,1160,800,1978
5470100270,225000,3,1.5,1310,10491,1,1310,0,1969
6112300140,530000,4,2.75,2450,15002,1,2450,0,1974
4024101715,306000,3,1,910,8658,1,910,0,1955
3205100060,517100,3,1.75,1580,9719,1,1580,0,1962
4450700030,354950,3,1.75,1780,9689,1,1130,650,1976
7920100083,348000,3,1.5,1040,1824,1,1040,0,1925
1774350160,522250,4,2.5,2340,41600,1,1640,700,1977
2115510340,275000,3,2.5,1720,8755,1,1000,720,1983
8901000445,390000,3,1.5,1600,10440,1,1600,0,1954
6121800060,260000,3,1.5,1320,9750,1,1320,0,1954
8712100320,585000,5,2.75,2350,4178,1.5,1520,830,1922
2979800520,605000,5,2.75,2740,5616,1.5,1670,1070,1925
2331540070,342000,4,2.5,2300,6448,2,2300,0,2001
6345000160,900000,5,3,4350,37169,2,2950,1400,1972
5126950340,252000,3,1.75,1430,7700,1,980,450,1981
5152100160,357000,3,1.75,2400,14012,1,2400,0,1971
3298201290,370000,3,1,940,7910,1,940,0,1959
0428000055,322500,3,1,1020,13504,1,1020,0,1959
8698600055,210000,2,2,1680,5756,2,1680,0,1910
3034200885,290000,2,1,1340,9840,1,1340,0,1949
2538400060,860000,4,3.25,3960,7012,2,3960,0,2005
3145600045,302000,6,2,2650,4621,1.5,2650,0,1911
7183000070,369160,4,2.25,2120,9680,2,2120,0,1965
6788200800,1.185e+006,4,2.75,2850,3000,2.5,2530,320,2003
0824059083,993000,4,2,2850,14810,2,2490,360,1954
2724069117,380000,6,2,1870,6969,1,1870,0,1968
9157600060,635000,4,2,2660,8160,1,1380,1280,1949
0943100262,260000,3,1,1190,11120,1,1190,0,1947
3810000465,243000,2,1,1770,5522,1.5,960,810,1943
2451000070,1.4e+006,4,2.5,2770,8879,2,2770,0,2001
7640400070,665000,4,2.5,2080,8100,1,1220,860,1952
7732410370,898000,5,2.25,2700,9000,2,2700,0,1987
3253500030,583000,4,2.75,2200,9453,1,1100,1100,1955
2128000160,429000,4,1.75,2160,7700,2,2160,0,1977
3764650070,471000,3,2.5,2010,4059,2,2010,0,1998
1118000465,1.81e+006,3,3.5,3780,8295,2,2430,1350,1951
2622059062,739500,3,3.25,4460,51177,2,4460,0,2005
2211700160,450000,3,1.5,1770,17208,1,1160,610,1959
9376301180,552500,3,1,1430,5000,1,1430,0,1949
2203500570,437000,4,1.75,1700,10642,1,850,850,1954
3634100030,270000,4,2,1830,5220,1.5,1830,0,1951
2599200830,226740,3,1.5,1410,8800,1,1410,0,1965
4140090370,446500,4,2.5,3060,7920,1,1810,1250,1974
2320069083,283000,3,2,1820,15068,2,1520,300,1920
6893300295,445000,4,1.75,2430,13211,1.5,2430,0,1909
7454000030,250000,2,1,740,6840,1,740,0,1942
7454001090,307000,3,1,770,6552,1,670,100,1942
2944500340,315000,4,2.75,2200,8580,1,1860,340,1991
2346800270,555000,3,3,2920,23085,1.5,1540,1380,1908
2796100640,264900,4,2.5,2040,7000,1,1250,790,1979
0993000046,510000,3,2,1600,4510,1,990,610,1978
2333230270,328000,4,2.5,1990,3980,2,1990,0,2002
5104510340,358000,4,2.5,1830,7308,2,1830,0,2002
2517000700,325000,3,2.5,2540,4260,2,2540,0,2005
1724069062,1.365e+006,2,3.25,2700,3444,3,2700,0,1990
5556800260,230000,4,2,1440,10800,1,1440,0,1967
2771603610,545000,3,2,1550,4000,1,940,610,1955
3629910240,705380,3,2.5,2490,4343,2,2490,0,2003
5634500036,459000,5,2.5,2650,12987,1,1350,1300,1979
2887703066,815000,4,2.25,2000,3800,2,2000,0,2001
3185600055,495000,6,5,3440,4500,2,3280,160,2007
1421069159,520000,3,2.5,2280,58712,2.5,2280,0,1987
0476000335,430000,2,1.5,1320,1194,3,1320,0,2001
0251300260,255000,4,2.5,2070,7800,2,2070,0,1989
2887700140,588000,3,2,1860,4777,2,1860,0,1908
3298201170,350000,3,1,940,7811,1,940,0,1959
2024059084,625000,4,2.75,2290,21486,1,2290,0,1963
7229700105,172500,2,2,1510,20685,1,1250,260,1958
2313900560,554000,3,2,1830,3500,1.5,1290,540,1909
6192400400,775000,4,2.5,3090,7112,2,3090,0,2001
1425069116,1.1875e+006,4,3.5,4340,217800,2,4340,0,2003
3582900200,618000,3,2.75,3200,12682,2,3200,0,1977
0243000335,305000,4,1,1560,8450,1.5,1560,0,1954
7760400350,232000,3,2,1280,13356,1,1280,0,1994
0128500260,262000,4,2.5,2020,6236,2,2020,0,2002
1697000370,234000,3,1,1040,8122,1,1040,0,1971
8902000267,500000,4,2.75,2260,7209,1,1330,930,2002
1218000030,278000,3,1,860,7632,1,860,0,1920
6099400140,230000,5,1,1920,19040,1,1160,760,1961
5710600030,500000,4,1.75,2290,9215,1,1270,1020,1969
7304300570,366500,4,2.75,2070,9300,1,1120,950,1945
1702901180,665000,6,3,4250,4400,2.5,3020,1230,1902
3508100135,1.101e+006,3,1.5,2220,4830,2,1790,430,1928
4443800030,575000,2,1.75,1840,4076,1,1140,700,1957
2553300140,674750,4,2.5,2590,9753,2,2590,0,1993
4154300465,719000,5,2,3110,6131,1,1560,1550,1940
3623029045,482000,3,1.75,2600,105587,1,1300,1300,1980
9371700125,254000,2,1,1060,8187,1,1060,0,1952
4443800810,443725,3,1.75,1250,3880,1,750,500,1944
1330900570,575000,4,2.5,2520,35636,2,2520,0,1980
4017110200,469000,3,2.25,2070,9957,1,1440,630,1977
0303000445,175000,2,1,1300,44431,1,1300,0,1958
7857003505,437000,5,2,2190,8316,1,1390,800,1961
4027701291,550000,4,3,2760,13113,1,1760,1000,1974
3831200200,172040,3,2.25,1710,7134,1,1130,580,1979
4123830070,363000,3,2,1750,7000,1,1750,0,1993
8946750140,282000,3,2.25,1552,3600,2,1552,0,2012
7129300400,400000,6,2,2350,6554,2,2000,350,1905
2126059234,650000,5,3.5,5110,10018,2,3850,1260,2003
0621069074,365000,3,2.5,1720,99916,2,1720,0,1990
7879600070,269950,4,2.5,1960,7230,2,1960,0,2002
6151800486,260000,2,1,1270,19602,1,1270,0,1977
8581200160,193000,3,1.5,1180,7000,1,1180,0,1977
2395710070,340000,4,2.25,2230,6791,2,2230,0,2005
6669100070,900000,4,3.25,4700,38412,2,3420,1280,1978
8856920070,371000,3,2.5,2150,8361,2,2150,0,1991
0323089084,592000,3,2.5,2400,81892,2,2400,0,1985
0798000342,300000,3,2.5,1830,12750,2,1830,0,1991
5104511840,449950,4,3,2800,6977,2,2800,0,2003
5205000400,299500,3,2.5,2090,7163,2,2090,0,1989
8565900160,995000,4,2.25,2340,13406,1,2340,0,1963
4302700445,335000,4,1.75,1670,9472,1,1100,570,1960
2413300240,280000,4,2.25,1990,7350,1,1180,810,1978
9477201620,446000,4,2.25,2270,7800,1,1290,980,1977
3395000070,1.5445e+006,4,2.75,4910,15139,1,2560,2350,1964
3336000791,325000,3,1,950,4500,1,950,0,1943
1087700030,450000,3,1.75,1610,11200,1,1610,0,1955
8856970570,322500,4,2.5,1940,7107,2,1940,0,2000
2206700295,453000,3,1,1210,9473,1,1210,0,1955
0293910030,655000,4,2.5,2570,4412,2,2570,0,2001
9547205660,603000,3,2.25,1700,2800,2,1150,550,1926
8856004400,235000,4,1,1610,24000,1.5,1610,0,1947
3888100128,968933,4,3.5,4120,7304,2,3070,1050,2006
8562900240,1.015e+006,3,3.5,2880,11340,1,1690,1190,1980
1088000030,435000,4,2.25,1990,8548,2,1990,0,1973
1545800640,242000,3,2,1260,8092,1,1260,0,1986
3020079078,487000,6,3.25,4750,248600,2,4750,0,1947
0011520640,810000,4,2.75,3010,10450,2,3010,0,1996
3407700046,625000,3,2.5,2410,64073,1,1820,590,1976
7696600240,165000,3,1.5,1280,7742,1,1280,0,1973
3904100106,335000,3,1,2320,6750,1,1160,1160,1960
7849201600,286700,3,1,1220,6600,1,1220,0,1958
8924100111,699000,2,1.5,1400,4050,1,1400,0,1954
2221000070,280000,3,1.75,1590,7280,1,1140,450,1974
8078350030,580000,4,2.5,2220,7064,2,2220,0,1988
8682281710,754800,2,2.5,2770,7781,2,2770,0,2006
1383500070,525000,4,2.5,2303,16801,2,2303,0,1995
6744700181,562000,3,1.75,1600,10530,1,1600,0,1962
6728700075,575000,4,1.75,1280,6060,1,860,420,1926
3630180240,808900,5,2.5,2900,5901,2,2900,0,2006
2162000160,992000,3,2.25,2950,15207,1,2070,880,1966
0705700140,335000,3,2.5,1700,6698,2,1700,0,1997
9423400193,473000,3,2.75,1050,7200,1,1050,0,1985
5137200140,350000,4,2.75,2990,11210,1,1880,1110,1977
5026900160,1.6e+006,5,2.5,3100,5374,2.5,3100,0,1906
4024101052,305500,3,1,1240,6090,1,1240,0,1950
1726069051,306000,2,1,780,13500,1,780,0,1946
6300000693,233000,2,2.25,850,1656,2,850,0,2001
6413100270,490000,3,1.75,1540,9000,1,1540,0,1971
7215420160,445000,4,2.5,2280,42077,2,2280,0,1994
7878400135,355000,3,2.25,2550,9674,1,1850,700,1959
2597710070,360000,2,2,1770,7607,1,1770,0,1987
9244900248,737500,3,1.75,2320,10900,2,2320,0,1935
0824059277,985000,3,3.5,2600,11920,2,2600,0,1969
3278601940,349950,2,3.25,1570,2031,2,1310,260,2006
7853250160,520000,4,2.5,3060,7161,2,2860,200,2005
1163100070,355950,4,2.5,1960,8540,1,1220,740,1955
8106300510,485000,5,2.5,3270,6129,2,3270,0,2004
4239400960,143000,3,1,1090,3315,1,1090,0,1969
7524900003,3.278e+006,2,1.75,6840,10000,2.5,4350,2490,2001
3893100327,355000,3,1,940,8512,1,940,0,1967
7856640560,1.126e+006,5,3.5,3880,13885,2,2540,1340,1979
7206900075,200000,5,1.75,1770,15525,1,1770,0,1959
8691310070,913000,4,2.5,3640,10576,2,3640,0,1999
4389200796,1.6e+006,3,2.5,3160,12824,1,1820,1340,1966
7436300160,409900,2,2.5,1590,1845,2,1590,0,1997
7896300070,265000,4,1,1290,6034,1,1050,240,1950
2425059074,740000,5,3,3655,51836,1,2174,1481,1955
2111010340,306000,4,2.5,2490,8124,2,2490,0,2001
7852150140,381000,3,2.5,1470,3999,2,1470,0,2003
1370800830,1.22e+006,3,3.25,3960,6132,2,2600,1360,1933
7632400400,1.05e+006,3,3.5,3190,29982,1,2630,560,1941
5220300140,408000,2,1,810,7440,1,810,0,1948
2568200140,739900,5,2.5,2980,5377,2,2980,0,2006
1137300340,674250,4,2.5,2780,35000,1,2780,0,1985
7640400106,438400,2,1,1340,8100,1,1340,0,1953
2175100055,1.7e+006,5,5,4930,14649,2,4160,770,2000
9274200990,703000,3,2,1360,5980,1.5,1360,0,1945
5028600550,262000,3,1.75,1320,6530,1,1320,0,1989
1471630160,353000,3,2,1210,14499,1,1210,0,1984
9430110030,500000,4,2.5,1940,7607,2,1940,0,1995
9275700016,1.28e+006,4,2.5,3160,4620,1.5,2020,1140,1917
6654700240,332000,4,2.5,1980,6566,2,1980,0,2004
8563080270,824000,4,2.5,2320,14240,1,1620,700,1974
7548300326,290000,4,2,1660,4788,1,1660,0,1968
5457300696,700000,3,2.5,1660,1545,2,1400,260,2002
1175001125,550000,2,1,1080,3420,1,780,300,1922
3034200197,549000,2,1,1510,11165,1.5,1510,0,1921
7787400105,1.865e+006,4,2.5,2950,43560,1,2550,400,1951
9346700270,858000,4,2.25,3070,13720,2,3070,0,1978
6414600260,345000,2,1,970,10423,1,970,0,1947
2620069195,340000,4,1.75,2140,11651,2.5,2140,0,1930
1300301840,1.215e+006,4,2.25,2570,9600,2.5,2570,0,1962
4358700186,275000,3,2.25,1260,1488,3,1260,0,2009
0259600560,405000,3,1,1220,7771,1,1220,0,1963
2634500070,432500,3,2,1720,8145,2,1720,0,1949
7186800105,236500,4,1,2140,4217,1.5,1320,820,1925
4459800070,679000,4,1.5,1420,4923,1.5,1420,0,1928
3034200370,543000,4,2.5,2060,8451,2,2060,0,1995
7887200390,294000,3,1,1320,9520,1,990,330,1953
2473390710,340500,3,1.75,1810,10463,1,1810,0,1969
2600140370,1.012e+006,4,2.5,2980,16263,2,2980,0,1989
7525100520,335000,2,2,1350,2560,1,1350,0,1976
6204200560,425000,3,2,1540,8011,1,1540,0,1988
5416100160,353000,3,2.5,2510,9240,2,2510,0,2001
3905040070,540000,3,2.5,1670,5146,2,1670,0,1991
8562900520,640000,5,3.5,3690,11928,2,2540,1150,2006
4027701182,339950,3,1,1320,11457,1,1320,0,1959
9407110710,195000,3,1.75,1510,8400,1,980,530,1979
9407110710,322000,3,1.75,1510,8400,1,980,530,1979
5160300030,660000,4,1.75,1870,10450,1,1620,250,1978
0001000102,280000,6,3,2400,9373,2,2400,0,1991
0001000102,300000,6,3,2400,9373,2,2400,0,1991
8945300200,207500,3,1,1170,8816,1,1170,0,1966
7796600070,195000,3,1.5,1190,8726,1,1190,0,1956
4443800765,700000,3,2,2080,3880,1,1160,920,1954
3298720030,560000,4,1.75,2150,8555,1,1460,690,1982
1781500435,260000,3,1.75,1580,7344,1,1580,0,1911
1781500435,575000,3,1.75,1580,7344,1,1580,0,1911
6979970140,475000,3,2.5,2370,3239,2,1950,420,2006
1005000036,285000,3,1.75,1840,8601,1,920,920,1905
3629921160,753888,4,2.5,2660,5500,2,2660,0,2003
3629910370,650000,3,2.5,2190,3600,2,2190,0,2003
5200100105,620000,3,2.25,1660,3478,1.5,1100,560,1929
1024069159,526000,3,1.75,1780,37801,1,1300,480,1977
0418000310,155000,2,1,700,5200,1,700,0,1952
0765000060,342000,4,2,1570,11200,1,1120,450,1959
2126079046,390000,3,1.75,1220,216332,1,1220,0,1981
2024079035,685000,3,2.75,3150,219978,2,3000,150,1990
7202270830,608000,4,2.5,2690,4736,2,2690,0,2001
0133000070,179900,2,1,680,6400,1,680,0,1943
2818600060,1.245e+006,6,3.25,3750,14150,2,2750,1000,1936
6082400083,166000,3,1,1010,11675,1,1010,0,1957
9412900045,462000,3,1.5,1710,4500,1.5,1410,300,1928
3905030140,545000,4,2.5,2090,6023,2,2090,0,1990
7228501580,415000,3,1,1560,4500,1.5,1560,0,1903
6679000390,269000,3,2.5,1560,4200,2,1560,0,2003
1822500160,356500,4,2.5,2570,11473,2,2570,0,2008
6889000060,225000,3,1,1010,7633,1,1010,0,1961
0835000055,175000,2,1,1020,5130,1,1020,0,1948
7811210320,549000,5,2.5,1710,9720,2,1710,0,1974
3123049320,535000,3,2.75,2300,12197,2,2300,0,1989
4123400320,627000,4,2.25,1990,7712,1,1210,780,1973
4477000270,565000,3,2,2730,15677,2.5,2730,0,1976
3126049094,392450,4,2,2195,2681,1,1060,1135,1912
8682282180,509000,2,2,1560,4675,1,1560,0,2006
1232000810,340000,3,2.5,1400,4800,1,1200,200,1921
1232000810,537000,3,2.5,1400,4800,1,1200,200,1921
8691330310,865000,4,3,3690,9892,2,3690,0,1998
3996900295,358000,2,1,1140,8340,1,1140,0,1948
0117000003,595000,4,2.25,1920,3225,1.5,1300,620,1923
1471590060,661000,4,2.5,2496,8058,2,2496,0,1998
2558650200,419950,3,2.25,2280,8500,1,1680,600,1977
5104531580,490000,4,3.5,3200,6420,2,3200,0,2006
6021503570,525000,2,1,880,4000,1,880,0,1940
1862400517,350000,3,2,1320,1298,3,1320,0,1995
2738650030,552500,3,2.5,2450,3582,2,2450,0,2008
5560000710,210000,3,1,1040,8970,1,1040,0,1961
7215410320,390000,3,2.5,2480,53250,2,2480,0,1990
3971700510,336800,5,1.75,1830,16650,1.5,1610,220,1958
7202330270,465000,3,2.5,1440,4473,2,1440,0,2003
9542830160,299900,4,2.5,1580,3632,2,1580,0,2011
3630120960,715000,3,3.25,3230,5000,2,3230,0,2006
3622059155,235000,4,2.5,1810,39639,1,1230,580,1970
1687000240,276000,3,2.5,2495,4400,2,2495,0,2007
4322300340,265000,4,1.5,1740,12728,1,1180,560,1964
3797000830,425000,3,1.75,1680,3000,1,840,840,1900
4137060270,313000,4,2.5,2460,10320,2,2460,0,1993
7277100640,715000,3,2.5,3050,6000,1,1720,1330,1984
1312920060,265000,3,2.25,1630,10969,2,1630,0,1991
1472330030,646000,3,2.75,2460,6413,2,2460,0,2004
2973800030,175000,3,1,1030,6600,1,1030,0,1954
5152920070,649000,3,2.5,3410,13809,1,2450,960,1973
2021200058,785000,3,2.75,2310,5200,1,1520,790,1940
9828202255,890000,4,2.75,2610,4400,1,1260,1350,1920
2126059276,612000,3,3,2330,10327,1,2330,0,1998
7796450340,330000,4,2.5,2980,5674,2,2980,0,2003
1449000260,493000,3,2.25,1790,11393,1,1790,0,1978
8722100570,1.6e+006,4,2.25,2940,5735,1,1470,1470,1957
7856400240,1.62e+006,4,3,3900,9750,1,2520,1380,1972
7856400240,1.65e+006,4,3,3900,9750,1,2520,1380,1972
3037200060,499000,3,2.5,1750,2150,2.5,1230,520,1900
6071700160,603500,6,2.75,2660,8400,1,1550,1110,1962
7645900055,530000,2,1.5,1580,3680,1,1280,300,1941
0292000070,895000,5,2.5,2350,14197,1,1220,1130,1962
9510900710,267345,4,2.25,2510,8165,1,1610,900,1972
1471620240,275000,3,2.5,1480,15639,2,1480,0,1987
1626079012,439950,3,1.75,1720,223377,1,1240,480,1950
3904901670,455000,3,2.25,1470,4653,2,1470,0,1985
8927600070,630000,3,1.75,1540,6930,1,1250,290,1944
3629970240,690000,3,2.5,2820,5001,2,2820,0,2004
1099610260,212000,4,1.75,1250,12705,1,1250,0,1971
5420300270,231500,4,2.25,2080,7526,1,1280,800,1985
2954400520,1.2375e+006,4,3.25,5180,49936,2,5180,0,1991
1121059105,378500,3,2.5,2860,43821,2,2860,0,1990
2591720070,482000,4,2.5,2710,35868,2,2710,0,1989
9178600055,695000,2,1,1140,3990,1,1140,0,1924
9290850800,965000,4,2.5,4070,57587,2,4070,0,1989
5040800060,675000,3,1.75,1710,5913,1,1120,590,1941
1437900350,387000,3,1.5,1340,6500,1,1340,0,1972
1328300810,347500,4,2.75,2290,7000,2,2290,0,1977
3990200125,385000,3,2,1860,7400,1,930,930,1922
7452500340,265000,3,1,1080,4930,1,1080,0,1950
9215400075,406000,3,1,960,5264,1,960,0,1953
5061300030,134000,2,1.5,980,5000,2,980,0,1922
3362900696,415000,3,1,1500,3399,2,1300,200,1926
2558640340,375000,3,1.75,1440,8775,1,1440,0,1973
8078460810,620000,4,2.5,2580,7465,2,2580,0,1993
0538000390,337500,5,2.5,2070,4698,2,2070,0,1999
3584900160,565000,3,2.5,1880,12368,1,1260,620,1967
8572900135,399500,3,1.75,2420,12676,2,2420,0,1911
8056000075,1.065e+006,2,1.75,1890,9466,2,1890,0,1987
2972300140,352500,3,2,1920,33630,1,1920,0,1992
7697870350,259000,3,2,1870,5909,1,1270,600,1986
7972601710,320000,2,1,900,7620,1,900,0,1971
6421100342,733000,3,2.5,2160,9888,2,2160,0,1989
2464400340,381500,2,1,900,2910,1,900,0,1924
8113101232,343000,2,1,1180,9261,1,940,240,1957
5706500140,205500,2,1,900,6400,1,900,0,1938
1024069037,525000,3,2,1600,16530,1,1600,0,1967
9476700135,300000,3,1.75,1500,8352,1,750,750,1943
1926069035,299000,2,1,1070,189486,1,1070,0,1942
3904990030,561000,4,2.5,2570,5250,2,2570,0,1990
7132300550,450000,3,1,1210,4000,1.5,1090,120,1928
2193340140,540000,4,2.5,1850,7850,2,1850,0,1985
1422300160,379000,3,2.5,1740,30886,2,1740,0,1992
2946000751,230000,3,1,1300,14000,1,1300,0,1958
1796250140,399950,3,2.5,2000,30605,2,2000,0,1989
6699001200,355000,5,2.5,3220,5806,2,3220,0,2002
7525300310,580000,4,2.25,2160,9593,1,2160,0,1969
5700000340,700000,3,2,2130,4299,1.5,1680,450,1922
3210400340,279900,3,1.75,1580,8151,1,1100,480,1962
0179003055,210000,3,1,1200,7500,1,1200,0,1905
9829200566,1.165e+006,3,3,3790,5001,2,2810,980,1989
1723059050,290300,2,1,860,3874,1,860,0,1931
2624059036,1.59995e+006,5,4.5,5130,43123,2,5130,0,1996
5101406441,490000,3,1,1600,6380,1.5,1400,200,1939
8582010240,606000,4,2.5,2110,13850,2,2110,0,1987
6300500505,359950,3,1,1400,4980,1,950,450,1943
3275890310,677100,3,2,2110,9199,1,2110,0,1993
7715801040,465000,3,2,1430,7125,1,1430,0,1984
7738500731,4.5e+006,5,5.5,6640,40014,2,6350,290,2004
1822079046,500000,3,2,3040,41072,1,1520,1520,1978
1062100075,455000,2,1,980,5000,1,980,0,1950
8825900070,705000,6,2,2570,4240,1.5,1970,600,1911
1158700135,420000,3,2.5,2060,7020,1,1460,600,1967
7983000200,169575,3,1,1300,8284,1,1300,0,1968
7983000200,250000,3,1,1300,8284,1,1300,0,1968
1727510030,530000,3,2.25,1680,7262,1,1180,500,1973
3286800370,590000,5,3.25,4020,40341,1,2170,1850,1970
6791400320,257500,3,1.75,1530,14087,1,1070,460,1979
3992700036,415000,3,1,1170,6700,1,1170,0,1957
1175000059,536000,3,1.75,1580,3764,1.5,1280,300,1945
8732000390,246500,3,1.5,1270,11600,1,1270,0,1964
1441800030,395000,3,1.75,1480,7700,1,1480,0,1975
4045800030,739000,3,2.25,2220,10530,1,1700,520,1974
1727850340,1.272e+006,4,2.75,3200,13729,2,3200,0,1984
2268000370,190000,3,1,910,10575,1,910,0,1968
2023049350,305000,3,1.5,1480,9086,1,1480,0,1962
7018000560,925000,4,4.25,3770,13058,2,3770,0,1983
4147200140,895000,4,3,3500,13444,2,2360,1140,1977
3176600055,656000,3,1.75,1480,7475,1.5,1480,0,1943
7518500885,560000,4,1,1660,4690,1.5,1260,400,1945
7504020810,610000,5,2.25,2520,11700,2,2520,0,1977
3276930370,645000,4,2.5,2850,37522,2,2850,0,1987
1687000200,259000,3,2.5,2153,4400,2,2153,0,2007
7501000340,980000,4,2.5,3780,10962,2,3780,0,1990
7611200136,872000,4,4,3770,9750,1,1940,1830,1967
5459500125,1e+006,6,2.75,3600,9675,1,1940,1660,1977
0825059271,900000,3,2.75,2980,12600,1.5,1590,1390,1941
9465200181,475000,4,1.5,2320,5534,1.5,1540,780,1915
5469502860,350000,5,2.75,2980,13482,1,1730,1250,1975
0486000565,840000,4,1.75,2930,11562,1,1670,1260,1947
6071900070,500000,4,2.5,2040,8400,1,1420,620,1963
7957600075,202500,3,1.5,1510,9898,1,1110,400,1954
0823069074,523000,4,2.5,2660,65340,2,2660,0,1988
2366800055,225000,3,2.5,1740,10050,2,1740,0,1989
7272001805,418200,3,2.25,2240,9542,1,1190,1050,1980
3582700070,356500,4,1.75,1570,9670,1,1170,400,1959
2402100055,670000,4,3,2500,5000,1.5,1460,1040,1926
5146000070,456150,3,2.25,1750,12408,1,1150,600,1962
2607760890,471000,4,2.5,3030,9687,2,2020,1010,1998
9274200316,558000,3,2.5,1680,934,3,1680,0,2008
4139500200,1.38e+006,6,4.5,5740,10312,2,3610,2130,2000
3021059155,161500,3,1,1220,6000,1,1220,0,1961
3580900160,311000,3,1,1310,8370,1.5,1310,0,1962
3876000350,470000,6,1.75,2490,8732,1.5,2490,0,1966
3959400400,569000,3,3.25,2220,8227,1.5,1770,450,1929
8079100700,689000,4,2.5,2240,7350,2,2240,0,1989
9407001610,271900,3,1.75,1890,11875,1,1230,660,1979
8700120270,278000,4,2.5,1850,6037,2,1850,0,1991
3204300860,820000,2,2.5,2210,4440,2,1440,770,1931
3204800520,399500,3,1.75,1410,7700,1,1410,0,1967
8857320260,462000,3,2.75,1890,2614,2,1890,0,1979
6791400800,347500,3,1,1830,12036,1,1550,280,1977
2768000270,562100,2,0.75,1440,3700,1,1200,240,1914
1432400060,230000,2,1,950,7560,1,950,0,1958
2547200240,687000,4,2.5,2370,10083,2,2370,0,1966
6441800060,725786,4,2.5,3070,5762,2,3070,0,2000
1775800710,315500,3,1,1300,12600,1,1300,0,1969
7694600253,312000,4,2,1300,7054,1,1300,0,1950
8910500238,343000,3,3.25,1210,1173,2,1000,210,2002
3076500830,385195,1,1,710,6000,1.5,710,0,2015
1072030510,415000,4,2.25,2240,12650,1,1730,510,1981
3888100226,461000,3,1.75,3600,8666,2,2400,1200,1948
7227501369,369990,4,2.5,1960,7133,2,1960,0,2002
3820350070,349950,4,2.5,1820,3134,2,1820,0,1999
7616800350,285750,3,2.25,1960,17126,1,1400,560,1966
7811210200,542500,4,2.25,1750,10160,1,1320,430,1972
6891100260,830000,5,3.5,3700,5400,2,2890,810,2011
6076500160,705000,4,2.5,2910,20946,2,2350,560,1976
2872100445,615000,2,1,1270,5000,1,1090,180,1949
3352400004,184500,2,1,720,5880,1,720,0,1940
7942601200,412000,2,1,1040,5120,1,1040,0,1901
0985001266,250000,3,1.5,2210,11111,1.5,2210,0,1934
2218000390,580000,5,2,2060,6000,2,2060,0,1903
7231502505,220000,2,1,780,6000,1,780,0,1923
7555220140,675000,4,2.75,2240,8937,1,1460,780,1976
7445000105,373500,2,1,800,3330,1,800,0,1918
5583200810,662700,2,1.5,2440,6900,2,1590,850,1910
7340600827,239950,5,1,1460,6032,2,1460,0,1941
7436900045,383000,3,1,1150,10196,1,1150,0,1957
4027701294,485000,3,2.75,2650,12350,1,1470,1180,1975
3570000160,610000,4,2.75,2600,36583,1,1580,1020,1976
9276202190,545000,6,1.75,1820,6250,1,1130,690,1954
5016002180,780000,2,2.5,2560,2500,2,1690,870,1901
7300000550,305000,3,2.5,1714,3240,2,1714,0,2005
6817810310,405000,3,1,1330,15678,1,900,430,1984
7851980260,1.11e+006,5,3.5,7350,12231,2,4750,2600,2001
1423400260,273000,3,1.75,2050,9045,2,2050,0,1959
3876810140,326500,3,1,1810,12375,2,1810,0,1970
3276180140,365000,3,1.75,1380,9134,1,880,500,1981
9808590310,1.00075e+006,3,2.75,3070,10739,2,2440,630,1987
0546000045,422500,2,1,800,4046,1,800,0,1940
2595650060,354450,4,2.75,2140,9920,2,2140,0,1993
1771110550,320000,3,1,1330,9540,1,1330,0,1971
5335700030,223000,3,1,1030,9120,1,1030,0,1961
7203101580,410000,3,2.5,1740,4948,2,1740,0,2008
0272000125,438000,3,1,1200,4000,1.5,1200,0,1923
2770601741,390000,3,3,1490,2944,2,960,530,1993
4250200140,298500,4,2.5,1890,5954,2,1890,0,2004
8965400390,749999,5,2.25,3060,13630,2,3060,0,1989
5071401000,779000,6,2.5,3250,12000,1,1800,1450,1966
3760500435,570000,3,2.75,2730,11936,2,1530,1200,1978
5680000260,385000,3,1,810,4600,1,810,0,1918
9170500060,649000,4,2,2240,11040,1,1120,1120,1961
0795000885,283000,3,1,1740,5247,1,1270,470,1947
4038600260,699900,4,2.25,2380,16236,1,1540,840,1961
4406000560,278500,4,1,1540,8400,1,770,770,1971
2260000340,700000,4,1.75,2340,9100,1,1610,730,1975
9510310030,535000,4,2.75,2710,45963,2,2710,0,1995
4245400045,234500,3,1.75,1310,18400,1,870,440,1954
9371700132,374150,3,1.75,1390,9585,1,1390,0,1973
7272001610,397000,4,2.5,2201,9542,2,2201,0,2006
1324059139,613000,3,2.25,1960,10385,1,1960,0,1988
1552100135,1.15e+006,3,2.5,2850,10474,1,1730,1120,1954
1257200060,595000,4,1.75,1880,4080,1,940,940,1924
2822059350,340000,5,2.75,2440,6858,2,2440,0,2003
2781260070,388000,4,2.5,2560,5800,2,2560,0,2005
0619000045,404000,3,1.75,1410,15210,1,1410,0,1950
8934100125,810000,3,2,2870,6360,1.5,1790,1080,1946
2472920140,405000,4,2.5,2620,9359,2,2620,0,1987
7215730310,726000,5,3,2970,10335,2,2970,0,2000
7697870310,266000,3,2.5,1780,7214,1,1400,380,1986
2795000060,722500,5,2.25,3700,7207,1,1850,1850,1970
2408600160,352000,4,2.5,1252,25002,1,992,260,1996
7888200240,265000,4,1.5,1240,8158,1,1110,130,1961
0151000075,856000,3,2.5,2160,3920,2,2160,0,2014
5104530240,346950,3,2.5,2040,4348,2,2040,0,2006
4139680070,866059,5,3.5,3130,4797,2,2570,560,2014
7852180260,410000,3,2.5,2350,4456,2,2350,0,2004
1471610060,370000,3,1.75,1570,16817,2,1570,0,1982
3520069033,230000,3,1,1530,389126,1.5,1530,0,1919
9268200550,400000,2,2,1520,5010,1,1520,0,1999
1788700295,172000,3,1,1350,9680,1,820,530,1959
7379600240,615000,3,1.75,1950,8480,1,1250,700,1962
8691330060,860000,4,3.5,3950,9600,2,3950,0,1998
6384500581,555000,3,1.75,2040,6000,1,1120,920,1958
6690500070,579000,3,2.5,1990,4040,1.5,1390,600,1926
3205400140,385000,3,1.75,1300,7030,1,1300,0,1968
6662410070,420000,4,2.25,2030,12000,2,2030,0,1977
1919800260,645000,3,1.75,2340,6750,1.5,1620,720,1914
7283900045,549950,3,2.5,2160,6288,2,2160,0,1996
3756100160,678000,3,2.75,2770,10000,1,1640,1130,1962
3352401981,199000,4,2,2030,8120,2,2030,0,1950
5315100394,604000,3,1,1440,13824,1,1440,0,1957
3450300270,268000,5,1.75,1730,10368,1,1010,720,1963
2325069117,960000,5,3.5,4510,16305,2,2820,1690,2003
7199340310,509250,3,2.5,2100,7600,1,1450,650,1980
8663260030,416000,3,2.5,1800,5372,2,1800,0,1987
9315100030,190000,3,1,1090,8520,1,1090,0,1967
2190601049,212000,3,1.5,1010,10000,1,1010,0,1973
9264930400,325900,3,2.5,2040,9765,2,2040,0,1985
2490200055,560000,3,3.5,2270,4088,2,1880,390,1996
3830630140,275000,3,2.5,1730,5799,2,1730,0,1987
6385260160,665000,4,2.5,2480,15411,2,2480,0,1994
5701500030,1.505e+006,4,3.5,3480,7232,2,2580,900,1926
0859000160,375000,4,2,1720,2410,1,970,750,1930
0123039633,359950,3,1.75,1570,6975,1,1040,530,1979
3601200465,340000,4,2.75,3527,7200,2,3527,0,2005
0106000320,401000,2,1,840,8100,1,840,0,1948
7631200292,669000,2,1.75,1950,10766,1,1160,790,1952
2526059046,638500,4,2.5,1980,6568,2,1980,0,2004
3416600111,545000,2,1.5,1620,3760,2,1170,450,1924
3205500160,524000,4,1,1980,7015,1,1260,720,1973
0824059331,1.61e+006,5,3.75,3530,13260,2,3530,0,2013
5347200060,280000,2,1,1260,4800,1,1100,160,1947
9323610260,828000,4,2.5,2120,10841,1,1500,620,1979
8732160240,223000,3,1.75,1360,10573,1,1360,0,1984
9808640320,1.289e+006,4,3.5,3100,2261,2,2250,850,1981
1326069050,750000,2,2,2370,155130,1,2370,0,1970
1454100267,430000,2,1,1460,9207,1,1210,250,1947
5021900160,711000,4,1.75,1980,10800,1,990,990,1948
0818100030,310000,4,2.5,1930,7014,2,1930,0,1994
0393000045,415000,5,1.75,3700,9140,1,1850,1850,1957
8091411040,274900,4,2.5,1970,6600,2,1970,0,1987
5561200310,525000,3,3,2470,36445,2,2470,0,1980
3204500340,179500,3,1,1180,32214,1,1180,0,1952
9222400935,478000,3,1,1280,2580,1.5,1280,0,1910
1796350570,195000,3,1.75,1380,7350,1,990,390,1981
2473450200,385000,4,3,2740,10925,1,1670,1070,1980
1387300570,401000,3,2.75,2020,9505,1,1260,760,1969
8857640860,522000,4,2.5,2835,6598,2,2835,0,2002
5415000240,330000,4,1.75,1520,14417,1,1520,0,1968
2591760070,503000,3,2.5,2190,4882,2,2190,0,1999
4131500140,175000,5,1.75,1680,8400,1,1680,0,1979
7203220370,963990,4,3.5,3915,6364,2,3915,0,2014
1651500060,845000,5,2,1720,9972,1,1720,0,1951
7883600700,157500,2,1,670,4500,1,670,0,1905
0567000755,450000,2,3,1790,1709,2,1400,390,2001
9294300615,925000,4,1.75,2440,11793,1,1420,1020,1950
3213200215,600000,2,1,920,5029,1,920,0,1938
9136101776,709000,4,1,1680,4087,1.5,1680,0,1911
5035300850,1.385e+006,5,3.75,3290,6480,2,2190,1100,1938
3668001080,248000,3,2.5,2120,6840,1,1220,900,1984
5540800100,245000,3,1,910,6630,1,910,0,1912
3679401110,332000,2,1,1000,4776,1,1000,0,1942
7852130100,459950,3,2.5,2340,4273,2,2340,0,2002
9828200147,425000,3,2,1180,1800,2,1180,0,1994
0826069085,460000,3,2.25,2080,50965,1,1590,490,1979
6383900090,838300,6,2.5,3760,12978,1,2360,1400,1967
8100000090,256000,3,2.5,1480,7200,2,1480,0,1995
7805450750,864000,3,2.75,3060,13554,2,3060,0,1984
0148000705,900000,4,3.5,3070,4440,2,2030,1040,1922
1432400490,145600,3,1,1170,7560,1,1170,0,1958
7974200820,865000,5,3,2900,6730,1,1830,1070,1977
8731951130,250250,3,2.25,2210,8000,2,2210,0,1969
7227801955,162000,4,2,1440,7641,1,1440,0,1943
3558910490,450000,4,1.75,1980,7350,1,1430,550,1973
0324059112,675500,4,2.75,2060,21344,1,1460,600,1978
2710600025,697000,3,2.25,2420,5304,1.5,1640,780,1947
7582700100,1.32405e+006,3,3.25,3440,4080,2,2560,880,2005
3882300100,490000,3,1.75,1600,16510,1,1600,0,1984
3735900590,590000,3,2.25,2210,5742,1,1460,750,1951
5153200356,280000,4,1.75,2250,16000,1,1450,800,1957
7625702350,515000,2,1,1680,6500,1,1140,540,1941
2755200090,576000,3,1,1140,5395,1,1010,130,1909
0626059317,375000,3,1.75,1430,10574,2,1430,0,1981
7199360090,478000,3,1,1440,7107,1,1000,440,1980
8651443480,282000,3,1,1670,5200,1,1030,640,1977
9359100750,1.4e+006,4,4.5,3080,10550,2,1940,1140,1976
5561400740,593500,5,3.25,4300,50405,2,3220,1080,1972
1723099031,724950,4,3.5,3010,174240,2,3010,0,2004
7236500025,306000,3,1.75,1560,7500,1,1560,0,1966
2473411080,341000,4,1.75,1920,7665,1,1500,420,1975
1773101335,399950,3,2.5,1400,4400,1,1400,0,1930
9126100850,534000,5,2,2280,3600,2,2280,0,1992
7202331220,635000,6,2.5,3880,5700,2,3880,0,2003
5511600245,350000,2,1,1350,3880,1,950,400,1927
1344300090,856000,3,1.5,1480,2700,1.5,1480,0,1928
9828702812,582000,4,3,1670,1189,3,1427,243,2000
3825310820,799000,4,2.5,3400,6742,2,3400,0,2004
7852040110,423700,3,2.5,2070,3986,2,2070,0,1999
6752500090,1.835e+006,4,3.5,4870,39190,2,4870,0,1995
3222079162,322000,3,2,1760,43575,1,1160,600,1988
1025069192,929000,4,3.25,4030,57499,2,4030,0,2002
5101404608,443000,2,1,1130,5413,1,880,250,1939
9477100490,441500,3,1.75,1510,7700,1,1510,0,1968
0324069015,875000,4,3.5,3110,108464,2,3110,0,1979
4114601570,3.6e+006,3,3.25,5020,12431,2,3420,1600,1941
7920100025,450000,2,1,740,5100,1,740,0,1947
3275730110,425000,3,2.25,1630,10500,1,1100,530,1974
7504030090,660000,4,1.75,2780,9900,2,2780,0,1978
8813400405,763101,3,1.75,1990,5560,1,1100,890,1939
1313300300,499000,4,2.75,2250,14149,2,2250,0,1992
8121610110,521000,3,1.75,1720,37363,1,1350,370,1974
1820069019,302000,2,1,900,423838,1,900,0,1925
9406450090,293000,4,2.25,2360,6260,2,2360,0,1998
2619950490,335000,3,2.25,1530,4580,2,1530,0,2011
1646500785,499000,2,1,1450,3090,2,1450,0,1919
1868901690,600000,3,1.75,2040,5000,1.5,1780,260,1924
9542400025,720000,4,1.75,2620,11041,1.5,2620,0,1962
2781270090,195000,2,2,1180,2553,2,1180,0,2005
1665400165,249000,3,1,1110,8423,1,1110,0,1952
1326069191,334000,3,2.25,1840,9781,2,1840,0,1989
0381000110,599950,4,1.75,2720,7810,1,1510,1210,1952
3530530110,149900,2,1.75,1090,1950,1,1090,0,1982
5210200107,700000,4,1.75,1730,6500,1,1250,480,1945
1574100025,525000,4,1.5,1170,6240,1,1170,0,1960
2523069192,1.049e+006,4,3.75,4740,126759,2,4740,0,1991
6706600090,402000,3,2.5,1960,8000,1,1290,670,1977
1994200031,450000,3,2,1430,3480,1,980,450,1947
2523069156,520000,3,2.25,2510,43995,2,2510,0,1981
5029450850,205000,3,1.75,1420,6980,1,820,600,1980
2723069147,635000,3,2.25,2680,175982,1,2680,0,2004
3750605349,210500,3,1,1220,9600,1,1220,0,1958
9285800735,406650,2,1,1070,6100,1,1070,0,1940
7574000100,350000,3,1.75,1580,19998,1,1580,0,1968
9212900100,425000,4,1.75,1820,6000,1,930,890,1942
8651611130,798000,3,3.5,3590,6402,2,3590,0,1999
0423059184,180000,3,1,1960,9583,2,1960,0,1908
5451200600,1.25e+006,5,3.25,3160,13238,2,3160,0,1972
6300000378,435000,4,2,2030,4033,2,1630,400,1925
2570300090,355000,3,1.5,1240,15867,1,1240,0,1962
9808100100,3e+006,5,3.25,5370,14091,2,3850,1520,1918
4019300906,685000,5,2.5,2670,14455,2,2670,0,1958
1023059223,311000,3,1,1640,12060,1,1640,0,1960
9320700090,305000,4,2.25,2130,9600,1,2130,0,1966
5700002460,675000,3,2.5,2550,4954,1.5,1850,700,1924
7598100735,769000,4,2.75,3630,15405,1,1850,1780,1968
2202500110,430000,3,1.5,1690,9708,1.5,1690,0,1954
0726059395,516250,6,2,2390,8660,1.5,2390,0,1925
1455600015,760000,3,3.5,2350,10739,1,1340,1010,1940
9528101224,579950,3,3.5,1420,1217,2,1180,240,2003
6713100031,476000,3,2.25,1570,7187,1,1170,400,1980
8677900123,510000,3,1.75,1600,19200,1,1600,0,1967
4302201130,205000,2,1,720,5040,1,720,0,1955
1310800090,240000,3,1,1470,7350,1,1470,0,1969
6117502727,738000,5,3.5,2790,16952,2,1970,820,1991
9324800110,420000,3,1.75,1720,8102,1,860,860,1940
8965000110,455000,3,1.75,1300,9600,1,1300,0,1969
5700001055,765000,4,1,2520,5500,1.5,1820,700,1912
0049500090,372000,4,1.5,1780,7914,1.5,1780,0,1962
3812400657,160000,3,1,1200,8360,1,1200,0,1948
2725069162,772000,4,2.5,2990,9643,2,2990,0,2003
4232400110,1.125e+006,5,1.75,1910,5640,2,1910,0,1906
9521100586,479000,3,1,1370,3000,1.5,1370,0,1924
7215721570,570000,3,2.5,1910,4941,2,1910,0,1999
3834000805,350000,4,1,1170,8147,1.5,1170,0,1959
2274000026,353000,3,2.5,1250,864,3,1250,0,2004
5103300090,699000,5,2.5,3340,24755,2,3340,0,2002
9558200025,265000,3,2,1380,8536,2,1380,0,1955
8649401270,167000,1,1,780,10235,1.5,780,0,1989
0686200740,500000,4,2.25,2080,8000,1,1390,690,1964
7658600025,700000,3,1,1410,7200,2,1410,0,1901
3702900165,295000,1,1,520,5600,1,520,0,1918
7977201240,1.01e+006,4,3.5,3500,4080,2,2590,910,2004
8651410090,209000,2,1,840,5265,1,840,0,1969
3750603732,276000,3,1.75,2240,9200,1,1440,800,1968
1023059429,380000,4,2.5,2100,5857,2,2100,0,2002
2412100025,315000,3,1.5,1750,12500,1,1150,600,1954
0203600600,685530,4,2.5,3130,60467,2,3130,0,1996
2021069059,254600,3,2,1470,20000,1,1470,0,1968
7227501645,230000,3,2,1440,5600,1,720,720,1942
4310702787,335000,3,3,1430,1249,3,1430,0,2003
1494300110,550000,4,2.5,2170,9600,1,1460,710,1980
1950900245,123300,3,1,1150,8050,1.5,1150,0,1956
3512100110,275436,4,2.75,2170,9658,1.5,2170,0,1966
8732750100,325000,4,3.5,2630,3435,1.5,1640,990,1984
1332000110,635000,4,2.5,2490,40608,2,2490,0,1997
2768100690,513000,3,1.75,1710,5000,1,1110,600,1944
7525410090,580000,4,2.5,2130,35752,1,1490,640,1980
9558800025,225000,3,1,940,9272,1,940,0,1954
2788400315,265000,3,1,1400,9460,1,1060,340,1961
7128300855,313000,4,1.75,1630,3000,1,930,700,1978
7655900038,296000,2,1,1370,8400,1,1370,0,1948
7923500090,655500,4,2.75,2380,15800,1,1680,700,1957
3339900096,250750,5,1.75,2140,12058,1,2140,0,1951
5214500690,438000,4,2.5,1970,8545,2,1970,0,2004
4045900147,590000,3,2.75,2550,54014,2,1980,570,1967
6450302900,329500,3,1,1080,5250,1,1080,0,1947
2597460090,1.195e+006,3,2.25,3070,9645,2,2110,960,1987
2770601595,415000,2,1,1470,6000,1,900,570,1944
4188000490,900000,4,2.5,3620,42580,2,3620,0,1984
1324079085,378000,3,1.5,1050,57499,1,1050,0,1975
1720069006,474000,2,1,1050,403365,1,1050,0,1905
1947300115,464000,3,1,1320,3625,2,1320,0,1900
5490700100,310000,3,1,1210,7649,1,1210,0,1956
7278100690,580000,3,1.5,1860,7190,2,1860,0,1952
2322029048,999000,3,2.75,2830,505166,1,1830,1000,1962
6821102100,510000,2,1,810,6480,1,810,0,1942
3176100110,650000,3,1.5,1630,7475,1,1160,470,1940
2188200785,196000,3,1,880,19600,1,880,0,1978
1446801030,220000,4,1.75,1660,11664,1,1010,650,1952
8965520100,855000,3,2.25,3440,10628,2,3440,0,1985
3649100586,483000,3,1.75,2110,10454,1,1440,670,1978
7283900153,400000,3,1,1060,12000,1,1060,0,1952
1036100100,435000,3,2.5,1900,7984,2,1900,0,1993
3278602670,219500,1,1,820,1060,1,760,60,2007
3625049014,2.95e+006,4,3.5,4860,23885,2,4860,0,1996
7276100165,427000,3,2.5,2050,3218,3,2050,0,2008
9136103130,430000,2,1.5,1090,4013,1.5,1090,0,1900
9136103130,685000,2,1.5,1090,4013,1.5,1090,0,1900
1193000025,495000,2,1.5,1920,6250,1,1060,860,1937
2744000100,299950,3,2.5,1870,7942,2,1870,0,1990
3744600028,390000,4,1.75,2690,46609,1.5,2690,0,1940
3679400025,385000,3,1.75,2160,5863,1.5,1260,900,1928
9545260100,740000,4,2.5,3000,10392,2,3000,0,1995
0375000165,991700,4,3,2290,2350,2,1610,680,1924
4003000053,765000,3,2.75,2250,9600,2.5,1830,420,1909
7855600820,802000,4,2.25,2130,8734,2,2130,0,1961
3860400100,950000,4,2.75,2500,20000,1,1700,800,1969
0121059147,392000,4,2.5,2300,41167,2,2300,0,1988
0825079019,590000,3,2.5,3360,218235,1,3360,0,1989
0123039313,425000,4,2.5,1920,9000,2,1920,0,1989
7784000110,765000,5,1.75,2440,15143,1.5,1740,700,1944
8835220090,313500,3,2.25,1440,3488,2,1440,0,1983
6381501636,320000,3,1,1780,6840,2,1780,0,1947
1370804446,604000,4,1.75,1490,4485,1,1350,140,1960
9828701871,570000,3,2,1400,1657,2,1060,340,2004
3396200090,639000,4,2.5,2150,12028,2,2150,0,1982
1463400047,335000,4,2,1910,10200,1,1910,0,1963
8825900855,896000,4,1.75,2660,3520,2,2080,580,1917
7147600245,259500,3,1.75,1650,12349,1,1650,0,1957
5071400485,637000,3,2,1980,6000,1,1380,600,1958
8732040090,307450,4,2.75,2690,8874,1,1370,1320,1980
8082400100,535000,3,1.75,1380,3561,1,860,520,1925
0546000930,669500,4,2.25,2500,4046,1.5,1520,980,1940
1665400025,259000,3,1.75,1590,7148,1,1590,0,1952
9187200245,441000,4,1.5,1100,3300,1,1100,0,1919
2123700015,228800,4,2.5,1470,1612,2,980,490,2003
8682291730,530000,2,2,1680,4950,1,1680,0,2006
5318100504,524000,2,2,1450,2272,1,750,700,1924
9297800165,430000,4,2.25,2020,4840,1.5,1200,820,1925
1342300265,1.325e+006,4,3.25,2470,4760,1.5,1890,580,1906
2212901130,210000,3,1,1230,12201,1,1230,0,1969
8122100690,449000,4,2.5,1850,5040,1,1230,620,1930
0148000375,945000,2,2.5,2540,7089,2,2540,0,2004
3423049209,200450,3,1,970,9130,1,970,0,1957
0016000015,219950,3,1.5,1070,6601,1,1070,0,1985
4035900015,659500,4,3,2620,18362,1,1870,750,1956
8563010300,746000,4,2.75,2110,8190,1.5,2110,0,1966
3396200300,540000,3,1.75,2110,7129,1,1280,830,1982
2291401425,485000,5,2,1910,5508,1,1020,890,1968
7454000110,202000,2,1,670,7844,1,670,0,1942
3377900195,2.525e+006,4,5.5,6930,45100,1,4310,2620,1950
3824100082,502000,3,2.75,2010,11200,1,1360,650,1979
3751604169,279000,2,2.75,1770,10534,1,1210,560,2003
6431500283,409500,3,1,1340,4120,1,1040,300,1921
6647400090,453000,3,2,1660,15050,1,1260,400,1983
7387500195,367000,4,1,1820,5500,1.5,1820,0,1947
3342101785,550000,3,2.5,2510,5400,2,2510,0,1992
9320600090,273500,3,1.5,1560,8314,1,1560,0,1962
8901001185,505000,4,3,2280,7400,1,1340,940,1978
0825069097,770000,3,2.5,2650,40705,2,2650,0,1994
7745000090,565000,4,2.25,2470,7447,2,2470,0,1984
1771110090,316000,3,0.75,1270,10092,1,1270,0,1971
7888100090,160000,4,1,1520,7298,1.5,1520,0,1960
5083000375,170000,3,1,1310,9529,1,1310,0,1956
5083000375,235000,3,1,1310,9529,1,1310,0,1956
1329000090,1.799e+006,4,3.5,3930,39098,2,3930,0,1999
8143000600,310000,3,1,990,7050,1,990,0,1967
2144800215,285000,4,1.75,2080,13629,1,1040,1040,1955
9268200658,280000,2,1,960,4920,1,960,0,1942
5452301785,2.298e+006,4,4.25,4070,13860,2,4070,0,2004
1137500090,763776,4,2.5,2750,16139,2,2750,0,1989
6117500025,530000,5,2.75,3230,13572,1,1880,1350,1965
2326079039,362000,1,1,890,211576,1.5,890,0,1996
7595700025,430000,2,1,990,4920,1,990,0,1931
4443800110,456500,3,1,1290,3880,1.5,1290,0,1919
5101405265,445000,4,2.5,2170,5257,2,2170,0,1989
9206200110,386900,3,1,1330,10500,1,960,370,1963
2205700405,479000,3,1,1340,13750,1,1340,0,1955
7852020300,525000,3,2.5,2200,4544,2,2200,0,2000
5559200051,272000,4,1.75,2520,10890,1,1260,1260,1979
2826049165,517000,4,1,1180,13500,1.5,1180,0,1950
2675600028,615000,3,1.75,2660,7800,1,1330,1330,1951
0259801110,439000,3,1.75,1250,7030,1,1250,0,1965
1150001270,716000,3,2.5,2270,7866,1,2270,0,1988
7130300690,308000,2,1,1080,6250,1,1080,0,1942
2652500015,800000,3,2.25,1620,4500,2,1620,0,1926
3693901801,575000,3,2,940,5000,1,880,60,1941
8092501240,219950,3,1.5,1620,9310,1,1620,0,1967
9552701030,770000,4,2.5,2350,8001,2,2350,0,1987
9477101280,424950,3,1.75,2090,7505,1,2090,0,1967
7462900015,387000,3,2.25,1760,45133,2,1760,0,1984
6744700302,790000,4,1.75,2050,10920,1,1450,600,1974
3163600015,156000,2,1,600,4000,1,600,0,1933
6896300375,580000,2,1,2540,7000,1,1320,1220,1942
7419700015,490000,4,2.25,2090,10869,2,2090,0,1970
4473400195,950000,5,3.25,2700,3650,2,2070,630,1926
9358001566,400000,2,2.5,1410,1281,2,1090,320,2008
6145600900,325000,2,2.5,1170,1638,2,1170,0,2008
1865000110,365000,4,2.5,2540,6688,2,2540,0,2002
8698100115,255000,3,1.75,2190,6000,1.5,2190,0,1920
1454600038,985000,5,3.5,3890,13261,2,2870,1020,1984
5652601425,595000,4,2.5,2030,10722,1,1100,930,1967
6381500690,427500,3,1,1350,7085,1,1350,0,1944
1778500015,728000,3,1.5,1940,4000,1.5,1310,630,1915
6021500245,549950,2,1,1260,4000,1,1000,260,1940
2926049382,650000,3,2,2800,10501,1,1400,1400,1954
1692900110,1.125e+006,5,3.25,3080,13394,1,2230,850,1968
8651401270,203000,3,1,840,6500,1,840,0,1969
3332500265,311000,2,1,860,3300,1,860,0,1903
4027700853,387500,6,2,2400,7684,1,1200,1200,1932
7301300215,370000,4,2,1640,7200,1,1640,0,1963
7663700792,228000,2,1,1060,6100,1,1060,0,1951
2919702235,740000,2,1.75,2080,4800,1,1080,1000,1923
5476200123,200000,4,2,2090,6630,1,1070,1020,1974
3797002585,660000,3,1,1240,3500,1,1240,0,1927
8864000735,275000,4,2,2030,8426,2,2030,0,1944
1193000115,708000,2,1,1120,5250,1,950,170,1938
7334501240,280000,3,2.5,1270,9675,2,1270,0,1993
7885801460,325000,4,2.5,2260,5702,2,2260,0,2002
1823099076,495000,3,2.5,1780,47480,2,1780,0,1995
8900000110,691000,2,2,1780,3810,1.5,980,800,1922
0251620110,2.288e+006,4,2.5,4080,18362,2,4080,0,1983
0221049191,329500,3,2.5,2120,22482,1,1360,760,1979
9264950940,348000,3,2.5,2060,7458,2,2060,0,1989
8820902540,425000,2,1,1670,6212,1,1670,0,1947
3438500625,210000,3,1,1080,21043,1,1080,0,1942
7452500315,285000,2,1,1210,4895,1,710,500,1951
8945200750,222000,3,1,990,8840,1,990,0,1966
2599001240,200000,4,2.5,1720,9600,1,1120,600,1961
5360200054,247500,3,2,1530,8749,1,1530,0,1995
0622069006,1.5e+006,4,5.5,6550,217374,1,5400,1150,2006
0084000245,190000,3,1.75,1100,9452,1,1100,0,1942
5605000590,975000,4,2.5,3020,4950,1.5,2020,1000,1921
6613000015,1.13e+006,4,3,3180,4649,2,2070,1110,1925
5151600195,283200,4,1.75,1830,12540,1,1130,700,1958
7308900490,650000,3,2.5,2540,8073,1,1880,660,1937
2222900082,449500,3,2,1770,6610,1,960,810,1954
3574801720,400000,3,1.75,1470,6682,1,1470,0,1987
1721801591,89950,1,1,570,4080,1,570,0,1942
2641800015,158800,3,1,960,8291,1,960,0,1950
7625703885,870000,4,3,2940,7108,2,2220,720,2011
3751600176,196000,3,1.5,1000,18568,1,1000,0,1989
5035300750,850000,3,1.75,2450,8603,1,1340,1110,1940
9510970300,775000,4,2.5,3310,5101,2,3310,0,2005
9286100300,483500,3,2.5,1670,4308,2,1670,0,2001
4047200850,387000,3,1.5,1620,21929,2,1620,0,1990
4019300195,900000,3,3,2990,30869,2,2990,0,1951
7891600590,336000,3,1.5,1240,5000,1,1240,0,1964
5249802424,415000,2,1,670,6000,1,670,0,1949
3918400017,380000,0,0,1470,979,3,1470,0,2006
9209900315,350000,3,1.5,1320,4400,1,1320,0,1909
7237500590,1.32e+006,4,5.25,6110,10369,2,6110,0,2005
3271800850,765000,3,1.75,2440,5800,1,1320,1120,1945
1023059511,527000,4,2.5,2900,6736,2,2900,0,2013
4109600195,524000,4,2.75,2310,5000,1.5,1480,830,1908
5100401468,448000,2,1,1110,5413,1,890,220,1937
1926069137,775000,4,3.25,4100,241322,2,2500,1600,1981
3828000405,176500,3,1,930,9900,1.5,930,0,1910
7773800015,750000,4,2.25,2420,11120,1,1620,800,1952
1084000107,1.265e+006,4,2.25,2870,6000,1,1730,1140,1951
7832800015,250000,3,1,1480,6750,1,1480,0,1958
9829200590,759000,3,2.75,1960,6390,1.5,1960,0,1900
8127700820,640000,3,2,1470,4640,1.5,1470,0,1926
9547202265,990000,3,3.25,2460,4182,2,2100,360,1910
7663700261,395000,4,1.75,1960,7945,1,980,980,1946
1445200110,275000,2,1.5,1160,1103,2,890,270,2006
1023059313,390000,3,2.5,1910,4755,2,1910,0,1997
0170000215,752500,5,2.75,2720,4680,1.5,1710,1010,1913
7550801220,450000,2,1,1020,5000,1.5,1020,0,1906
7518501390,473000,2,1,900,5100,1,900,0,1909
9407102460,178500,3,1.75,1120,10450,1,1120,0,1973
8567300110,485000,3,2.5,2340,59058,1,2340,0,1985
5029450110,215000,3,1.5,1410,8415,1,780,630,1982
7915100490,589000,4,1.75,1920,4862,1,1060,860,1919
0114101500,325000,4,1.75,1370,9993,1,1370,0,1918
9274201807,580000,3,2.5,1590,1937,2.5,1590,0,2004
7893206095,181100,4,1.75,1850,7500,1,1850,0,1954
2770602265,345000,3,2,1430,4200,1,830,600,1908
5418200245,781000,3,1.75,1940,8729,1,1460,480,1960
7228502150,402500,4,1,1270,3630,1.5,1270,0,1903
7972601030,426000,3,1.5,1380,7200,1,1080,300,1948
7853270940,389000,3,2.5,1720,4515,2,1720,0,2005
5561401220,670000,6,3,4050,36171,2,2620,1430,1970
1336800015,1.506e+006,4,3.25,3660,5800,2.5,3360,300,1909
8944750850,288400,3,2.25,1870,3230,2,1870,0,1997
3362400590,700000,4,2,2230,4635,1.5,1510,720,1908
6821100195,830000,4,3,2020,6000,1,1220,800,1968
1827200265,1.899e+006,2,2.75,3690,32044,2,3690,0,1989
5100401429,350500,2,1,1450,6380,1,1450,0,1967
6116500028,431000,3,1.75,1630,9000,1,1630,0,1956
2759800110,485000,3,2.5,1840,8250,1,1340,500,1958
0579000096,780000,3,1.5,1620,7500,1,1620,0,1949
9169600096,720000,2,1.5,1840,9000,1,1340,500,1957
1226059112,415000,3,1,1360,73616,1,1360,0,1971
6021503830,480000,4,1,2080,5500,1,1040,1040,1941
3824100291,452250,4,2.25,2550,10000,1,1560,990,1979
9264921030,316000,3,2.5,2550,8170,2,2550,0,1985
8073000495,700000,2,1,1160,17635,1,1160,0,1945
7129304105,285000,4,2,1760,5500,1,780,980,1925
0525049085,575000,3,1.75,1720,4050,1,860,860,1906
6117500785,590000,3,2.25,2300,12430,1,1580,720,1960
6115400008,587500,4,1.75,2500,20868,1,1600,900,1956
4024101545,364000,4,2.25,1750,10270,1.5,1750,0,1968
8651511220,490000,3,2.5,1890,10190,2,1890,0,1986
5561301280,410000,3,2.25,1800,36704,1,1360,440,1978
3629800100,520000,3,2.5,2160,4297,2,2160,0,1999
6141100750,389000,3,1,1380,6591,1,1380,0,1947
2770605065,450000,2,1,1180,6000,1,1180,0,1910
2517100490,325000,3,2.5,2550,4240,2,2550,0,2006
4083801785,660000,2,1,1070,5000,1,1070,0,1924
4318200405,850000,3,2.25,2870,8170,2,2250,620,1995
2329810590,285000,3,2.5,1940,9874,2,1940,0,1990
2768301214,395000,2,1,870,3121,1,870,0,1923
1931301105,440000,3,2,1550,2401,2,1550,0,1996
3343903640,249000,3,1.75,1400,5648,1.5,1400,0,1917
8813400245,635000,3,1.75,1210,4400,1.5,1210,0,1930
3521049048,515000,3,2.5,3430,48993,2,3430,0,2001
1118001645,1.4e+006,3,3.25,3020,6073,2,3020,0,1954
2968801105,200000,2,1,950,8100,1,950,0,1955
3524039209,1.135e+006,4,2.75,3370,8103,1,1970,1400,1970
0952003480,445000,4,1,1460,4600,1,780,680,1946
2877102670,555000,3,1.5,1740,4200,1.5,1640,100,1920
5014000100,537000,4,2,1720,6413,1,860,860,1950
7399301050,315000,3,1.75,1480,7500,1,1480,0,1968
6979940100,805000,5,2.5,3320,7266,2,3320,0,2000
8731982840,414000,4,2.5,3490,9030,1.5,3490,0,1969
6909200037,375000,2,1.5,1160,1648,2,1160,0,2002
1160000115,401000,4,1.75,3010,12523,1,1780,1230,1952
7893207665,210000,3,1,1030,4583,1,1030,0,1967
8024201270,365000,2,1,980,5110,1,780,200,1939
0003800008,178000,5,1.5,1990,18200,1,1990,0,1960
6788200931,710000,2,1,1790,4000,1,1040,750,1923
0723049596,255000,2,1,810,7980,1,810,0,1928
7214711270,528000,5,2.25,2940,38009,1,1700,1240,1977
4136980090,537000,4,4.25,4883,26040,2,3859,1024,2006
9278200131,442000,4,1.5,1360,6110,1,1010,350,1955
4046600750,375000,3,1.75,1370,19550,1,1370,0,1978
9510970090,637250,4,2.5,2120,3220,2,2120,0,2005
2594200375,427500,3,1.75,1240,7200,1,1240,0,1942
1125069064,700000,4,2.5,2770,89298,2,2770,0,2004
0117000100,680000,3,1.75,1660,5750,1,1080,580,1909
9212900820,393820,2,2,1170,8251,1,1170,0,1941
3959400855,525000,4,2.75,2470,7200,1,1350,1120,1940
2028700265,505000,2,1.75,1310,3816,1,1110,200,1929
3041700090,555565,3,2,1670,11337,1,1670,0,1959
0868001295,650000,3,1.75,1660,10819,1,1240,420,1942
7853270740,632500,5,3.25,3500,7254,2,2760,740,2005
5416500090,269000,3,2.5,1440,3800,2,1440,0,2005
3574801110,405000,4,2.75,2360,7716,1,1390,970,1978
0624110930,845000,3,3.5,3460,15745,2,3460,0,1986
5335700110,234000,3,1,1750,8820,1,1750,0,1961
1176000964,638000,4,1.75,1470,4236,1.5,1470,0,1946
7334602070,290000,3,1.75,1710,10950,1,1060,650,1967
2420069251,262000,1,0.75,520,12981,1,520,0,1920
7885800740,270000,4,2.5,2350,5835,2,2350,0,2003
8082400076,875000,4,2.25,2380,4876,2,2240,140,1948
1310980110,299000,3,2.25,1920,7840,2,1920,0,1982
2354300740,551000,3,1,1580,6000,1,1580,0,1947
3023049236,350000,3,2.75,3070,5280,2,2360,710,1950
9808700405,1.901e+006,3,2.5,2660,13367,2,2660,0,1992
2877102345,511718,2,1.75,1700,5000,1,850,850,1915
1924069058,965000,4,3.25,5010,49222,2,3710,1300,1978
9269260100,475000,4,2.25,2680,4673,2,2680,0,1999
2877104265,1.062e+006,4,2.75,2720,4000,1.5,1840,880,1928
3123039089,252000,2,1,940,15450,1,940,0,1926
8576400110,580000,6,2.5,3596,13700,1,1798,1798,1964
7660600131,374950,2,2.25,1240,1172,2,1000,240,2008
2296500131,739000,5,4,4660,9900,2,2600,2060,1979
1761300850,271000,4,1.75,1710,7200,1,910,800,1975
6083000037,230000,2,1,930,7550,1,930,0,1986
5259800090,210000,3,2.25,1430,9150,1,1070,360,1984
2968801366,350000,3,2.75,1650,5700,2,1650,0,1988
2126059172,491500,3,2.25,1560,12000,1,1110,450,1968
7334501250,325000,3,2.5,1870,9825,1,1250,620,1994
1545805490,190000,3,2,1320,7625,1,1320,0,1987
7518500855,658600,4,2,1400,4690,1.5,1400,0,1945
4171200025,299950,3,1.5,1940,8951,1,1300,640,1958
9818700215,464000,5,2,2000,3000,1.5,1200,800,1931
0798000535,308000,3,1,1640,18144,1.5,1640,0,1942
3900100265,625000,3,1,1020,7650,1,1020,0,1919
1951100110,240000,3,1.75,1630,9450,1,1080,550,1977
7215420590,530000,4,2.5,2940,35996,2,2940,0,1995
3343301910,1e+006,5,4.5,2120,8944,2,2120,0,1939
9828702095,439000,1,1,790,2400,1,790,0,1918
2917200645,575000,4,1.75,2020,6200,1,1010,1010,1948
6163900501,418000,3,1.75,1530,7238,1,1530,0,1959
0540100057,1.208e+006,4,3.75,3250,10949,2,2940,310,1930
2652500300,1.1e+006,4,3.75,2930,3200,1.5,2130,800,1925
1330300300,1.9e+006,3,3.75,3150,8550,2,3150,0,2007
1137301780,580000,3,2.5,2180,40278,2,2180,0,1985
9842300485,380000,2,1,1040,7372,1,840,200,1939
7224000315,256000,3,1,880,5375,1,880,0,1924
6161000015,349950,3,1,1400,7066,1,1400,0,1957
5207200195,691500,4,2.5,2600,7200,2,2600,0,1962
9191201790,556000,3,1.75,1590,2500,1.5,1190,400,1908
8731902680,218000,3,2.25,1610,7084,1,1280,330,1968
9448300115,425000,4,2,1390,4500,1.5,1390,0,1908
4045500625,935000,3,3.25,3710,38509,2,3710,0,1998
5603700025,732000,4,1.75,2360,11300,1,2360,0,1974
1266200015,805500,3,1,1440,10330,1,1440,0,1952
0952003350,507250,3,1.75,1400,5750,1,1100,300,1915
2386000300,800000,4,2.5,4600,67369,2,4600,0,1990
3625059143,600000,3,2.25,2100,8276,2,2100,0,1979
8651500850,627800,4,1.75,2010,12044,1,2010,0,1982
3359500110,660000,2,2.25,2550,6000,2,1860,690,1902
0818500490,153503,2,2.5,1240,3649,2,1240,0,1986
3876311390,456500,3,2.25,2090,9163,1,1460,630,1975
8085400490,1.306e+006,5,2.5,2770,8100,2,2770,0,2002
2355010090,843500,3,2.5,3560,11448,2,3560,0,1997
9550200265,625000,3,1,1240,4080,1,1240,0,1925
8818400490,527000,2,1.75,1640,4080,1,840,800,1921
8964800025,1.965e+006,5,3.75,3940,13738,1.5,3940,0,1951
2125059112,1.003e+006,5,2.5,3150,50094,2,3150,0,1969
2028700535,855000,4,3,2550,5300,2,1720,830,1908
4309710100,725000,4,3.25,3940,27591,2,3440,500,2000
4364700805,315000,1,1,580,7200,1,580,0,2000
3356407665,180000,3,1.75,1330,16000,1,1330,0,1978
9238900855,700000,2,1,930,5000,1,930,0,1926
1086100100,476500,3,1,1060,8625,2,1060,0,1962
6121000110,193000,3,1.5,1180,9048,1,1180,0,1960
8700100100,295000,4,2.5,1850,6663,2,1850,0,1990
9417400215,363000,2,1,820,4880,1,820,0,1925
7701961030,875000,4,2.5,3600,21794,2,3600,0,1990
2149800148,257200,3,2,1850,8250,1,1150,700,1952
0686450490,555000,3,2,2240,11250,1,2240,0,1968
9413400165,380000,3,2.25,1860,15559,2,1860,0,1963
0104550690,282000,4,2.75,2390,7330,2,2390,0,1989
1995200245,545000,4,2.5,2040,6034,2,2040,0,1990
7409700215,550000,3,1.5,1900,5000,1.5,1640,260,1926
7409700215,921500,3,1.5,1900,5000,1.5,1640,260,1926
1337800855,885000,3,1.5,2200,2880,2,1440,760,1904
7015200615,820000,4,2.25,2280,6660,1.5,1960,320,1940
8805400090,289000,3,1,1090,7315,1,1090,0,1981
2391602350,334000,1,1,670,5750,1,670,0,1942
0844001140,206000,3,1,1050,5233,1,1050,0,1906
5210200131,491950,3,2.25,2090,10733,1,1440,650,1958
6893300110,430000,3,2.5,2030,7770,2,2030,0,2003
1796351080,208000,3,2,1250,7995,1,1250,0,1980
1938400300,245000,4,2.25,2600,6390,1,1390,1210,1978
2877101340,426000,2,1,640,2500,1,640,0,1918
6084200100,400000,3,2.5,2120,3742,2,2120,0,2006
7977201910,553000,3,1,1330,5100,1,900,430,1942
6638900115,296000,2,1,750,4680,1,750,0,1948
2587920110,428000,3,2.5,2230,32660,1,2230,0,1977
3438500714,325000,4,2.5,1890,6156,1,980,910,1980
0726049184,294000,2,1,820,6366,1,820,0,1952
2787720300,410000,3,1.75,1880,8424,1,1380,500,1977
2821049048,590000,4,4.25,2360,57514,2,2360,0,1939
3904901450,445000,3,2.25,1850,4050,2,1850,0,1985
9829200495,921000,4,2.5,2310,5362,2,2010,300,1928
1523089097,496000,3,1.5,2520,37616,1,2520,0,1955
2724200705,95000,2,1,800,8550,1,800,0,1947
8122600245,359000,4,1.75,1580,6396,1,790,790,1945
1323089184,452500,3,2.5,2430,88426,1,1570,860,1985
2600300110,555000,4,1.75,2350,6200,1.5,1410,940,1946
9485951030,549900,5,3,3800,42316,1.5,3800,0,1984
4021700025,569000,5,3,3670,10583,1,2060,1610,1952
2473250850,318500,4,2,1780,7350,1,900,880,1974
9828702310,487028,2,1.5,1295,1093,2,1105,190,2007
7523700245,240000,3,1,1350,7560,1,950,400,1959
1765100025,253000,3,2.25,1440,9806,1,1440,0,1965
2011400405,380000,5,1.75,1320,38125,1,1120,200,1947
3410600015,250000,2,0.75,700,16828,1,700,0,1958
3276050110,368500,2,1.75,2510,19141,2,2510,0,1977
7792000025,340000,3,1,3180,27586,1,1400,1780,1969
2810600015,400000,2,1,910,4000,1,910,0,1918
8081900011,835000,3,2,1570,4625,1.5,1570,0,1927
0104550740,299000,3,2.5,2450,7062,2,2450,0,1993
1959701745,1.675e+006,6,2.25,4910,6600,2.5,3580,1330,1910
8078520090,265000,3,2,1570,5706,1,1570,0,1998
6403510090,437500,4,2.5,2680,7513,2,2680,0,1998
2326300090,865000,3,1.75,2090,4725,2,1610,480,1947
8078380090,626000,3,2,2150,7200,1,2150,0,1988
7132300042,247300,2,2,1140,1118,2,1040,100,2009
3861470110,2.075e+006,4,3.5,4230,20377,2,4230,0,1997
2734101055,425000,3,1,1790,6000,1.5,1790,0,1937
4039701080,905000,5,3.5,3100,10200,1,1660,1440,1970
0464000600,641250,3,2.5,2220,2550,3,2220,0,1990
5437400100,675000,4,2.5,2370,9679,2,2370,0,1984
1423089055,845000,4,2.75,4070,115434,2,4070,0,2002
6713700100,401500,4,1,1790,8400,1,1260,530,1954
0339600110,395000,3,2.5,1610,3755,2,1610,0,1987
5021900090,1.1e+006,5,2.75,2830,18050,1,1630,1200,1958
6099400053,145000,3,1,1010,5490,1,1010,0,1954
7518508625,900000,3,1,1560,3825,1.5,1390,170,1930
8143000490,374500,3,1.5,1330,8636,1,1330,0,1968
3260000300,850000,4,2.25,2330,10451,2,2330,0,1965
5742600090,490000,3,1,960,5750,1,960,0,1951
7212650850,304000,3,2.5,1710,6773,2,1710,0,1993
9158800090,400000,4,2.25,2230,7200,1,1300,930,1963
7820000038,454000,3,2,1700,10000,2,1700,0,1992
7135300026,160000,2,2,1040,4750,1,850,190,1950
8562700300,542000,3,1.75,1070,8030,1,1070,0,1966
6114400028,403500,5,2.5,3600,17300,1,2410,1190,1968
3793501130,418000,4,2.5,2750,8471,2,2750,0,2003
6052400625,406000,4,1.5,1920,6000,2,1920,0,1951
2560805630,242500,3,2.25,1770,10000,1,1340,430,1978
9558020600,425000,4,2.5,2460,5440,2,2460,0,2003
9136101335,613000,4,2,1550,4815,1.5,1550,0,1909
9407101380,189000,3,2,1460,11481,1,1170,290,1995
8901500178,700000,4,2.25,2440,9450,1.5,2440,0,1947
9551201250,750000,3,1,1640,6516,1.5,1440,200,1935
3544400236,494000,2,1,1290,4650,1,1290,0,1906
7215730090,700000,4,3,3150,7778,2,3150,0,2000
8682291390,705000,2,2.5,2305,5580,1,2305,0,2007
1770000490,356000,2,1.75,1060,16470,1,1060,0,1977
2935400100,625000,3,1.75,2060,12558,1,1350,710,1984
7686205020,144975,2,1,900,7500,1,900,0,1940
3629921240,970000,4,4.5,3890,5906,2,3060,830,2004
1775801340,415000,3,1.75,1910,12596,1,1340,570,1977
3574801780,485000,4,3,2340,7048,1,1340,1000,1979
7854800090,799950,3,3,2900,11769,2,2900,0,1997
4054530090,783350,4,2.5,3290,35001,2,3290,0,1991
8807900236,430000,1,1,630,1362,1,630,0,1943
1118001408,2.54475e+006,5,4.75,5410,13431,2,5050,360,1941
9290850740,975000,4,2.5,4270,43386,1,2680,1590,1991
3025059089,950000,3,1.5,1700,8050,1,1130,570,1950
0923000265,350000,2,1,1430,8157,1.5,1150,280,1944
8901001335,637000,4,2.75,2850,7510,2,2850,0,2008
1523059066,895000,3,2,2160,105415,1,2160,0,1991
5249801785,579000,2,2,1760,7200,1,880,880,1946
2190601055,314900,4,1.75,2700,27072,1,1380,1320,1958
1917300025,122000,2,1,860,6000,1,860,0,1945
3797000300,405000,2,1,880,3000,1,880,0,1927
5332200026,553650,2,2.5,1360,1349,2,1050,310,1997
3278602760,369900,2,2.5,1770,1853,3,1770,0,2007
2721049059,225000,3,2,2030,24829,1,1220,810,1979
2172000750,160000,2,1,1180,9350,1,1180,0,1918
1022069058,449500,4,2,2430,199940,1,1310,1120,1961
0249000115,650000,3,1,1300,8266,1,1300,0,1953
7214710300,542126,4,2.5,2360,43088,2,2360,0,1977
0192450300,309950,3,1.5,1200,15606,1,1200,0,1985
3356403820,115000,2,1,1000,16524,1,1000,0,1913
8075400100,221700,2,1.5,1556,20000,1,1556,0,1957
1982200245,726000,3,2.5,1890,3880,1.5,1460,430,1915
7905200037,515000,3,1.75,1810,5733,1,1010,800,1926
2597531030,756000,4,2.5,2730,10753,2,2730,0,1991
5318100645,1.57e+006,4,3.75,3070,5850,2,2400,670,1927
7504400850,442000,4,2.25,2080,12007,1,1220,860,1979
1761300110,260000,4,2,1620,7992,2,1620,0,1975
9390700100,390000,2,1.75,1150,2723,1,770,380,1923
7518503200,459500,2,1,1250,3825,1,850,400,1929
3971700940,330000,3,1.5,1430,8000,1,1430,0,1948
1446403835,189000,2,1,790,7128,1,790,0,1944
9183702251,280000,3,1,1200,9322,1.5,1200,0,1954
5589900590,400000,2,1.75,2110,9519,1,2110,0,1948
7227501745,368000,4,2,3160,11193,1,2410,750,1942
2473350930,390000,4,1.75,2700,7875,1.5,2700,0,1968
6450303820,245000,2,1,820,7475,1,820,0,1945
5469000100,375000,4,2.5,1800,8432,1,1200,600,1960
8679600100,465000,5,1.5,1750,12491,1,1390,360,1961
0638100015,445000,3,2,1540,67953,1,1540,0,1997
3241600015,250000,3,1,1130,7800,1,1130,0,1952
6411600026,475500,3,1,1500,9416,1,1500,0,1952
3179101050,672324,2,1.75,1600,5795,1.5,1600,0,1940
5363200266,420000,3,2,1200,5029,1,880,320,1937
7518502490,515000,3,2,1690,5100,1.5,1690,0,1907
7732400490,732350,4,2.5,2270,7665,2,2270,0,1986
5416510110,297500,4,2.5,1910,5000,2,1910,0,2005
8604900017,475000,3,1.5,1640,2720,1.5,1640,0,1929
0808300490,414000,4,2.5,2120,6497,2,2120,0,2003
6855700115,357250,3,1.5,1400,8840,1,1400,0,1952
9325800110,289950,2,1,760,6000,1,760,0,1950
8121100015,550000,3,1,1070,3713,1,1070,0,1917
8568700015,446000,3,1.75,1460,9998,1,960,500,1958
6399600115,279000,3,1.5,1280,16738,1.5,1280,0,1932
5651010300,370000,3,2.25,1650,4859,2,1650,0,1988
3423049311,216000,3,2,1260,4125,1,1260,0,1998
7000100711,1.1e+006,3,2.5,2200,20000,1,1400,800,1952
5482700115,1.2806e+006,4,2.5,3560,15450,1,2060,1500,1977
9349900110,355000,2,1.5,1140,2500,1,630,510,1988
9328510100,699000,4,2.5,2550,7312,2,2550,0,1988
6300500475,412000,3,2.5,1553,1991,3,1553,0,2014
7849200315,276000,2,1,1140,7200,1,1140,0,1923
7813200115,100000,2,1,790,6426,1,790,0,1944
2851200100,955500,4,1.75,2130,5080,1.5,2130,0,1914
2823059055,199000,3,1,1390,21262,1,1390,0,1958
7853301560,762000,4,3.5,4000,15253,2,4000,0,2007
9477001280,425000,4,2,1520,7983,1,1520,0,1967
7905200147,546000,2,1,1657,5031,2,1657,0,1910
6190701110,419600,3,1.75,1680,8460,1,1180,500,1976
0871001500,735000,4,2.25,2270,5102,1,1340,930,1954
2559950110,1.23457e+006,2,2.5,2470,609,3,1910,560,2011
3693900245,445000,2,2,1240,2500,2,1240,0,1985
1023089140,665000,3,2,1740,41275,1,1740,0,1974
3026059085,1.29e+006,5,3.5,4090,290980,1,2920,1170,2002
3575302345,508500,4,2.75,2520,12500,2,1720,800,1979
1568100076,345950,5,1,1340,11198,1.5,1340,0,1934
6600400090,207500,3,1,1640,9750,1,1640,0,1968
5451200110,1.075e+006,4,2.5,3000,10920,1,1550,1450,1969
3204300090,640000,3,1,1210,3720,2,1210,0,1930
3023039066,329500,3,1,1810,13068,1,1360,450,1941
3824100246,460000,4,2.75,2200,9676,1,1500,700,1979
7768700315,1.23e+006,3,1.75,2200,14630,1.5,2200,0,1948
4154305290,805000,5,3,2350,6480,2,1650,700,1924
0621069113,200000,3,1.5,1090,10454,1,1090,0,1963
1523059201,749700,3,1.75,2280,77972,1,1460,820,1977
1453602309,288000,0,1.5,1430,1650,3,1430,0,1999
7518504291,535000,2,1,1520,3360,1,830,690,1927
4058801240,330000,3,2.25,1620,7150,1,1280,340,1950
2313900165,479200,3,2,1510,3750,1.5,1510,0,1928
2122059206,373000,5,2.5,3001,5710,2,3001,0,2006
9282801720,355000,4,1.5,2020,6000,1,1010,1010,1953
9542840590,275000,3,2,1380,4500,1,1380,0,2008
2493200015,380000,3,1.5,1520,4288,1,1020,500,1949
9550202870,417000,2,1.75,1090,4590,1,790,300,1915
0098000750,1.165e+006,5,3.75,4220,15959,2,4220,0,2004
7504010900,598500,3,2.25,2520,12000,1,2520,0,1978
1370803820,629000,3,2,1760,5000,1,960,800,1920
1446401220,226950,2,1,930,6600,1,930,0,1957
0868000615,1.225e+006,4,2.5,2600,11542,1.5,2200,400,1939
6625910100,415000,3,2.25,2180,11100,1,1700,480,1979
3629870110,595000,3,2.5,1910,3075,2,1910,0,2001
8651400750,209950,3,1.75,1100,5525,1,1100,0,1968
0925069111,568000,3,1.75,1760,235224,1,1760,0,1973
3352402250,119900,2,1,700,3180,1,480,220,1951
4168000110,207000,3,1,1080,10200,1,1080,0,1962
5647900930,195000,3,1,1070,22489,1,1070,0,1967
2523039278,324950,3,1.5,1460,8710,1,1460,0,1955
6149700405,210000,1,1,1050,7583,1,1050,0,1947
0203100690,1.078e+006,4,2.75,3160,42733,2,3160,0,1995
4410600100,325088,4,1,1400,6739,1,1000,400,1954
3223059303,790000,4,3,3120,157875,2,3120,0,1977
0522069097,150000,2,1,720,212137,1,720,0,1982
2023069059,790000,3,3,2840,206910,2,2840,0,1999
7987400356,255000,2,1,1220,2500,1,770,450,1910
0461005360,697000,4,3,2820,2850,1.5,1860,960,1928
0461004195,457500,2,1,840,5000,1,840,0,1908
9547204350,690000,3,2,1610,5100,1.5,1610,0,1940
2331300025,967000,4,3.25,1860,4356,2,1860,0,1917
2288000090,980000,4,1.75,2260,17711,1,2260,0,1968
5525400300,619420,4,2.75,2450,14803,2,2450,0,1988
9523103001,389000,2,1,850,3276,1,850,0,1910
5249802460,500000,3,1,1800,7200,1,1020,780,1964
7000100850,569000,4,1.75,1230,7890,1,1090,140,1950
9477000300,425000,4,2.25,2060,8540,1,1540,520,1967
8121100265,635000,4,2.25,2750,6180,1,1500,1250,1948
2817100900,256500,2,1,1120,9912,1,1120,0,1980
3578700017,695000,4,2.5,3010,11393,2,3010,0,2005
7550800195,535000,4,1.5,1580,5000,1.5,1390,190,1945
3449900090,454200,4,2.5,2630,5379,2,2630,0,2004
9232900165,418500,2,1,790,5800,1,790,0,1943
1137300900,749950,4,2.75,3110,35235,2,3110,0,1983
2617370090,338500,3,1.75,2130,5489,1,1370,760,1999
5452301800,1.25e+006,4,3.75,4520,9240,1.5,3270,1250,1992
6648760100,299950,3,2.5,1600,9830,2,1600,0,1993
0798000337,325000,4,1.75,1950,12500,1,1330,620,1963
1737300110,434000,4,3,2010,8171,2,2010,0,1973
2817800100,328950,4,1.75,2550,8976,1,1300,1250,1978
5700003640,2.095e+006,5,3.75,5340,10655,2.5,3740,1600,1912
0824069156,570000,4,2,2000,46902,2,2000,0,1978
1997200165,802000,3,2.25,2170,5001,2,2170,0,2014
4083301645,525000,3,1,1550,6840,1.5,1550,0,1918
3880900245,700000,6,3,2790,4550,2.5,2790,0,1907
1322059002,350000,3,1.75,1980,273556,1,1040,940,1956
2426039313,277500,2,1.5,1190,1236,3,1190,0,2005
6448000090,1.575e+006,5,2.75,3650,20150,1,2360,1290,1975
8005100025,195000,3,1,1510,4350,1.5,1510,0,1913
2891000750,222000,3,2,1200,6074,1,1200,0,1968
5456000110,865000,5,3,2830,8854,1,1500,1330,1979
5393601050,445000,4,2,1650,6000,1,1000,650,1959
2979801095,495800,4,1.5,1710,4600,1.5,1710,0,1924
6840701095,548500,3,1,1740,4400,1.5,1740,0,1924
2221000100,310000,3,1.75,1840,10723,1,1220,620,1974
5070000100,205000,3,1.5,1820,8585,1,1820,0,1962
3793501450,470000,5,3.75,3860,6901,2,3860,0,2003
0321079066,430000,3,1.5,1810,349351,1.5,1810,0,2002
2026049125,310000,2,2,1030,2271,3,1030,0,1999
1844500025,355000,4,1,1410,7693,1.5,1410,0,1953
3541600405,621500,5,2.5,2140,15950,1,1370,770,1968
1823049202,175000,6,1.5,1930,8400,1,1030,900,1971
1823049202,326000,6,1.5,1930,8400,1,1030,900,1971
1563100705,690000,4,3.5,1930,5400,1.5,1930,0,1920
7968200090,335000,4,2.5,2210,7214,2,2210,0,2003
5379802816,197000,4,1,1360,11175,1,1360,0,1961
3340401570,312500,3,1.75,1830,7969,1,930,900,1950
7300700056,436000,3,2.25,2120,6710,1,1420,700,1959
1257201130,1.015e+006,4,2.5,2700,4590,2,2700,0,2002
7526400100,805000,4,2.5,3160,35225,2,2250,910,1992
7504400750,652427,4,2.25,2770,13129,2,2770,0,1979
1525059112,1.008e+006,3,2.5,2240,41339,1,2240,0,1945
7300410300,355000,4,2.5,2570,6466,2,2570,0,1999
1326039039,334550,2,1,880,12000,1,880,0,1939
8100400110,557500,3,2.25,1820,9670,2,1820,0,1984
6385900090,277500,4,2.25,1660,7184,1,1110,550,1963
7229000025,300000,4,3,2200,10800,1,2200,0,1960
6145602355,325000,4,1,1640,3844,1.5,1460,180,1928
0003600057,402500,4,2,1650,3504,1,760,890,1951
4040200490,461000,3,1.75,1420,5170,1,1420,0,1963
2919201095,540000,3,1,1270,3840,1.5,1270,0,1926
5248800625,385000,3,1,1070,4000,1,1070,0,1971
1257201295,480000,2,1,1060,3040,1,860,200,1924
3342700371,539950,3,2.25,2190,7149,1,1240,950,1963
1724079013,529000,3,2.25,1940,217800,2,1940,0,1990
2770606822,417000,3,2.5,1300,877,2,1060,240,2008
5706201930,405000,3,1.5,1330,12500,1,1330,0,1966
8731800300,299000,3,2.25,1940,9100,1,1630,310,1966
3751600457,299000,3,1.75,2100,15480,1,2100,0,1983
9169100214,372220,3,1,1290,5500,1,980,310,1951
0809000820,494400,2,1.75,1560,1750,1,780,780,1904
9460000110,280000,3,1.75,2630,6500,1,1330,1300,1958
7888780090,277950,3,2.5,2100,6021,2,2100,0,1992
2423059067,770000,3,2.75,2070,54557,2,2070,0,1996
1331900110,760000,4,2.5,2960,28005,2,2960,0,1989
6600490300,230000,2,2,1300,3608,1,1300,0,2004
6042000090,525000,4,2.5,2520,7731,2,2520,0,1994
7846700850,307000,3,1,1150,6000,1.5,1150,0,1927
5381600110,253779,4,2,2030,9600,1.5,1430,600,1947
3459100300,405000,3,1.5,1880,7400,1,1480,400,1968
8151600590,360000,2,1,2320,11250,2,2320,0,1942
7936000252,521000,2,1,1050,7500,1.5,1050,0,1910
2825059256,680000,4,2.5,3030,13068,2,3030,0,1978
1925069006,355000,1,0.75,530,33278,1,530,0,1950
1274500300,200000,3,1.5,1090,9600,1,1090,0,1968
7129304085,330000,3,2.25,2220,4060,1,1330,890,1993
0104540820,221000,3,2.25,1430,5999,2,1430,0,1987
9272200090,1.59889e+006,4,4.5,3780,6000,2,2770,1010,1910
1787600164,310000,2,1,1560,4920,1,780,780,1947
8127700215,862000,4,2.25,2220,4200,1.5,1310,910,1932
7348200115,200000,3,1.5,1140,8340,1,1140,0,1960
7752200100,630000,4,2.5,2540,11100,1,2540,0,1957
3904901570,432250,3,2.25,1440,6232,2,1440,0,1985
1238501116,478000,3,2.25,1570,9500,1,1070,500,1977
9392500100,249000,4,2.25,1860,9576,1,1400,460,1962
7857003465,495000,5,3,2440,4750,1,1450,990,2006
4038700930,630000,4,2.5,2100,8800,1,1240,860,1960
6979920090,550000,4,2.5,2150,27540,2,2150,0,1997
1515920090,350000,3,2.5,2440,18674,2,2440,0,1994
2473100090,270000,5,1.5,1930,7480,2,1930,0,1966
6402700100,488250,4,2,1830,9610,1,1830,0,1963
0104530490,248000,4,3.5,1850,6519,2,1130,720,1986
2487200940,889000,4,3.5,3210,5000,3,3210,0,2014
6132600315,375000,1,1,1090,5250,1,980,110,1927
6848200475,933000,3,1.5,1870,3300,2,1870,0,1906
2141310490,625000,3,2.25,1920,8412,1,1460,460,1977
7571200110,328000,2,1,700,4350,1,700,0,1943
5072300100,470000,4,2.25,3380,9900,1,1690,1690,1969
3342103148,502500,5,2.5,2430,6168,2,2430,0,2007
1770000090,484000,3,1.75,1950,17400,1,1210,740,1976
8658303585,252500,2,1,900,7500,1,900,0,1961
1115400090,610000,3,2.5,2060,8893,2,2060,0,1987
4400800061,419000,4,2,2180,10447,1,1280,900,1969
4137000590,322500,4,2.25,2140,9377,2,2140,0,1986
0809000945,563000,6,1,1730,2760,1.5,1250,480,1918
4397000100,464000,4,2.5,3140,12591,2,3140,0,1993
3426049031,870000,4,4.25,3010,4887,2,1940,1070,1951
4310702775,280000,2,1.5,800,1196,2,800,0,2003
8965450110,850000,3,2.5,3300,11570,2,3300,0,1994
2887700805,458950,2,1,1530,4370,1,1130,400,1946
1446401460,122000,2,1,760,5280,1,760,0,1946
0225039175,525000,5,3,2450,4591,2,2450,0,1994
1151100165,286300,2,1,1000,31838,1,1000,0,1962
4330600301,218450,2,1,840,7425,1,840,0,1952
2767602141,525000,3,1.5,1380,4290,1,1080,300,1955
2767602141,650000,3,1.5,1380,4290,1,1080,300,1955
2223089048,356000,4,2,2020,48693,1.5,2020,0,1949
3693900985,436500,2,1,1260,5000,1,1040,220,1951
3574801790,410000,3,1.75,1440,7112,1,1180,260,1979
2568800121,512500,4,1.75,1540,8311,1,1540,0,1950
5249804560,510000,4,1,1060,7200,1,880,180,1925
7811100100,566000,4,1.75,1900,10297,1,1900,0,1966
6116500300,525000,3,1.75,2870,26500,1.5,2870,0,1948
2489200165,435000,3,1,1050,5500,1,930,120,1920
0425079100,406500,3,2.75,1840,68479,1,1340,500,1989
1828001220,550000,5,2.75,3000,9473,1,1500,1500,1966
5602000025,251000,3,2,1200,10212,1.5,1200,0,1949
0191101015,830000,3,1.5,1840,10125,1,1220,620,1959
4249000100,803000,4,2.5,2790,7673,2,2790,0,1989
7877400266,206000,3,1,970,9360,1,970,0,1942
7657000165,200000,4,1,1070,7467,1.5,1070,0,1944
4302200535,219000,2,1,900,5160,1,900,0,1952
0369000881,777000,4,4,2680,6000,1,1380,1300,1962
7527200110,593700,3,2.5,2000,22000,2,2000,0,1979
1561600025,712500,3,1.5,1660,8797,1,1660,0,1956
2813100100,600000,4,1.5,1770,6014,1.5,1240,530,1946
3179100755,554663,3,2,1230,6802,1.5,1230,0,1940
1422700110,267000,3,1,1740,10875,1,1020,720,1962
1075100090,390000,3,2,1710,8910,1,1710,0,1953
7338402690,335000,6,2,2020,7071,1,1010,1010,1979
5451210100,938000,4,2.5,2410,9886,1,1990,420,1975
7523900300,370000,4,2.75,2310,14745,1,1410,900,1993
7237300090,335000,5,2.5,2400,4548,2,2400,0,2003
4083303815,695000,5,2,3160,3990,1.5,1870,1290,1923
6117501015,387500,3,1,1560,14333,1,1560,0,1953
6700390100,245000,3,2.5,1770,6187,2,1770,0,1992
7334401450,308550,3,2,1600,13200,1,1600,0,1990
8588000315,225000,3,1.75,1330,13102,1,1330,0,1968
3121500100,715000,4,2.5,2970,29163,2,2970,0,1993
0726049202,335000,3,1,1020,10200,1,1020,0,1954
3629760110,634000,3,2.5,2490,4904,2,2490,0,2003
8692800025,337500,5,2,1700,7314,1,1000,700,1956
4392200165,440000,1,1,850,6567,1,850,0,1940
1023089228,350000,3,1.75,1250,13775,1,1250,0,1990
7625702615,400000,2,1,610,4560,1,610,0,1918
8081030090,1.288e+006,4,3.5,3700,13175,2,3700,0,1989
2201500490,435000,3,1,950,10080,1,950,0,1954
7853250090,681000,4,2.5,3860,5130,2,2930,930,2004
7133300044,397000,3,3.5,1360,1275,2,1240,120,2007
0293700110,775000,4,2.5,3890,34513,2,3890,0,1996
4038100110,480000,3,2.25,1680,9090,1,1130,550,1959
7697870600,158000,3,2.5,1520,7200,2,1520,0,1985
8847400115,590000,3,2,2420,208652,1.5,2420,0,2005
7853240100,772500,5,2.75,3890,9130,2,3890,0,2004
0326049058,464500,5,1.5,2940,13425,1,1470,1470,1955
8732800090,281000,3,1.75,1350,8737,1,1350,0,1966
2526059086,620000,3,2.25,2190,45738,1,2190,0,1990
2391600165,475000,3,2.25,2280,5750,1,1150,1130,1985
7225000090,245000,2,2,1070,4500,1,910,160,1932
1868901295,660000,5,2.25,2540,3750,1.5,1510,1030,1925
6072100490,527500,4,2.25,2270,8480,1,1310,960,1973
2522069064,135000,2,1,1220,7250,1,1220,0,1914
0806800090,275000,3,1.75,1890,5000,1,1890,0,2003
7228500375,430000,4,2,1990,4740,1,1080,910,1926
2891100820,213500,3,1,1220,6000,1,1220,0,1968
8564850300,535000,3,3,2640,5978,2,2640,0,2012
3861400061,641000,3,1.75,1480,9603,1,1480,0,1952
3343903647,436300,3,2,2320,9420,1,2320,0,1952
0809002680,1.44e+006,4,1.75,2410,6000,1.5,2410,0,1911
5450300195,830000,4,2.75,2090,13500,1,2090,0,1949
1231001110,380000,3,1,920,3532,1,920,0,1910
6303401050,132500,3,0.75,850,8573,1,600,250,1945
1003400245,179950,3,1,1130,9907,1,1130,0,1954
7468900245,188200,3,1,1260,7265,1,1260,0,1954
5021900265,659000,4,2,2090,10800,1,2090,0,1951
8100900015,317000,3,2,2020,7260,1.5,1180,840,1926
0573000490,625000,3,2.25,1970,4564,1,1470,500,1959
4022900837,350000,3,1.75,1820,9545,1,1230,590,1976
0475001295,750000,3,1.5,1840,5000,1.5,1340,500,1915
5256500025,457000,4,1.75,2100,10358,1,1280,820,1959
2767601390,632500,4,2,1770,5000,2,1770,0,1906
6700400110,223000,3,2,1110,7231,1,1110,0,1991
8860300300,610000,4,2.75,2090,8400,1,1240,850,1976
3738900165,385000,4,1.75,2080,8215,2,2080,0,1948
1314300018,367500,3,3.25,1400,1343,2,1160,240,2005
3992700265,385100,3,1,1060,8040,1,1060,0,1949
1105000296,230000,2,1,720,5913,1,720,0,1920
1773100121,286000,3,2.75,1100,750,2,780,320,2008
7585000110,201700,3,1,1010,9576,1,1010,0,1967
0822069112,1.35e+006,4,4.75,5230,89298,2.5,5230,0,2002
5423030300,525000,4,1.75,2420,7672,1,1480,940,1979
1387301730,361000,3,1.5,1200,7236,1,1200,0,1975
4447300008,530000,3,1.5,1950,1963,3,1950,0,2002
6413600123,455000,3,2.25,1870,7403,1,1870,0,1950
3288100100,421000,4,2.25,1310,8400,1,1310,0,1966
6127600110,640000,4,2,1520,6200,1.5,1520,0,1945
3423049165,240000,3,1,1270,12733,1,1270,0,1955
1233100601,360000,2,1,840,7414,1,840,0,1928
3422059085,157340,2,1,900,23000,1,900,0,1953
9294300600,1.24e+006,4,3,3010,6139,2,2560,450,1950
7282900025,250000,3,1,1050,6874,1,1050,0,1954
2526059076,735000,6,2.75,3360,84506,1,2040,1320,1962
5451100490,884900,7,4.75,5370,10800,1.5,5370,0,1967
0126059097,775000,3,3.5,2690,104544,2,2690,0,1948
7739100015,463000,3,1.75,1710,7320,1,1710,0,1948
9828702251,579000,3,2.5,1640,1269,3,1640,0,2009
9558040820,570000,6,3.75,4000,6015,2,3080,920,2004
1437580600,1.06e+006,5,4.5,4140,7924,2,4140,0,2005
5469502460,375000,4,2.75,3140,24800,1,2080,1060,1971
2919701105,422000,2,1.75,1320,2609,1,920,400,1938
0952003585,866500,4,3.5,3080,4945,2,2010,1070,2014
3066400750,705000,3,2.5,2500,10359,2,2500,0,1986
2607740100,470000,4,2.5,2520,9684,2,2520,0,1994
0793200100,360000,3,1.25,2350,6200,1,1320,1030,1966
6744700900,795000,4,2.5,2570,13450,1,1510,1060,1948
1828300100,800000,4,2.5,3100,7807,2,3100,0,2003
1118000110,2.4535e+006,4,3.5,4730,13586,1.5,4270,460,1935
9297301015,277284,3,1.75,1030,4800,1,930,100,1927
0585000008,460000,2,1,1020,4002,1,1020,0,1953
4070700300,898888,3,2.5,2080,3729,2,2080,0,1996
3026079031,211000,3,1,1410,47916,1,1410,0,1981
2781250750,222000,2,2,1360,3300,2,1360,0,2004
0203100625,672000,3,2.5,2620,21587,2,2620,0,1992
0687600110,778000,3,2.25,2260,33080,1,1690,570,1974
2473372250,312500,3,1.75,1490,9493,1,1490,0,1976
7974700112,650000,4,2.5,2530,6500,1.5,1720,810,1975
2330000015,740000,6,2.25,3140,10250,1,1570,1570,1959
7230300100,320000,3,2,1820,17600,1,1820,0,1972
2133010110,455000,4,2.5,1770,13168,2,1770,0,1990
4389201250,2.45e+006,5,4,4430,9000,2,4430,0,2013
3383900057,500000,3,3.25,1490,902,3,1220,270,2001
2424410110,325000,3,1.75,1790,27427,1,1130,660,1978
3126049436,416000,3,2.5,1710,1296,3,1510,200,2004
9238500100,495000,4,2.25,2070,20280,2,2070,0,1968
9828700900,549000,2,1,1140,5400,1,1140,0,1908
0686400930,589000,5,2,3930,10150,1.5,3070,860,1968
5515600088,194820,3,1.5,1100,32700,1,1100,0,1967
1254200015,405000,3,2.5,2260,5500,1.5,1280,980,1910
1254200015,625000,3,2.5,2260,5500,1.5,1280,980,1910
1523049209,205000,3,1,1130,7014,1,1130,0,1954
0561000300,345100,3,3.75,1950,8625,1,1360,590,1959
0399000195,200000,3,1,960,7500,1,960,0,1953
2540700110,1.905e+006,4,3.5,4210,18564,2,4210,0,2001
2523089097,524500,3,1.5,3430,264844,1,2230,1200,1988
3026079055,598600,4,2.75,3470,212639,2,2070,1400,1993
1105000011,367777,5,3,2140,5937,1,1280,860,1978
5113400535,750000,3,2.75,2520,5401,1,1360,1160,1946
3876301140,575000,5,2.25,3550,7992,2,3550,0,1968
1523049188,84000,2,1,700,20130,1,700,0,1949
5621100115,255000,2,1,740,5000,1,740,0,1926
4219401080,1.74e+006,4,3.75,3300,4545,1.5,2600,700,1926
2112700600,415000,3,2.25,1640,5880,1,1240,400,1977
3222049112,449900,3,2.5,2780,8225,2,2780,0,1990
0622059019,220000,5,1.5,1830,94960,1.5,1830,0,1929
9348700490,899000,4,2.5,3540,9349,2,3540,0,2003
9259900025,430000,3,2.5,1440,7320,1,1440,0,1954
3022059066,472500,4,2.5,2960,223462,2,2960,0,2001
1777500090,680000,6,2.5,3180,9375,1,1590,1590,1967
3885803245,1.65e+006,5,4,3310,8400,2,3310,0,2000
8819901030,810000,3,2,2390,8025,2,2390,0,1921
2623069067,605000,3,2.5,2460,138085,2,2460,0,1977
8635700025,522000,3,1.75,1630,15600,1,1630,0,1958
0098020300,759000,5,2.75,3490,8230,2,3490,0,2005
7243500025,411000,4,2.75,2500,5257,2,2500,0,1966
3329510850,286950,4,2.5,2080,9846,1,1240,840,1984
9521100855,440000,3,1.5,1290,1286,3,1290,0,2000
0723049156,149000,3,1,1700,8645,1,1700,0,1955
0723049156,284700,3,1,1700,8645,1,1700,0,1955
5130000090,374950,3,2.5,2540,11562,1,1290,1250,1964
8562400025,816000,3,1.5,1180,8545,1,1180,0,1952
5706201140,533250,4,1.75,1520,15398,1,1370,150,1960
3034200198,689800,3,2.75,2390,9313,1,1390,1000,1942
4077800017,775000,4,2.75,2740,6200,1.5,1820,920,1947
1245500099,702000,3,2.5,2190,8528,1,1760,430,1991
4435000705,160000,3,1,1350,8700,1.5,1350,0,1942
4435000705,255500,3,1,1350,8700,1.5,1350,0,1942
2225059118,949000,4,2.75,2980,42253,1,1860,1120,1973
5126900405,169500,2,1,790,7450,1,790,0,1944
5603800110,586000,4,2.25,2130,9000,2,2130,0,1965
2426059076,680000,4,2.5,2700,37431,1,1600,1100,1978
3260200110,851500,3,2,3200,18184,1,2000,1200,1977
4235401055,582500,2,1.5,1159,4800,1,1159,0,1948
1550000463,637000,4,3.5,3080,118918,2,3080,0,2008
1823049144,225000,3,1,1000,9295,1,1000,0,1955
7012200215,795000,3,3.25,2260,3727,2,1880,380,2003
5149300100,304999,4,2.25,2270,9600,1,1290,980,1976
7335400215,95000,1,0.75,760,5746,1,760,0,1915
7227501450,240000,4,1.75,1420,5382,1,1040,380,1942
8146300025,772000,4,2.5,2500,8680,1,1250,1250,1958
3530540090,245000,2,1.5,1450,6258,1,1450,0,1983
9284802215,430000,5,3,2500,5750,1,1430,1070,1999
1250202430,799000,3,1.5,2210,6300,1.5,2210,0,1916
1241900028,880000,5,2.75,3020,9187,2,3020,0,2007
8691400600,750000,4,2.5,3290,7538,2,3290,0,2004
1118000301,2.89e+006,4,4,5780,7173,2,4130,1650,2008
3905081500,532000,3,2.5,1820,4910,2,1820,0,1993
5611000090,525000,4,2.75,2500,10330,1,1380,1120,1978
2013800705,239000,2,1,1210,9375,1,1210,0,1952
9276200850,460000,2,1.5,1090,4000,1,970,120,1951
2785000110,540000,4,2.25,1330,8400,1.5,1330,0,1962
2919702655,475000,2,1,890,4590,1,890,0,1923
3942900115,445000,3,1.75,1360,4998,1,1360,0,1968
5452301810,1.575e+006,5,3.75,4220,9240,2,3420,800,1991
5104511730,549950,4,2.5,3780,6800,2,3780,0,2004
3923400123,294950,4,2,2610,14321,1.5,1690,920,1940
2249500367,736000,3,2.5,1980,2975,3,1980,0,1993
2916600110,214946,3,1.75,1290,8688,1,1290,0,1980
3629921140,856000,5,3.25,3620,5500,2,3620,0,2003
8682250090,775000,2,2.5,2680,7392,1,2680,0,2004
6929602605,205000,3,1.75,1200,8631,1,1200,0,1959
8550001515,429592,2,2.75,1992,10946,1.5,1288,704,1903
1775800740,414250,4,1.75,1640,13566,1,1120,520,1977
1773101340,399950,4,2.75,1920,4400,1,960,960,1906
5561710110,319990,3,2.25,1840,7326,1,1370,470,1979
1115800110,524000,3,1.5,1310,9471,1,1310,0,1970
2131701240,349950,2,1,1050,6317,1.5,1050,0,1913
8827901450,889000,4,2.5,2570,4480,1.5,1580,990,1927
4302200336,300000,3,1,930,5160,1.5,930,0,1919
7550800916,395000,1,1,730,3000,1,730,0,1911
0534000112,348000,2,2.5,1270,1242,3,1270,0,2008
3885801450,830000,2,1,1150,6000,1,710,440,1921
0522059013,173000,2,1,820,10450,1,820,0,1965
3342700405,585000,4,1.75,3000,42200,1,1500,1500,1950
9276201140,576750,3,2,2220,5000,1,1110,1110,1966
7972601280,495000,5,3.25,2500,7620,1,1250,1250,1962
2734100734,216650,3,3.5,1540,1427,2,1360,180,2007
4022900077,615000,4,2.75,2750,15450,1,1800,950,1978
1777600490,675000,4,2.5,3130,12463,1,1620,1510,1978
2193310300,510000,3,2,1430,9250,1,990,440,1983
2322069168,630000,3,2.5,2680,327135,2,2680,0,1995
7885800900,359950,4,2.5,3010,5701,2,3010,0,2003
1545800090,265000,3,1.5,1530,7500,1.5,1530,0,1986
7131300025,210000,3,1,1240,4842,1,1240,0,1916
3221079055,367000,3,2.5,2260,93218,1,2260,0,1998
9184700535,1.075e+006,4,2.25,2820,5000,1.5,1800,1020,1926
1877500090,756000,3,2.5,3560,8297,1,1650,1910,1948
0723049476,203000,3,2.25,1630,9145,1,1630,0,1960
8556800100,535000,4,2.5,2880,23994,2,2880,0,2002
9830200475,525000,3,3.25,2200,7440,2,1710,490,1947
2525000690,347500,3,1.75,1620,7500,1,1220,400,1981
1891100090,620000,3,1.75,1480,2185,2.5,1480,0,2005
3447000100,645000,4,2.5,2250,10696,2,2250,0,1996
1118001295,2.2e+006,4,3,3540,11098,2,3000,540,1940
7968460110,280000,3,2,1790,42399,1,1790,0,1990
5101406489,432000,3,2,1400,6380,1,700,700,1924
9275702350,790000,3,1.5,2390,4452,2,1790,600,1929
7752000090,635000,4,1.75,2400,10050,1,2400,0,1957
0293000165,442000,3,1.5,2050,6384,1,1350,700,1958
7852100110,490000,4,3,2640,5267,2,2640,0,2001
1311000600,250000,5,1.75,2320,7700,1,1290,1030,1962
1732800820,1.325e+006,4,2.5,2440,3600,2.5,2440,0,1902
7893203565,120000,3,1,1260,7500,1,1260,0,1954
2524049166,2.95e+006,5,4.75,6240,47480,1,4610,1630,2003
9406550100,325000,4,2.5,1930,8458,2,1930,0,1993
3327000090,210000,4,1.75,1200,7680,1,1200,0,1968
1220000100,215000,1,1,970,7639,1,570,400,1920
1066600025,387000,3,1.75,1810,10800,1,1210,600,1968
3626039228,408000,3,1,1380,7015,1.5,1380,0,1925
7635801032,410000,3,1,1470,6500,1,1470,0,1953
4364700600,216000,3,1,1010,7920,1,1010,0,1925
4364700600,390000,3,1,1010,7920,1,1010,0,1925
7774200236,357000,3,1.5,1340,11744,1,1340,0,1950
8025700590,215000,3,1,970,7275,1,970,0,1970
7129302095,265000,3,1,1122,6554,1.5,1122,0,1900
2997800076,589950,3,2.75,1670,1350,3,1350,320,2014
7740100015,440000,3,1.75,2840,16851,1,1600,1240,1950
5279100625,248000,2,1,770,8600,1,770,0,1914
1126059144,730000,3,2.25,2040,130680,2,2040,0,1977
5409800110,425000,4,2.5,3052,12145,2,3052,0,2004
7963900100,680000,3,2.5,2620,14248,2,1830,790,1977
9264910100,341500,5,2.25,3120,10400,2,3120,0,1980
8819900449,395000,2,1,1100,3975,1,900,200,1950
1525059160,1.225e+006,4,2.75,3410,95396,1.5,3410,0,1962
7526800100,695500,5,2.75,2510,9180,1,1600,910,1975
6385100100,308000,3,1.75,1680,8629,1,1200,480,1977
2085200261,422500,3,2,1960,6450,1,1000,960,1977
3522900061,418000,2,1,1040,6900,1,1040,0,1915
2570500090,385000,5,1.5,1750,9780,1.5,1750,0,1961
5482700100,876650,3,3.25,2170,12508,1.5,1650,520,1928
0567000268,450000,3,2.5,1639,2710,2,1479,160,2003
3649100315,418800,4,2.25,2100,9984,1,1290,810,1973
6821102352,330000,2,1,880,1753,2,880,0,1945
6072300110,550000,3,1.75,1940,8376,1,1290,650,1963
3223049131,270000,4,2.5,2490,11650,1,1390,1100,1990
1068000110,978500,3,2.25,2060,7080,2,1800,260,1940
2600020100,975000,4,2.5,2720,10455,2,2500,220,1981
5422500110,455000,3,2.25,2180,6850,1,1750,430,1973
4055700378,1.415e+006,4,3.25,3600,38016,2,3310,290,1991
0795000820,220000,2,1,840,9000,1,840,0,1951
0925059113,490000,3,2,2370,12196,2,2370,0,1970
3275000090,420000,4,2.25,2270,9100,2,2270,0,1978
8946700100,408500,4,2.5,2720,7043,2,2720,0,2003
0809002485,716000,3,1.5,1140,4800,1.5,1140,0,1915
5332200405,965000,4,2.5,2460,5000,2,1620,840,1938
1775950100,357823,3,1.5,1240,9196,1,1240,0,1968
9808700762,7.0625e+006,5,4.5,10040,37325,2,7680,2360,1940
1133000542,425000,3,2.25,1670,9500,1,1170,500,1977
7905200315,711777,4,1.75,2220,6731,1,1110,1110,1953
3949600090,335000,3,1,980,9903,1,980,0,1966
9274201730,825000,4,1.5,1890,6938,1.5,1890,0,1919
7883604065,210000,2,1,1100,6000,1.5,1100,0,1900
1158700100,575000,2,1.75,2770,19700,2,1780,990,1983
7237500110,1.208e+006,4,2.75,4250,10925,2,4250,0,2003
8682280490,431500,2,2,1370,4866,1,1370,0,2005
0224059111,475000,3,1.5,1480,13457,1,1480,0,1959
4141800215,1.495e+006,4,3.75,3770,4000,2.5,2890,880,1916
1822069097,540000,6,3,2870,206474,2,2330,540,1960
1668500100,775000,3,2.5,3820,35016,2,3820,0,1987
1254200615,635000,3,2.5,1530,2978,1,1210,320,1997
7135520300,1.3e+006,3,2.75,4120,16365,1,4120,0,1999
1755700090,405000,3,2.25,1590,7267,1,1100,490,1976
2414600195,210000,3,1,1520,8600,1,1040,480,1951
3592500985,880000,4,2.5,2350,4675,2,2150,200,1923
1003600056,239000,4,2,1370,8837,1.5,1370,0,1955
9285800755,515000,3,2.5,1540,6100,1,770,770,1944
1269200229,1.3799e+006,3,3.25,3786,38038,1,1934,1852,1978
0304100090,215000,4,2.25,1500,5393,2,1500,0,1999
7227800110,315000,6,2,1750,17685,1,1750,0,1943
7507500015,442500,3,1.5,1800,8303,1,1200,600,1957
0621069146,311000,2,1.75,1180,55321,1,1180,0,1941
0263000164,425000,2,1,830,6030,1,830,0,1925
0263000291,433500,3,1.75,1540,9450,1,1040,500,1919
1566100625,450000,3,2.25,1610,8296,2,1610,0,1978
8861500015,675000,3,2.25,1990,10260,2,1990,0,1987
8961990090,535000,3,2.5,2070,4132,2,2070,0,1999
3584900090,577000,3,1.75,1760,12874,1,1230,530,1967
8902000407,480000,3,1.75,1740,8528,1,1290,450,1939
3026059014,400000,3,1.5,1950,4473,1,1530,420,1914
7304300906,304000,3,1,1280,8184,1.5,1280,0,1947
8155820110,355000,3,1.75,1460,7203,1,1460,0,1990
0722069232,998000,4,3.25,3770,982998,2,3770,0,1992
1825069031,550000,4,1.75,2410,8447,2,2060,350,1936
1825069031,550000,4,1.75,2410,8447,2,2060,350,1936
3348401584,210000,3,1.75,1400,7300,2,1400,0,1948
8029500100,317000,3,2.5,2100,7587,2,2100,0,1990
7964410100,700000,4,3.5,5360,25800,1,3270,2090,1971
1457500026,265000,3,1,1000,9150,1,1000,0,1969
7215730590,700000,4,3.5,3150,6175,2,3150,0,2001
7525530100,1.02e+006,5,3.5,4180,17841,2,3160,1020,1990
1925059194,1.145e+006,4,2.25,2840,20242,1,2240,600,1972
5561401110,460000,4,2.5,2110,35091,1,1290,820,1985
7173700524,410000,2,1.5,1660,4000,1,1000,660,1950
9828202215,665000,4,3,2160,4400,1,1320,840,1921
4113800300,600000,4,2.5,2420,7744,2,2420,0,1994
6145600855,502000,4,1.75,1920,3844,1,1170,750,1967
2130702350,364950,4,2.5,2310,8030,2,2310,0,1978
8815400735,680000,3,2.25,2330,4000,1.5,1520,810,1927
5152600090,235500,5,2.5,2340,13713,1,1670,670,1967
7852090750,576000,4,2.5,2590,5756,2,2590,0,2001
2488200459,405000,2,3,1410,1240,2,1140,270,2006
8035600590,335000,3,2.75,2850,8039,1,1540,1310,1989
4438000165,122000,2,1,730,6728,1,730,0,1953
6744700423,432000,3,1.75,1470,6250,1,1070,400,1939
2473002100,375000,4,2.25,2330,11400,1,2330,0,1974
4399200245,276000,4,2.25,2460,11250,1,2460,0,1959
1326059085,450000,3,2.25,2080,111513,1.5,1680,400,1977
6324000090,210000,2,1,990,8140,1,990,0,1910
9542830600,279000,3,2.5,1450,4106,2,1450,0,2011
2767604580,635000,3,1.75,1340,3900,2,1340,0,1900
0662310900,350000,3,2.5,2730,7372,2,2730,0,1998
1432600100,218000,3,1,1140,7560,1,1140,0,1958
8928100025,750000,4,1.5,1950,6300,1.5,1650,300,1944
1221039058,310597,4,1.75,2000,25700,1,1150,850,1958
3840700600,355000,3,1,900,37800,1,700,200,1923
8691410100,735000,5,2.75,3390,5211,2,3390,0,2004
7883607645,155000,1,1,720,6000,1,720,0,1940
9435300051,354000,3,1,940,10368,1,940,0,1965
6179900090,415000,3,1.75,1770,10513,1,1400,370,1982
6840700165,202000,1,1,590,833,1,590,0,1926
2768301217,580000,3,2.5,1980,1873,2,1470,510,1996
0629000615,1.495e+006,4,3.25,3070,10375,2,2180,890,1962
7202360600,790000,4,2.5,3500,7519,2,3500,0,2004
7852020590,499900,3,2.5,2100,5112,2,2100,0,1999
2023039160,525000,4,2.25,2620,98881,1,1820,800,1952
2597520090,810000,4,2.5,2810,10613,2,2810,0,1989
8631600025,425000,4,1.5,2290,8773,1,1330,960,1947
8100000110,241250,3,1.75,1350,7588,1,1350,0,1993
5151800015,318700,4,2.5,2770,19116,1,1600,1170,1961
9521101055,720000,4,1.75,2530,5000,1.5,2070,460,1917
2475901105,291000,3,1,1280,10500,1.5,1280,0,1941
1726069202,420000,3,1.75,1060,38644,1,1060,0,1983
3530450100,210000,2,1.75,1000,3554,1,1000,0,1975
8941800100,645000,3,3.25,3870,11000,2,2970,900,1991
0809002215,762000,5,2,3370,5000,1.5,2140,1230,1907
6209000165,247500,4,1.75,2290,7765,1,2290,0,1936
4178500100,282500,3,2.25,1670,7150,2,1670,0,1990
1523069086,395000,3,1.75,1460,22651,1,1460,0,1961
6121000090,295000,3,1.75,1770,8235,1,1030,740,1960
3342100785,235000,2,1,820,5100,1,820,0,1954
6012500100,770000,3,1.75,1900,6334,1,1450,450,1948
8682291720,559950,2,2,1870,4950,1,1870,0,2006
5041300100,639000,4,2,1840,5419,1,920,920,1942
2473101140,314950,3,1,1590,8470,1,1140,450,1967
8121100600,525000,3,1,1640,6180,1,1640,0,1946
0724069059,2.4e+006,3,2.25,3000,11665,1.5,3000,0,2001
2755200110,820000,3,1.75,2160,6272,1,1390,770,1960
6169901130,1.385e+006,3,3,2490,3600,2,1790,700,1911
6385000025,521450,3,2,1290,5700,1,1290,0,1950
0509000090,760750,3,2.5,3190,49137,2,3190,0,1988
0622059031,759600,4,1,1540,115434,1.5,1540,0,1923
5358300100,346150,3,2,2140,7200,1,1480,660,1966
4459800100,390000,2,1,980,3800,1,980,0,1926
2473371780,359950,5,2.25,2450,9432,2,2450,0,1973
9393700110,430000,3,2,1360,5120,1.5,910,450,1924
8691360490,960000,4,3.5,4610,11676,2,4610,0,2000
9175600025,800000,7,6.75,7480,41664,2,5080,2400,1953
7605800090,1.01e+006,3,2.5,2860,5805,2,2860,0,1999
7334500090,290000,3,2,1810,11456,1,1810,0,1970
8964800930,1.35e+006,4,2,2240,10296,1,2240,0,1948
2260800110,777000,3,3.25,3610,59677,2,2440,1170,2003
7550800945,526000,2,1,1450,4500,1.5,1450,0,1921
1972205338,550000,3,3.5,1450,1091,2,1200,250,2007
2946000590,276000,3,1.5,1820,8750,1,1200,620,1958
5700003585,2.5e+006,5,3.25,5620,12672,2,4140,1480,1916
7129302235,325000,3,1.75,2080,6554,1,1040,1040,1950
3278602490,365000,3,2.5,1780,1754,3,1780,0,2007
0685000115,2.15e+006,8,6,4340,9415,2,4340,0,1967
3423600025,825050,4,3.25,2860,3680,2,1980,880,1925
7173700518,690000,3,1.5,2540,9520,1,1500,1040,1959
3277801450,390000,4,1,1140,6250,1.5,1140,0,1958
1862400518,385000,3,2,1320,1297,3,1320,0,1995
8078350090,619000,3,2.5,2040,7503,2,2040,0,1987
1423089118,494000,4,2.25,1790,42000,1,1170,620,1983
7980900011,412450,3,2,1910,13505,1,1910,0,1955
5309100750,580000,3,1.75,1460,2800,2,1460,0,1928
0322059097,269900,3,1.5,1420,22100,1,1420,0,1957
9834200165,704300,4,1.5,1790,4080,1.5,1790,0,1928
2420069201,267000,3,2,1390,6005,2,1390,0,2005
4167300300,310000,4,1.75,1880,12150,1,1280,600,1976
1105000745,227064,3,1.5,1570,10824,2,1570,0,1908
8927600100,925000,3,2.5,2690,7000,2,1840,850,1943
8078490090,245000,3,1.75,1670,11452,1,1670,0,1992
1736100090,339888,3,1,1040,7490,1,1040,0,1969
3876200100,439000,4,2,1560,7500,1,1560,0,1968
6844702290,400000,2,1,1470,6120,1,1470,0,1940
4022906430,560000,3,2.25,2070,15002,1.5,2070,0,1955
5040800015,703011,2,1,1370,5922,1,1130,240,1941
9297301055,363000,2,1,1120,4800,1,770,350,1926
0318500300,650000,4,2.75,2640,6240,2,2640,0,2001
1839910300,299950,3,1,1030,9916,1,1030,0,1972
1446400785,228950,3,1,1120,6625,1,1120,0,1942
4036800015,465000,4,1.75,1730,11700,1,880,850,1956
8965500900,725000,3,2.5,2090,9847,2,2090,0,1983
3751603173,212500,3,1,920,14400,1,920,0,1977
3423059140,526000,4,2.25,2970,54450,2,2970,0,1983
0114101055,383000,3,2.5,1720,10031,2,1720,0,1993
2475200590,244000,3,1.75,1460,4692,1,1460,0,1988
3856905010,565000,3,1.5,1540,3570,1.5,1490,50,1930
7226500100,373000,8,3,2850,12714,1,2850,0,1959
3580900090,300000,3,2,1310,9855,1,1310,0,1962
9558000100,405000,5,2.5,2430,4781,2,2430,0,2001
1872900076,979000,3,1.5,1700,14133,1,1700,0,1954
1221059112,324888,4,1.75,2160,28750,2,2160,0,1978
2877102495,445000,3,1.5,860,3200,1,860,0,1929
4400200057,761000,3,3.5,2050,2020,2,1520,530,2006
1049010300,435000,4,2,1650,4745,1,1130,520,1972
6802210090,252000,3,2.25,1570,8410,1,1180,390,1991
0726049232,350000,3,1.75,1660,10150,1.5,1660,0,1957
3262300940,875000,3,1,1220,8119,1,1220,0,1955
3262300940,940000,3,1,1220,8119,1,1220,0,1955
1214700090,280000,3,2,1780,11342,1,1780,0,1964
8564950300,450000,3,2.5,2180,4226,2,2180,0,2004
3321069006,905000,3,2.5,3520,237402,2.5,3520,0,2004
3751601501,382450,3,2.5,2220,20531,2,2220,0,1998
1156000100,246700,3,2,1610,13309,1,1610,0,1967
3972900735,220000,3,1.5,1070,9331,1,1070,0,1956
6888900115,555750,3,1,1060,4880,1,910,150,1913
3031200165,262500,3,1.5,1160,8906,1,1160,0,1962
5683000033,515000,2,1,910,4725,1,910,0,1949
7230000265,499500,3,2.5,2970,21907,2,2970,0,1998
0985001015,135000,1,1,790,13062,1,790,0,1942
2815600215,462500,2,2,1540,7290,2,1540,0,1948
3585900090,937500,4,2.5,3130,21100,1,2530,600,1956
5101407370,458000,3,1.5,1470,9570,1,1280,190,1941
0871001105,845000,4,2.75,3160,7143,1.5,2100,1060,1933
0424069233,660000,3,2.25,2675,40910,2,2675,0,1984
3830630090,265000,3,2,1340,6783,1,1340,0,1987
1997200215,599999,9,4.5,3830,6988,2.5,2450,1380,1938
1898310110,280000,3,2.5,1800,8697,2,1800,0,1987
3407700047,1.055e+006,3,3.25,2990,189852,2,2990,0,1974
9542100165,875000,4,3,3720,14125,1,1930,1790,1960
7140800100,125000,3,1,920,7276,1,920,0,1961
7202340930,634800,4,3,3280,4904,2,3280,0,2005
9262800057,269950,4,1,1440,9600,1,1440,0,1964
1159100100,359950,3,2.25,1940,11612,1,1100,840,1981
7230900100,417000,3,1.75,1590,11454,1,1590,0,1979
8682301910,389000,2,2,1340,4122,1,1340,0,2007
7701450110,1.038e+006,4,2.5,3770,10893,2,3770,0,1997
1725059209,698000,6,2.5,2680,11250,1,1340,1340,1967
4025300195,685000,4,2.5,2820,10125,2,2820,0,2008
0985000900,198500,3,1.75,1520,7137,1,1520,0,1932
7140700850,350000,4,2.5,2560,5428,2,2560,0,2012
0522079067,649950,3,2.5,3310,387684,1,2160,1150,1919
1387300940,441000,3,1.5,1540,7200,1,1540,0,1968
8562700090,462600,3,1.75,1430,11761,1,1430,0,1964
2122059236,365070,4,2.5,2506,6232,2,2506,0,2006
0514500090,550000,4,2,2250,7500,1,1200,1050,1956
5680001095,470000,5,1.75,2740,9600,1,1370,1370,1945
2475900855,340000,3,1.75,1540,10400,1,1540,0,1977
8669400100,910000,4,2.75,4190,38912,1,2040,2150,1965
3824100051,405000,4,1.75,1690,8392,1,1190,500,1979
0952004875,661000,4,2.25,1990,4600,1.5,1420,570,1932
9522350090,635000,4,2.5,2410,7069,2,2410,0,1993
1787600252,282000,2,1,1150,6098,1,950,200,1948
7148000315,235000,4,1.75,1720,10137,2,1720,0,1956
2180001080,277500,3,2,1260,22100,2,1260,0,1981
1328330590,346500,5,2.5,2020,8250,1,1430,590,1978
0034001304,480000,5,2.25,2240,5500,1,1490,750,1959
1558500100,360000,4,2.25,1930,6508,2,1930,0,1996
2887950110,245000,3,2.5,1820,6785,1,1420,400,1994
6852700412,625000,3,3.5,1560,1490,2,1240,320,1995
1798000100,750500,5,3,2170,2440,1.5,1450,720,1911
9516500100,525000,3,1.75,1600,9579,1,1180,420,1977
0203400090,740000,4,3.5,3760,57063,2,2950,810,1998
4036800805,523000,3,1.5,1240,7735,1,1240,0,1957
7129302615,292000,3,1.75,1090,4500,1.5,1090,0,1929
7278700100,625000,4,2.5,2740,9599,1,1820,920,1961
7852070090,700000,3,2.5,3110,11727,2,3110,0,2002
1250200552,399950,3,2.5,1610,1320,2,1280,330,2007
9126100608,545000,4,3.5,1880,1341,3,1650,230,2007
0396100025,339999,4,2,1740,6369,1,870,870,1954
9184700600,1.21e+006,4,2.25,3270,6000,2,2180,1090,1909
4221250090,545000,3,2.5,1990,5149,2,1990,0,2003
8731901810,260000,4,1.75,1960,8400,1,1960,0,1967
7977201707,526000,3,1.75,1680,3420,1,960,720,1992
3260350090,701000,4,3,2910,8540,2,2910,0,2003
7399300850,290000,3,2.25,1500,7482,1,1210,290,1968
0461002551,330600,1,1,580,1799,1,580,0,1908
9158100090,550500,3,1.75,2540,8280,1,1270,1270,1949
9358002305,430000,2,1,950,6426,1,950,0,1949
6447300265,4e+006,4,5.5,7080,16573,2,5760,1320,2008
2235000015,260600,2,1,810,4560,1,810,0,1928
9523104345,825000,5,3,4080,7500,2,2720,1360,1961
6139100056,378950,4,2,1820,8400,1,1300,520,1956
0808300090,435000,4,2.5,2650,9065,2,2650,0,2000
8077100031,631000,3,2.25,1670,1396,2,1250,420,2015
1402650110,415000,3,2.5,2480,8342,2,2480,0,1986
7985000100,222000,3,1.75,1240,7560,1,1070,170,1967
1796350690,245000,3,2,1390,8250,1,1390,0,1987
7504110110,720000,3,2.5,2880,10126,2,2880,0,1985
4324500490,215000,3,1,1060,9954,1,1060,0,1960
1257202120,579100,2,1,1070,2754,1,830,240,1924
3987700115,522500,4,1.75,1640,9299,1.5,870,770,1943
9137101353,489000,3,2,1510,3000,1,910,600,1972
3298701066,240000,3,1,1230,2353,1.5,1230,0,1925
8682290100,420250,3,2,1510,3657,1,1510,0,2007
4055700778,523000,4,2.5,3180,20870,2,2120,1060,1967
0438000025,628000,4,2,2260,6000,1,1430,830,1958
2474400300,320000,4,2.5,1920,7277,2,1920,0,1990
0087000283,359950,3,2.5,1980,7800,2,1980,0,1999
2946001645,232000,2,1,1200,8063,1,1200,0,1958
9294300495,810000,4,2.25,2020,5600,1,1210,810,1961
0492000475,245000,4,1.5,2010,7561,1.5,1890,120,1921
3876540600,273000,3,2.25,1930,8192,1,1470,460,1984
4122500100,1.191e+006,5,2.5,2710,14989,1,1720,990,1959
2461900945,438000,5,1,1950,6250,1.5,1450,500,1917
7221400495,400000,3,1.75,2110,19600,1,2110,0,1959
2349300090,340000,3,1,1250,4800,1,1250,0,1951
9523100459,552000,2,2.5,1380,951,3,1380,0,2006
3856904580,790000,3,1.75,2050,4080,2,2050,0,1991
7345600755,360000,3,1.5,1800,22000,2,1800,0,1931
0798000457,235000,3,1,1310,15022,1,1310,0,1934
7986400945,775000,2,1,1010,3600,1,1010,0,1913
0395300100,489200,3,2.75,1850,9600,1.5,1850,0,1965
2473510090,341000,3,2.25,1750,8900,2,1750,0,1977
1329300300,335000,4,2.5,2154,6050,2,2154,0,2012
0952007069,393500,3,1.75,1230,1441,2,1010,220,2004
8073000265,360000,3,2,1960,8846,1,980,980,1940
0952004745,400800,4,1,1070,5750,1,870,200,1923
1376800115,585000,3,1,1450,5378,1,1190,260,1939
6613000750,1.6e+006,4,2.75,3680,5000,2,2480,1200,1936
2303900090,2.8805e+006,4,2.5,5760,32033,2,4390,1370,1994
6713700025,300000,3,1,1220,13000,1,1220,0,1955
4083304535,1.045e+006,4,2.75,2950,4560,2,1810,1140,1912
3626039403,360000,3,1.5,1340,1110,2,1040,300,1999
0254000100,665900,4,2.25,2870,5453,2,2220,650,1926
2724049076,470000,4,1,2590,18224,1.5,2000,590,1911
8562500690,581000,4,1.75,2090,8164,1,1070,1020,1963
3834500195,527000,6,3.5,3000,8401,1,1500,1500,1979
2207100405,423000,4,1.75,1730,7245,1,880,850,1955
9482700475,875000,4,3.5,2850,4416,1.5,2040,810,1926
7905200386,410000,3,1,1020,6903,1,1020,0,1951
8680500090,606000,3,2.5,2200,6005,2,2200,0,1997
3424089119,654000,3,2.5,3240,60840,2,3240,0,1997
1437500015,150000,3,0.75,490,38500,1.5,490,0,1959
3298700110,373000,3,2.5,2990,6771,1,1550,1440,2003
6300000337,550000,5,2,2450,9488,1,1240,1210,1900
8561200110,512500,3,2.5,1900,7604,2,1900,0,1990
2781250110,360000,4,2.5,2640,7388,2,2640,0,2003
4442800008,369000,3,2,1340,1480,3,1340,0,1997
2619920110,825000,4,2.5,3220,5262,2,3220,0,2003
7334501130,255000,3,2,930,11475,1,930,0,1978
9471200115,1.285e+006,4,2.5,3240,10800,1,2260,980,1946
2597500090,270000,5,2.5,2630,8470,1.5,2630,0,1968
8665050490,480680,3,2.5,1730,4924,2,1730,0,1996
1736800740,525000,4,1.75,2120,7725,1,1220,900,1965
6163901751,291500,3,1,880,9238,1.5,880,0,1946
2323059184,305000,4,2,1800,13551,1,1800,0,1974
7349650490,285000,3,1.75,1600,7500,1,1600,0,1998
1025039086,1.875e+006,3,2.5,3280,29111,2,3280,0,1925
0274100090,329500,5,1.75,3290,8000,1,1790,1500,1968
3342104046,1.57e+006,4,2.25,2890,18226,3,2890,0,1984
7893801862,379260,3,2.5,1730,7202,1,1330,400,1991
7852060490,356000,3,2.5,1590,3411,2,1590,0,2000
7923300115,571900,4,1.75,1710,8947,1,1710,0,1956
2868300115,271500,3,1.75,1995,18360,2,1995,0,1957
9477001270,390000,3,1.75,1300,10030,1,1300,0,1967
0522069119,550000,3,2.5,2720,62310,1,2040,680,1985
2025049175,755000,2,2.5,1360,2070,2,1360,0,1999
2771604226,509500,2,2.5,1590,1485,2,1300,290,1994
2917200615,486700,2,1,1200,6278,1,1080,120,1942
9551201295,527500,2,1,1170,3000,1.5,1170,0,1910
7443000985,475000,5,2.5,2010,3600,1.5,1510,500,1912
3395041194,268000,3,2.75,1880,1793,2,1810,70,2001
1024069162,562000,3,2,3250,50529,2,3250,0,1978
5452800735,780000,4,2.5,2270,13449,1,1310,960,1975
2902200015,700000,9,3,3680,4400,2,2830,850,1908
1698900195,710000,3,2,1880,3000,1,1040,840,1931
0442000015,445000,3,1,1050,5664,1,910,140,1947
0222069058,729000,3,3.25,2250,60548,1,2250,0,2005
2926049449,384400,3,3.25,1689,1388,3,1689,0,2008
6071800100,815000,6,3,2860,17853,1,1430,1430,1962
4003000110,865000,4,2.5,2710,4069,3,2710,0,1990
0925059198,514000,3,2,1770,7200,1,1770,0,1967
6072700110,615000,4,2.75,2820,13193,1,1860,960,1965
1926069143,865000,4,3.25,3400,99170,1,2000,1400,1980
2871000300,755000,4,2.5,3110,6930,2,3110,0,2004
6163900301,425000,4,1,1480,8321,1,1080,400,1953
4318200090,375000,2,1,940,9839,1,940,0,1910
9526600090,750000,4,2.5,2680,4548,2,2680,0,2009
0629420100,722000,4,2.75,3190,5408,2,3190,0,2005
6905200215,1.011e+006,3,2.5,1920,4480,2,1920,0,1949
7202430110,725000,3,2.5,2610,7510,2,2610,0,1996
0087000245,170000,3,0.75,1040,42180,1,1040,0,1947
6667400090,845000,4,3.25,2880,35315,1,2270,610,1982
6802200100,271900,3,2,1450,8771,2,1450,0,1991
0913000315,1.3e+006,6,4.5,3902,3880,3,2782,1120,1977
8732030490,261500,4,2.5,2460,7800,1,1500,960,1977
3629920600,619500,3,2.5,2170,5000,2,2170,0,2003
1524079156,435000,5,2.25,1970,15247,1,1450,520,1986
6450301690,210000,3,1,1000,5454,1,1000,0,1954
5309101050,489950,3,2,1580,4010,1,790,790,1909
8857600820,260000,4,1.5,2130,8800,1,1100,1030,1962
3500100025,300000,4,1,1370,8499,1,1370,0,1949
5152100110,530000,4,2,2150,14161,1,1330,820,1966
3298600850,235000,3,1.75,1370,14030,1,1370,0,1977
3856902250,593500,3,1,1370,4000,2,1370,0,1918
8887001140,562000,3,3,3290,80471,2,2330,960,1975
2621069066,585000,3,2,3190,207346,2,3190,0,1994
0251620090,2.4e+006,4,3.25,4140,20734,1,3300,840,1977
3546000090,199500,3,1.75,1690,8901,1,1690,0,1986
3359500755,544500,5,1,1690,3240,1.5,1690,0,1914
3579800485,394900,3,1,1430,13370,1,1430,0,1962
2919201335,912000,4,3.75,1980,4095,2,1980,0,2009
1796370930,260000,3,2.5,1490,8102,2,1490,0,1990
3864000090,858000,5,3,3620,12778,1,1900,1720,1964
8651100110,1.275e+006,4,2.5,2720,16454,1,1870,850,1963
8731730590,242150,4,1.75,1490,8544,1,1490,0,1970
1761100300,220000,3,1.75,1230,7200,1,1230,0,1986
9542800820,235000,3,2,1900,7980,1,1340,560,1977
2644900110,370000,3,1.75,1530,10300,1,1530,0,1978
1626069198,450000,3,1.75,2290,44866,1,1390,900,1981
5101408593,534950,5,1.5,2240,6337,1,1280,960,1956
7853270100,730000,4,2.5,3470,14271,2,3470,0,2005
3308030100,465000,4,2.5,3050,32450,1,1550,1500,1983
1330280100,178000,3,1,1100,5734,1,1100,0,1955
2212200090,215000,3,1,1610,7140,1,1080,530,1976
9264921140,300000,3,2.75,1910,15508,1,1210,700,1984
8902000068,430000,3,2,1510,7066,1,1230,280,1973
7338000850,183000,3,1.5,1280,4366,2,1280,0,1985
2770600853,585000,3,2.5,1910,1501,2.5,1530,380,2007
4239400740,192950,3,1,1170,3330,2,1170,0,1969
6184700100,599000,2,1,1550,7713,1,1550,0,1930
3157600615,326500,3,1,1060,7920,1,1060,0,1968
6145601810,358803,2,1,1040,5765,1,1040,0,1944
1235700042,537000,3,2.5,1550,12920,2,1550,0,1999
7781600025,1.155e+006,3,2.5,2490,24691,1,1580,910,1961
7116500705,156000,2,1,920,5889,1,920,0,1950
2320069206,219000,3,1,1250,8276,1.5,1250,0,1939
1794501390,1.19e+006,3,1.5,2540,2700,2,1630,910,1922
2122059160,248000,5,1.75,2190,16788,1,1380,810,1978
2421069039,340000,3,1.75,1340,196020,1,1340,0,1987
5452800495,899100,5,2.5,2410,15300,1,1400,1010,1975
4024100961,346950,3,1.75,1830,10954,1,1830,0,1963
7857001560,330000,3,1,1850,5775,2,1740,110,1928
9540100025,325000,3,1,1410,8250,1,1410,0,1954
2473410740,315000,3,1.75,1460,7884,1,1460,0,1975
2770604365,649950,3,2.5,1500,1375,2,1200,300,2014
0173000025,316000,3,1,1130,7200,1.5,1130,0,1942
7853340490,386000,2,2.5,1620,3196,2,1620,0,2008
0239000115,535000,2,1.75,2330,7280,1,1450,880,1982
9528101032,600000,3,3,1520,1800,3,1520,0,2003
5416100110,339000,4,2.5,2840,8746,2,2840,0,2001
4331000265,167000,3,2,1520,7456,1,1520,0,1949
5249803885,430000,3,1,1740,4800,1,1740,0,1952
7853301390,688000,4,4,4000,9309,2,4000,0,2007
1376800025,834500,3,2.25,2780,6000,1,1670,1110,1948
7639900025,1.075e+006,4,4.25,3500,8750,1,2140,1360,1951
2822059262,250000,3,1,1060,52272,1,1060,0,1960
8113100850,402500,3,1,1290,4000,1.5,1290,0,1926
0565300110,432500,3,2.5,2390,6435,1,1600,790,1978
1887000100,485000,5,1.75,2460,14100,1,1380,1080,1972
8731990090,560000,4,2.75,2930,22000,1,1580,1350,1978
3432500705,410000,4,2.25,2200,8292,2,2200,0,1990
1015500300,455000,3,2.5,1870,7344,1,1470,400,1980
3972300100,459500,4,2.5,2060,8968,1,1190,870,1975
3876300600,371000,4,1.75,1610,11305,1,1610,0,1968
2111010940,289500,3,2.25,2120,3400,2,2120,0,2002
2771102158,395000,3,3.5,1450,1263,2,1160,290,2007
1498304065,496752,2,1,1980,5000,1,1090,890,1923
6150200375,227000,2,1,860,6800,1,860,0,1943
3343901340,330000,3,1.75,1460,9261,1,1460,0,1985
4037800015,480000,5,2,2590,8610,1,1340,1250,1958
1626079066,290000,2,1,1120,217800,1,1120,0,1976
0006200017,281000,3,1,1340,21336,1.5,1340,0,1945
5249805090,705000,4,1.5,1780,3120,1.5,1780,0,1926
4217401055,1.4e+006,4,2.5,2920,4000,1.5,1910,1010,1909
7738500475,485000,4,3.25,2820,6611,1,1410,1410,1958
2767603250,622000,3,2.25,1550,1919,3,1550,0,2003
2620069113,380000,3,2.25,1600,39848,1,1600,0,1958
3760500336,2.125e+006,4,2.75,3190,19513,2,3190,0,1982
5101404563,561500,3,1.75,1960,6380,1,980,980,1939
9407000600,242000,3,1,970,9600,1,970,0,1972
9353300600,348500,3,1.5,1360,10726,1,1360,0,1966
9353300600,370000,3,1.5,1360,10726,1,1360,0,1966
0993000090,752000,6,3.75,3810,6663,2,3810,0,1977
1796361140,230000,3,1.75,1340,8250,1,1100,240,1985
1112000031,715000,3,2.25,1990,4977,3,1990,0,2012
2822049160,240415,3,1.75,1120,10187,1,1120,0,1968
3856904560,562000,4,1.75,2060,4080,1.5,1460,600,1922
2492200956,360000,3,1.5,1170,4080,1,1170,0,1917
2770604079,659950,3,2.5,1610,1246,2,1080,530,2014
2719100042,458500,3,2,1890,1599,2,1430,460,2012
7899800864,259950,2,2,1070,649,2,720,350,2008
9485750110,366000,3,1.75,1680,6108,1,1680,0,1989
2024059058,978000,4,2.75,2890,7821,2,2890,0,2014
7977201865,525000,2,1,1360,6120,1,1060,300,1947
4232900940,926300,3,1.5,1660,4800,2,1660,0,1907
3364900375,750000,2,1,1620,6120,1,1620,0,1951
4151800375,660000,2,1,960,6263,1,960,0,1942
2610100015,305000,4,1.75,1000,7200,1.5,1000,0,1947
8682230590,800000,2,2.5,2395,6143,1,2395,0,2003
3876100940,600000,4,1.75,3050,9440,1,1800,1250,1966
1221079058,435000,2,1,1120,88327,1.5,1120,0,1972
2770605550,1.135e+006,4,3.25,2960,4296,2,2190,770,2007
4468400214,318000,3,2.25,1250,1017,3,1250,0,2008
2767705010,639000,4,2,1940,5000,1,980,960,1910
5422560930,453000,3,2.5,1750,3900,2,1750,0,1977
0824059211,800000,4,1.75,2150,9148,1,2150,0,1955
6825100015,437000,2,1.75,1500,6800,1,910,590,1942
4166600115,1.15e+006,3,2.75,3230,75889,2,3230,0,1925
3574801500,490000,4,2.5,3000,8645,2,3000,0,1985
9477001140,499950,4,1.75,1520,7700,1,1520,0,1967
3384300100,160134,3,1.5,1190,10116,1,1190,0,1968
6123600100,191000,3,1,990,8255,1,990,0,1953
1311300100,221000,3,1,1250,7280,1,1250,0,1965
3812400854,352800,4,2,2080,6360,1,1330,750,1960
1326069188,350000,3,2.5,1640,10424,2,1640,0,1988
3131201865,458000,4,1.5,1550,3000,1.5,1350,200,1918
0321059059,359950,3,1,1290,189486,1,1290,0,1960
0223039330,1.05e+006,3,3,3250,5093,2,3250,0,2004
7857000900,353000,3,1.75,1260,11775,1,1260,0,1942
8109800110,717550,3,3.5,2840,4468,3,2840,0,2006
5422560900,450000,3,2.25,1960,6500,2,1960,0,1977
3332000195,167500,3,1,760,3090,1,760,0,1903
2423029245,550000,3,1.75,2240,78225,2,2240,0,1976
8651600110,939000,4,2.25,2240,9684,2,2240,0,1970
7902200015,700000,3,1.75,1820,15570,1,1820,0,1948
3523089019,480000,4,3.5,3370,435600,2,3370,0,2005
8827900015,501000,3,1,1160,4360,1,1160,0,1929
9237800100,580000,3,2.25,1640,8625,1,1320,320,1987
2724089019,527550,1,0.75,820,59677,1,820,0,1999
5416501030,399000,4,2.5,2800,4687,2,2800,0,2005
7211402305,240000,3,1.75,1780,5000,1.5,1080,700,1957
1221059176,353000,4,2.75,2200,268329,1,1410,790,1989
7549802600,335000,4,2,1480,3132,1,740,740,1910
4112100165,475000,3,3,2010,2554,2,1860,150,2001
7518506595,660000,3,2,2880,5100,1.5,2080,800,1926
2767602490,551000,3,1,940,1948,1,940,0,1900
3821000100,249950,4,1.75,1620,10530,1,1620,0,1968
0524069019,1.15e+006,4,3.25,4400,262666,2,4400,0,1988
1492800296,575000,3,1.75,1530,6743,1,1410,120,1955
7855900110,1.08889e+006,4,2.75,3460,11350,1,1780,1680,1974
7853290090,515000,4,2.5,2890,7306,2,2890,0,2006
2123049175,235000,3,1.5,1980,11214,1,1980,0,1959
2025049064,796000,3,1,1980,3243,1.5,1980,0,1912
6046401105,450000,2,1.5,1450,2550,1,820,630,1984
3505100756,2.05e+006,4,3,4280,18834,1,2180,2100,1971
5468730110,270000,4,2.5,1810,6509,2,1810,0,1994
5154200015,1.705e+006,3,3,2490,27702,2,2490,0,2000
9285800590,565000,3,1,1610,4108,1.5,1610,0,1928
4083304190,680000,1,2.5,1820,3008,2,1090,730,1910
2470100110,5.57e+006,5,5.75,9200,35069,2,6200,3000,2001
7574910490,864500,4,2.5,3520,35991,2,3520,0,1992
0868001030,1.15e+006,4,2.25,3740,18000,1,1870,1870,1951
8108600464,335000,3,2.25,2150,30476,2,2150,0,1991
3295610490,911000,4,3.25,3526,15958,2,3526,0,1997
5013500110,425000,2,1,1070,6625,1,830,240,1950
3223069019,299950,3,1,1410,81021,1,1410,0,1949
2725069085,864000,4,2.5,3190,49658,2,3190,0,1999
6821600265,425000,2,1,1270,6000,1,1270,0,1939
1471701780,374950,4,1.5,1970,14490,1.5,1970,0,1963
9835800750,247000,3,2.25,1640,7630,1,1180,460,1968
8835900015,475000,3,1,1600,7161,1,1600,0,1953
0806800110,275000,3,2.5,3020,5868,2,3020,0,2003
0826069002,355000,2,1,1350,368517,1,1350,0,1947
2222059064,285000,4,1.75,1870,22072,1,1070,800,1959
7781600100,1.33875e+006,3,2.75,2730,38869,1.5,1940,790,1963
4047200265,325000,2,1,1100,17817,1,620,480,1980
2125059013,1.67e+006,5,3.5,4320,40816,2,4320,0,1997
2011400583,402000,3,2.5,2700,9994,1,1350,1350,1959
3526039160,1.1e+006,3,3,3700,16857,1,2170,1530,2000
8718500495,375000,4,1.75,2190,9225,1,1250,940,1959
3815500165,396000,5,2.75,2840,12253,1,1420,1420,1960
5104450690,320000,4,2.75,2610,9077,1,1310,1300,1987
7202260300,610000,3,2.5,2630,5827,2,2630,0,2001
1423600300,249950,3,1.5,1090,7698,1,1090,0,1966
1796100015,675000,4,3.5,3090,100835,2,3090,0,1999
3874900090,448000,2,2,1670,7772,1,860,810,1919
4232902615,819000,3,1,1300,3600,2,1300,0,1900
3585900495,1.25e+006,3,2.5,3670,18505,1,2530,1140,1983
3790700110,225000,4,2.5,1700,6031,2,1700,0,1994
3626079040,790000,2,3,2560,982278,1,2560,0,2004
2461900375,685000,4,2.5,2770,6000,2,2400,370,1993
8651611690,812000,3,3.25,3240,8338,2,3240,0,2001
8682301050,705000,2,2.5,2300,6400,1,2300,0,2007
1858600042,360000,4,3,2483,6870,2,2483,0,2005
2767604252,344000,1,1.5,760,779,3,760,0,2006
1954700615,825000,4,1.5,2040,6900,2,2040,0,1903
6844702690,476500,3,1,1200,6120,1,950,250,1945
2695600195,379500,2,1,960,5096,1,960,0,1949
0426059055,620000,3,1.75,2410,35236,1,2410,0,1980
1769600147,477590,3,3.25,2260,7701,2,1760,500,2000
9268200300,490000,3,1,1910,8190,1,1010,900,1946
3052700855,470000,3,1.5,1500,5000,1.5,1140,360,1927
9828702262,500000,3,2.25,1360,1236,2,1140,220,2006
1568100386,370000,3,1,1320,7341,1,1320,0,1982
4385700735,790000,2,1.5,1940,4400,1,970,970,1923
3425059206,725000,4,2.5,2650,18295,2,2650,0,1986
6848200018,840000,4,2.75,3040,2800,2,2100,940,1906
3023049256,390000,3,1,1240,11108,1,1240,0,1952
4019301500,507000,3,2.25,2210,11585,1,1510,700,1958
0402000115,263500,3,1.75,1540,6273,1,770,770,1951
9206950110,369000,3,2.5,1320,1683,2,1270,50,2004
8106300820,500000,3,2.5,3040,5326,2,3040,0,2008
8082400011,570000,2,1,910,4301,1,910,0,1923
7137960110,284000,4,3,2040,7145,1,1490,550,1994
0546000820,415000,2,1,980,4108,1,980,0,1947
3330500705,197500,3,1,980,3090,1.5,980,0,1903
1454600266,925000,4,3.75,4420,9492,2,3420,1000,1962
3335000025,468000,3,2,1570,6300,1,820,750,1953
1454100056,355000,3,1,1600,5001,1.5,1080,520,1930
5035300090,639000,4,1.75,1830,6000,1,930,900,1939
7504050090,720000,3,2.5,2820,14250,2,2820,0,1991
0408100110,381000,3,1.75,1800,6000,1,900,900,1950
5701700011,1.05e+006,3,4,4380,42769,2,4380,0,1983
3629970930,670000,3,3,2980,3730,2,2980,0,2005
7017200110,400000,3,1,1690,6658,1,1690,0,1942
4054500590,910000,4,3.5,4040,50479,2,4040,0,1987
2126059048,294000,3,1,1250,9427,1,1250,0,1931
0984200590,315001,3,1.75,1500,10230,1,1500,0,1968
9353300090,360000,3,2,1630,10723,1,1630,0,1959
0007600057,520000,3,2,1410,2700,2,1410,0,1902
2919701944,474000,3,1,1140,4560,1,770,370,1944
7202341110,702000,4,2.5,3280,5876,2,3280,0,2004
1122069019,728000,4,3.5,3490,87497,2,3490,0,2001
1565950090,308000,4,2.5,2020,7277,2,2020,0,1993
1724069059,2e+006,5,4,4580,4443,3,4580,0,2004
4137000110,340000,3,2.5,2270,7917,2,2270,0,1986
7849200945,306500,2,1.75,1310,10200,1,1310,0,1947
2397101270,716000,3,2,1420,3600,1.5,1420,0,1904
2726059100,950000,4,3,2980,44431,2,2640,340,1981
7202331500,673200,5,3,4180,8561,2,4180,0,2003
0439000090,564500,4,2.25,1950,6000,1,1350,600,1961
7788000100,393000,4,1.75,1790,11801,1,1790,0,1974
8658300315,425000,5,1.75,1400,5071,1,1400,0,1916
1723049567,150000,3,1,1320,24684,1,1320,0,1979
0621069039,327000,4,2.25,1620,106722,1,1200,420,1980
6806300750,444900,4,2.5,3120,7448,2,3120,0,1998
1898900100,305000,4,2.5,2100,14773,2,2100,0,1998
2767603931,469000,3,3.25,1370,1194,3,1370,0,2004
6072400820,525000,3,1.75,1520,7875,1,1520,0,1969
1922059396,330000,3,2.5,2410,17424,1,1630,780,1978
8818900300,618000,4,1,1260,4080,1,1260,0,1911
9264910900,295500,4,2.5,2830,7350,1,1690,1140,1982
3223039013,567035,3,2,2064,46173,2,2064,0,1903
5561300750,518000,4,2.25,2640,34870,1,1770,870,1977
9407111220,303000,2,1,1020,9200,1,1020,0,1978
1332200110,300000,4,2.5,2200,8065,2,2200,0,1998
2207200820,413107,3,1.5,1420,7520,1,1420,0,1956
3362400615,400000,3,1,1350,3090,1.5,1350,0,1914
3013300017,535000,3,1,1290,6859,1,1290,0,1941
1982200015,555000,4,2,1680,2600,1,840,840,1915
7140700300,312000,3,2.5,2280,6386,2,2280,0,2008
9363600457,785200,3,2.25,1840,3500,1.5,1540,300,1910
1245001220,749000,4,2,2040,11850,1,1020,1020,1959
0723049333,285000,3,1.5,1490,10367,1,1010,480,1957
7853301220,425000,4,2.5,2440,5088,2,2440,0,2007
8665900336,360000,3,2,1930,15540,1,1260,670,1958
1591000015,260000,3,1,1200,6615,1,1200,0,1954
7972601270,369000,3,2,1550,8509,1,1150,400,1959
1221039156,275000,4,2.5,2180,11132,1,1620,560,1978
0993001332,407000,3,2.25,1430,1448,3,1430,0,2005
7748000025,575000,2,1.75,1230,5418,1,990,240,1949
7871500485,1.236e+006,3,1.5,1670,3852,2,1670,0,1928
1370802540,875000,2,2.5,2720,4913,1,1700,1020,1936
1839500115,320000,4,1.5,2220,6811,1,1270,950,1961
4389201064,810000,3,1.5,1520,9041,1,1520,0,1954
1545805820,274000,3,1.75,1590,7620,1,1090,500,1984
0273800100,239900,4,1.75,1480,9523,1,1120,360,1959
7663700654,450000,4,1.5,1860,7808,1,1080,780,1953
3751606513,263400,4,2,1360,60548,1,960,400,1960
0399000025,265000,3,1,1360,5967,1,1360,0,1954
7130300785,418000,4,3,2360,6250,1,1460,900,1960
3818700123,390000,3,2,2360,5737,2,2360,0,2003
7891600245,430000,3,2,1860,7500,1,930,930,1909
5556300076,1.4425e+006,3,2.25,2630,9705,2.5,2630,0,1987
3421069118,297000,2,1.75,1280,37373,1,1280,0,1996
7280300042,650000,4,2.25,2330,7220,2,1600,730,1988
9368700031,195000,2,1,720,18000,1,720,0,1950
3223069118,554000,3,3.5,3380,108900,2,2700,680,1999
2522029039,550000,3,2,3650,843309,2,3650,0,1991
7977200590,700000,3,1.75,1640,4590,1.5,1640,0,1951
3124089086,300000,4,1,1730,177657,1.5,1730,0,1948
1568100215,315000,2,1,1030,8576,1.5,1030,0,1952
5364200649,603000,3,1,1790,5250,1,1400,390,1943
2771601730,530000,2,1,840,3400,1,840,0,1924
7201800300,397500,3,1.75,1300,8480,1,1300,0,1969
7224500300,221000,3,1,1240,5250,1.5,1240,0,1904
3876312350,466000,4,2.25,2170,8050,1,1220,950,1976
0853000261,197500,3,1,1330,5412,2,1330,0,1905
7165700110,280000,3,3,1390,1080,2,1140,250,2006
5708500208,412000,2,1.5,1240,3873,1,860,380,1909
5014000215,454000,2,1,880,6731,1,880,0,1950
2126079014,540000,4,2.25,2540,228254,1,1450,1090,1990
5595900090,250000,5,1.5,2520,5753,1.5,1510,1010,1928
1445500100,900000,5,2.25,2510,35691,1,2510,0,1967
4270600025,245000,5,1.75,2020,7902,1,1220,800,1962
3546000490,290000,3,1.75,2060,7251,1,1350,710,1987
0423049067,160000,2,1,930,7742,1,930,0,1933
9272201250,1.26e+006,2,1.5,2700,7225,1.5,1660,1040,1910
3226049184,325000,2,1,1060,6050,1,940,120,1939
5381000082,185000,2,1,670,6750,1,670,0,1947
0475000750,477000,3,2,1750,4990,1,950,800,1916
1900000195,100000,2,1,930,7623,1,930,0,1942
5162100820,345000,4,2.5,2420,11481,1,1370,1050,1985
6113400047,530000,4,2.25,2410,14985,1,1950,460,1965
7460000015,203000,3,1,1150,7156,1,1150,0,1953
7202340820,599000,4,2.5,2480,5000,2,2480,0,2004
5393601690,370000,4,1,1310,6000,1.5,1310,0,1940
7686203275,140000,3,1,1240,8000,1,1040,200,1954
2490200165,500000,3,1,1150,5100,2,1150,0,1911
0597000195,527200,3,1.75,1460,4000,1,730,730,1929
5119010090,549900,5,2.75,3060,7015,1,1600,1460,1979
1873100490,760000,4,2.5,3520,8095,2,3520,0,2006
3336001911,319000,2,1,960,4400,1,960,0,1951
1922059445,362300,3,2.5,2430,15264,2,2430,0,1997
7203600750,421000,3,2.5,1930,4505,1,1440,490,1973
6021503740,690000,3,1,1090,4000,1.5,1090,0,1945
3324069058,640000,3,2.5,2790,31798,1,1650,1140,1953
7345310100,238000,4,1.75,1650,6900,1,910,740,1978
6398000011,789000,3,3,3740,39640,2,3740,0,1991
5460600110,1.05e+006,6,4,5310,12741,2,3600,1710,1967
9478500590,302500,3,2.5,1690,4476,2,1690,0,2008
8645501091,259950,4,1.75,1400,7920,1,1400,0,1963
8099800590,456000,3,1.5,1440,28516,1,1440,0,1975
0339600090,369950,3,2.5,1360,3718,2,1360,0,1987
3522029031,363750,3,1.75,1726,197326,2,1726,0,1982
0725079058,585000,3,1.75,2220,216493,1,2220,0,1989
0104530110,268000,3,2.5,1850,6676,2,1850,0,1986
6852700246,1.2e+006,5,2.5,2860,4000,2,2160,700,1910
2124700015,345000,3,1,1120,10176,1,920,200,1905
8665900291,539000,4,2.5,2340,19850,2,2340,0,1993
8965500820,851000,5,3.25,3760,9792,2,2550,1210,1984
1024000100,900000,3,2.5,1920,7200,2,1780,140,1997
6132600165,850000,3,2.5,3230,5000,2,2430,800,1945
4040800090,390000,3,1.75,1260,6500,1,1260,0,1966
3432500215,345000,3,1.75,1540,6909,1,920,620,1955
3630030110,534500,3,2.5,1700,3150,2,1700,0,2005
9297300740,643500,6,5.25,3600,3960,2,2400,1200,1971
3592500866,1.2065e+006,3,2.75,3150,5520,1.5,2130,1020,1925
5019500215,495000,2,1.75,1280,4000,1,730,550,1929
3290800215,535000,2,1,980,4120,1,830,150,1950
7853230590,435000,4,2.5,2190,6578,2,2190,0,2004
1221000490,305000,4,2,2470,1831,2,1970,500,2009
5210200077,799000,4,2.5,2590,7910,2,2590,0,2001
3275880100,700000,4,2.5,2580,15031,2,2580,0,1999
2767704345,467000,3,2.25,1270,1213,2,1040,230,2005
1432701380,263000,3,1,1250,7560,1,1250,0,1959
1564000740,760000,4,2.5,4660,7157,2,3020,1640,2003
8141300300,293000,4,2.5,2019,4435,2,2019,0,2008
1388600110,245000,3,2,1490,7929,1,1490,0,1989
3523029059,181000,2,1.5,1560,10807,1,1560,0,1949
1061500110,240000,3,1,1030,15264,1,1030,0,1962
7555210100,880000,4,2.75,2560,7961,1,1450,1110,1975
9407150100,285000,3,2,1460,6377,1,1460,0,1995
6414100721,407500,2,1,770,6017,1,770,0,1950
4307340490,325000,4,2.5,1960,3543,2,1960,0,2004
4022900569,405000,3,1.75,1900,10454,1,1390,510,1978
2114700115,291700,3,2.5,1970,4120,1.5,1230,740,1927
2320069364,370000,3,2.5,2490,18525,2,2490,0,1995
4331400090,270000,3,1.5,1430,8960,1,1430,0,1953
3886902870,800000,4,2.5,2680,7200,1,1380,1300,1952
9136102680,626500,3,1.75,1610,3210,1,910,700,1928
2581900165,1.13e+006,4,3.5,4300,8406,2,3580,720,1987
3793501050,399950,4,2.5,3200,7545,2,3200,0,2003
0619000100,419000,3,1.75,2140,15030,1,1570,570,1958
4178700100,1.16e+006,4,2.5,4240,43995,2,4240,0,1989
3225059223,1.405e+006,4,3.5,3410,10769,2,3410,0,2008
3885805325,710000,4,2.75,2090,8064,2,2090,0,1967
4151800195,650000,3,1,1410,4840,1,1230,180,1942
1137300690,369900,4,2.5,2820,33750,2,2820,0,1984
0203600590,641000,4,2.5,2770,63118,2,2770,0,1997
7745500015,403000,3,1,1400,6879,1,1400,0,1951
1370802600,1.015e+006,3,3.25,3620,4000,2,2730,890,2005
5452800645,865000,4,2.5,2260,13600,1,1770,490,1974
1324049015,2.485e+006,4,2.5,3440,23954,1.5,2260,1180,1931
7645900165,810000,4,1,2150,3588,2,1850,300,1926
6798100652,316750,3,2.5,1256,1154,3,1256,0,2005
1023079147,652500,4,2.25,2220,130244,2,2220,0,1989
7972601250,360000,6,2.75,2850,15240,1,1850,1000,1962
0421000215,208000,2,1,700,5100,1,700,0,1953
4054520100,898000,4,2.5,3700,63991,2,3700,0,1992
3579700015,295000,4,1.75,1400,11934,1,1050,350,1961
9310300215,652500,4,1.75,3130,18253,2,3130,0,1978
3905081800,560000,4,3,2170,5764,2,2170,0,1992
7236100025,280000,3,1,1020,8400,1,1020,0,1957
2023049206,289950,3,2.5,1760,8584,1.5,1760,0,1937
3223059015,397500,3,2.5,1860,44093,1,1860,0,1978
1726069064,380000,2,1,1140,75132,1,1140,0,1956
1423089162,415900,3,2.5,1670,22703,1,1310,360,1988
8024201503,475000,2,1.75,1710,8645,1,1510,200,1923
0859000110,125000,1,1,500,7440,1,500,0,1928
2322059039,238000,3,1,1470,32670,1,1020,450,1958
2023049245,296000,4,1.5,1370,9750,1,1070,300,1953
0114100745,475000,6,3,3470,117612,1.5,3470,0,1924
2391601380,390000,3,2.25,1650,6250,1.5,1650,0,1910
2313900740,425000,3,1,1180,3750,1,1030,150,1940
9521101015,725000,6,3,3110,5000,1.5,1810,1300,1921
1036400110,605000,3,2.25,2080,12134,1,1530,550,1973
2572400100,302000,3,1,1600,1950,2,1600,0,1906
6821600300,886000,3,2.25,2380,6000,2,1650,730,1931
9547205225,540000,4,1.75,1630,6120,1,980,650,1918
3876312490,435000,4,2.25,1910,8400,2,1910,0,1975
1591600044,409000,4,3.25,3140,10752,2,2300,840,1992
7201800090,405000,3,1,1250,7280,1,1250,0,1975
4221270100,560200,3,2.5,1990,3984,2,1990,0,2004
2473410690,324000,4,1.75,2110,7208,1,1170,940,1975
7300410110,390000,4,2.5,2490,8290,2,2490,0,1999
7224500090,414000,2,1,800,5000,1,800,0,1938
7852000110,441500,3,2.5,2360,4670,2,2360,0,1998
4302200590,375000,3,2.5,1770,5146,2,1770,0,1992
8635750090,668500,4,2.5,2710,5500,2,2710,0,1999
1133000100,540000,5,1.5,1940,10202,1.5,1940,0,1940
7631800025,1.035e+006,4,3.25,3450,11240,2,2430,1020,1960
2998800110,1.345e+006,4,3.25,3440,4920,2,2520,920,2014
2432000110,758000,4,2.75,2410,9549,1,1780,630,1956
0824059140,949880,4,2.25,2290,10687,2,2290,0,1978
4229400015,570000,3,1,1030,4089,1.5,1030,0,1927
7805450110,736000,4,2.5,2290,12047,2,2290,0,1988
9839301055,670000,3,1.5,1490,4400,1.5,1490,0,1906
9471201110,1.13e+006,4,1.75,2370,8400,1,1270,1100,1949
1189000645,650000,4,2,1930,3976,1.5,1930,0,1914
6788201015,690000,2,1.75,1600,4000,1,850,750,1918
0425069147,610000,4,2.25,2240,45738,2,2240,0,1988
9268200600,413500,2,1,770,4000,1,770,0,1924
9201000100,765000,3,2.5,2300,9752,2,2300,0,1968
4140930110,828200,4,2.75,3400,7081,2,3400,0,2001
7226000110,205000,2,1,900,4397,1,900,0,1918
4358700100,465000,3,2.5,1450,5175,1,1030,420,1995
2228900195,556000,4,2.5,2240,5402,2,2240,0,2005
3905100740,540000,4,2.5,1780,4169,2,1780,0,1994
3295900490,423000,4,2.5,2320,4254,2,2320,0,2004
7379700051,375000,3,1.75,1590,14766,1,1590,0,1963
7348200195,173250,3,1,990,12696,1.5,990,0,1936
4047200300,599900,3,1.5,2605,12030,1,1355,1250,2003
4242900215,646000,5,2.75,2870,4461,1,1650,1220,1976
7851980100,1.075e+006,5,4.75,5180,17811,2,4070,1110,2001
9126101645,558000,4,2,2180,3870,1,1020,1160,1900
2695600375,354000,2,1,850,5225,1,850,0,1949
6648150090,1.195e+006,4,4,4050,9517,2,3360,690,1990
1189000245,670000,4,2,2250,4200,1.5,1650,600,1909
1169000057,1.125e+006,6,4.25,3100,9378,3,3100,0,1978
4013800131,267500,2,1,1747,12250,2.5,1747,0,1948
1787270090,299800,4,2.5,2410,4708,2,2410,0,2002
4037200735,430000,4,1.75,2070,9120,1,1250,820,1958
4083302370,775000,5,1,1860,3040,1.5,1530,330,1921
4319200820,333000,3,1,950,5214,1,830,120,1944
7663700551,336000,3,2,1060,11765,1,1060,0,1951
6821102350,323000,2,1,880,1712,2,880,0,1945
0723069089,575000,4,2.5,2550,56628,2,2550,0,2001
8165500110,328000,2,2.25,1550,2079,2,1550,0,2008
8081900195,572500,3,1,1590,4600,1.5,1290,300,1926
2878601425,600000,3,1.75,1650,5100,1,1040,610,1908
5104512070,412000,4,3,2430,7242,2,2430,0,2003
3885802970,827500,3,2.5,1810,7200,1,1310,500,1960
3021049140,300000,4,2.5,2890,17349,2,2890,0,1994
5249801720,415000,3,2.5,1280,5040,2,1280,0,1985
2025049006,750000,7,2.75,3410,4056,1.5,2130,1280,1906
7575700015,800000,3,2.75,2220,4000,2,1700,520,1914
2724049146,420000,3,1,1060,6000,1,1060,0,1954
8074200100,266000,3,1.5,1120,8250,1,1120,0,1957
1517900100,499000,4,2.5,2680,10590,2,2680,0,2004
2391602250,440000,4,1.5,1770,5750,2,1770,0,1947
7635801311,495000,3,2,2950,12196,2,2310,640,1918
3362401295,630000,2,1.75,1260,5300,1,840,420,1951
3303230110,424000,3,1.75,1430,6818,1,1430,0,1972
1522600100,760000,4,2.5,2730,36183,2,2730,0,1986
6646200090,650000,4,3.5,3270,15704,2,2110,1160,1990
2522059112,248500,4,1.75,1720,10018,1,1720,0,1960
3205100110,379600,3,1.75,1270,12420,1,1270,0,1962
6414100025,538000,4,2.5,3260,10032,1,1960,1300,1978
3529000930,530000,4,2.5,2050,6360,2,2050,0,1988
4141400100,545000,4,2.25,2050,9720,2,2050,0,1967
9562200090,925000,4,3,3580,35261,1.5,3580,0,1985
7399800110,565000,4,2.75,1960,48787,1.5,1960,0,1983
6917700356,405100,2,1,840,3522,1,840,0,1947
4040800600,502000,3,1.75,1300,8800,1,1300,0,1963
3629920300,425000,3,2.25,1260,3000,2,1260,0,2003
8944290090,233500,3,2.25,1650,2958,2,1650,0,1985
8091410930,287000,3,2.5,1710,10341,2,1710,0,1986
3313600266,190000,3,1,1180,8775,1,1180,0,1966
9508850100,666000,3,2.25,2780,31510,2,2780,0,1979
3330501545,330000,2,1,950,3090,1,950,0,1909
0031000165,1.49e+006,5,3.5,3620,7821,2,2790,830,1958
4123810090,393000,3,2.25,2140,10256,2,2140,0,1987
1180500100,353000,4,2.75,1920,4627,1,1010,910,1998
7549801140,260000,2,1,750,6720,1,750,0,1916
7254000100,680000,3,2.5,2060,2551,2,1900,160,2001
0644200090,921000,3,2.25,2380,11200,1,2380,0,1963
5101407305,319000,2,1,750,6380,1,750,0,1949
6817801030,280000,3,1,1160,10881,1,920,240,1983
7454001280,220000,3,1,1050,6300,1,1050,0,1942
8651440740,219000,3,1.5,1740,5200,1,1060,680,1977
1954430190,528000,4,2.75,2050,7171,1,1540,510,1988
4292300010,405000,3,1.75,1980,8100,1,1310,670,1949
8929000290,372977,3,2.5,1690,1618,2,1150,540,2014
1250201680,934550,4,3.25,2320,5900,1.5,2320,0,1910
0868001705,1.465e+006,3,1.5,2480,9900,2,2130,350,1940
1370801585,975000,4,2.25,2290,5350,2,2120,170,1958
7501000130,800866,5,2.5,3180,13806,2,3180,0,1990
4178300130,950000,7,3.5,3470,16264,2,3470,0,1980
7550801206,624000,4,3,1540,4140,1.5,1540,0,1902
9201300050,1.85e+006,5,2.25,2800,8442,2,2800,0,1963
3816300095,310000,3,1,1050,9876,1,1050,0,1953
7399301100,315000,3,1.75,1480,6800,1,1480,0,1968
4151800470,675000,3,2,1010,5973,1,1010,0,1942
7811000020,490000,3,1.75,1660,8208,1,1660,0,1965
5166700050,600000,5,2.25,2760,6350,1,1380,1380,1958
4045500130,154000,2,1,1040,20524,1,1040,0,1949
2927600675,480000,4,1.75,2220,6500,2,2220,0,1964
7686202580,196900,3,1,1270,7500,1,1270,0,1954
5690500095,735000,3,3.25,2960,39370,2,2960,0,1989
3876540630,205500,3,2,1330,8748,1,1330,0,1986
8929000170,357186,2,1.75,1210,1040,2,1210,0,2014
2621400080,275000,4,2.5,2120,6754,2,2120,0,1998
8154100020,248500,3,1.75,2090,12026,1,2090,0,1948
8097000190,350000,3,2.5,2680,7836,2,2680,0,1990
2624089181,390000,4,2.75,1790,47250,1,1220,570,1987
8718500275,390000,3,2.75,1950,12240,1,1250,700,1956
3575305495,660000,5,2.25,3740,14913,1.5,3740,0,1979
0411100020,310000,3,1.75,1140,8263,1,1140,0,1950
9113200020,717000,3,2.5,2480,5137,2,2480,0,2000
2011400019,260000,5,2.5,2580,11250,1,1410,1170,1964
3912000020,745000,3,2,2290,5001,1,1490,800,1960
8078370010,470000,4,2.5,2320,12042,1,1320,1000,1975
5104650020,429000,3,2.5,2530,8820,2,2530,0,1997
7417700664,220000,4,2,1400,7140,1,1400,0,1969
2770604920,497000,3,3,2060,1850,2,1400,660,2007
1930300190,716100,3,1,1640,4000,1.5,1640,0,1909
3024079069,371000,4,1,1960,94525,1.5,1960,0,1979
0723069049,379000,5,2.75,3000,25175,1,1500,1500,1961
2210500019,937500,3,1,1320,8500,1,1320,0,1954
3856901435,720000,4,2,1760,4500,1.5,1760,0,1906
3948900050,616000,3,3.25,2130,2306,2,1420,710,1924
5412400170,259000,3,2,1390,7120,1,1390,0,1988
2856102280,538000,3,1.75,1400,3825,1.5,1100,300,1904
3288100290,605000,3,2.75,3230,9576,1.5,3230,0,1966
5145000190,369950,3,1,1110,7603,1,1110,0,1967
6679000170,310000,3,2.5,1670,4220,2,1670,0,2002
9536601045,227500,3,1,1540,9450,1,1540,0,1960
8731981410,274000,4,2.25,2090,7400,1,1670,420,1973
3574801350,410000,3,2,1410,8088,1,1410,0,1987
1922069099,354800,3,2,1370,78408,1,1370,0,1964
0871001735,650000,4,2.25,1910,5120,1,1300,610,1954
2022059308,353000,3,2,1678,13862,1,1678,0,1994
2525300480,224975,3,1,960,12745,1,960,0,1977
7979900440,600000,2,1.75,2080,13054,1,2080,0,1951
2558660290,437500,3,2.25,1790,7700,1,1340,450,1976
8650300190,567000,3,2.5,2540,6093,2,2540,0,1999
8643000225,225000,5,1.5,1790,11656,2,1790,0,1963
1105000233,255000,2,1,940,9330,1,940,0,1941
9831200500,2.479e+006,5,3.75,6810,7500,2.5,6110,700,1922
0945000250,370000,2,1,900,4600,1,900,0,1951
4101410050,675000,4,1.75,1900,8800,1,1140,760,1975
1571100130,285000,3,1,1440,4268,1,1040,400,1953
7932000078,310000,3,1.75,2070,37904,1,1420,650,1973
2592400170,475000,4,2.5,2240,7245,1,1140,1100,1972
2517010630,410000,4,2.5,3320,5034,2,3320,0,2006
6926700225,895000,4,2.25,1950,5950,1,1330,620,1947
8820902905,375000,3,1.5,1240,7733,1,790,450,1941
5104510190,349000,4,2.5,1830,4694,2,1830,0,2003
9839301060,650500,3,1.75,1740,4400,1.5,1740,0,1903
2425700005,760000,3,1.75,1410,15120,1,1410,0,1950
9276201190,480000,4,2.75,2050,3960,1,1180,870,1986
8644210050,689000,4,2.75,3220,16145,2,3220,0,1993
2741100280,415000,3,1.75,1960,5000,1,980,980,1911
2891000680,195000,3,1.75,1070,6110,1,1070,0,1968
7366100080,318000,5,2.5,2820,9956,1,1410,1410,1967
3211270170,404000,4,3,4060,35621,1,2030,2030,1989
3330500920,339950,2,1,800,3090,1,800,0,1925
5437820080,215000,3,1,1260,7897,1,1260,0,1979
8097000380,339900,3,2.5,2420,7423,2,2420,0,1990
2591010290,285000,1,1.5,810,3211,2,810,0,1982
1324300380,550000,3,1,1600,5000,1.5,1110,490,1947
3226049478,430000,4,1,1350,9000,1.5,1350,0,1964
7941500170,219000,3,1,970,7790,1,970,0,1967
7522500005,555000,2,1.5,1780,4750,1,1080,700,1947
1545801630,233000,3,2,1350,7686,1,1350,0,1989
5151600480,248000,3,1.75,1840,19501,1,1270,570,1972
2731600080,454000,5,2.25,2550,9200,1,1580,970,1975
2804600010,950000,4,2.5,1700,4418,2,1700,0,1931
8899210680,359000,3,2.5,2430,7857,2,1730,700,1980
6649300190,407500,5,2,2740,8230,1.5,2210,530,1962
1312200080,224000,3,1.5,1560,7300,1,1040,520,1964
1721801025,210000,2,1,1040,4590,1,1040,0,1954
7942200050,261000,4,1.75,1820,9824,1,1820,0,1968
9528100963,719000,3,3,1833,1706,3,1833,0,1998
9297301495,440000,3,2.5,2160,3738,2,2160,0,1994
0192300020,525000,3,2.75,2100,10362,2,1510,590,1998
9477100170,375000,3,1.5,1370,9720,2,1370,0,1968
6705120280,428000,2,2.5,1414,1960,2,1414,0,1986
7203220050,988830,5,3.25,4115,7910,2,4115,0,2014
6858700225,199950,3,1.75,1550,6225,1,1550,0,1949
8712100605,840000,4,2.25,2100,3671,1.5,1750,350,1929
5702380500,285000,3,1.75,1160,7006,1,1160,0,1992
6181430280,330000,5,2.5,3597,4972,2,3597,0,2006
7138000170,147500,3,1.5,1230,10125,1,1230,0,1960
6669010290,320000,4,2.5,2190,7125,2,2190,0,1978
5706200280,382500,3,1.75,1040,9000,1,1040,0,1967
1338300170,2.048e+006,5,4,4690,8208,2,3040,1650,1926
8562800250,596000,4,2.25,2270,10000,1,1720,550,1974
0109210280,220000,4,2.25,1950,7280,2,1950,0,1979
3216900080,325000,3,2.5,1880,6818,2,1880,0,1993
0629500170,679950,4,2.5,2850,5664,2,2850,0,2001
5272200005,175000,2,1,1160,6911,1,1160,0,1947
7205000080,268000,3,1.75,1370,10050,1,1370,0,1966
1117200170,715000,4,3.5,3260,110579,2,3260,0,1997
5561300480,600000,7,2.25,3170,36384,2,3170,0,1969
6896300380,228000,0,1,390,5900,1,390,0,1953
3293400010,950000,5,2.5,3450,35880,2,3450,0,1992
3421059049,475000,2,1.75,1490,224334,1,1490,0,1983
0524069049,700000,3,1.5,1460,78408,1,1460,0,1963
1524079093,275000,3,1.75,1300,20700,1,1300,0,1962
1524079093,369500,3,1.75,1300,20700,1,1300,0,1962
3832710680,215000,4,2,1540,7575,1,1040,500,1978
0686200840,593450,4,2.25,2130,7172,2,2130,0,1964
8682310460,498800,2,1.75,1350,4614,1,1350,0,2008
0446000190,849000,5,3.25,2450,6534,2,1770,680,1951
8805900430,1.15125e+006,4,2.5,1940,4875,2,1940,0,1925
3629921060,825000,5,2.5,2890,5110,2,2890,0,2003
8856890020,265000,3,1.75,1680,9769,1,1340,340,1989
2115510470,285000,4,2.25,1960,10400,1,1220,740,1985
1545803890,240000,3,1.75,1590,7931,1,1190,400,1979
3322049126,261000,4,1,1390,17739,1,1390,0,1958
6669020500,330000,4,1.75,2440,7350,1,1610,830,1978
3832710840,250000,4,2,1850,7560,1,1540,310,1978
7212651950,350000,4,2.5,2800,9538,2,2800,0,1993
1331900020,930000,3,2.5,3780,35273,1.5,3780,0,1986
7140200380,275000,3,2,1910,8050,1,1000,910,1980
7972601235,325000,4,2.25,2460,7620,1,1230,1230,1969
2848700585,255000,1,1,810,5000,1,590,220,1936
6132600380,562200,3,1.5,1900,5250,1,1500,400,1943
2424059127,952000,2,1.75,3490,88909,1,2320,1170,1980
2591830130,365000,3,2.5,2200,7350,1,1570,630,1988
1771100130,332900,3,1.5,1190,11996,1,1190,0,1969
8856700190,721000,3,2.25,2040,18360,2,2040,0,1983
7852040080,487275,4,2.5,2400,3986,2,2400,0,1999
5648600190,310000,3,2.5,1670,5791,2,1670,0,1995
4154300275,245000,2,1,990,4800,1,990,0,1908
5438000280,325000,3,1.75,2920,10573,1,2920,0,1964
9201000480,550000,3,1.75,1840,9401,1,1840,0,1971
1604600660,350000,2,1,910,4500,1.5,910,0,1906
0522069022,599000,5,2.5,2950,72309,2,2950,0,2006
4331400190,259950,3,1.5,1240,9500,1,1240,0,1955
9407150130,240000,4,2.5,1980,7264,2,1980,0,1996
2212900470,186000,3,1,1200,10080,1,1200,0,1969
6600220080,395000,3,1.5,1280,15028,1,1280,0,1982
9558050020,475000,4,2.5,3150,5757,2,3150,0,2004
8691300420,815000,5,3.5,3500,10794,2,3500,0,1996
5450300010,572000,3,1.5,1680,13751,1,1680,0,1951
0339600460,419500,3,2.5,1360,3188,2,1360,0,1986
9264910920,298700,3,2.25,2110,7350,1,1530,580,1980
0121029034,549000,2,1,2034,13392,1,1159,875,1947
2123049420,278000,3,1.5,1900,9994,1,1120,780,1960
7950302890,455000,4,2,2380,4500,1.5,1470,910,1926
6117500430,925000,5,3.5,4050,13495,1,2230,1820,1988
1972200660,465000,2,1.5,1120,1201,3,1120,0,1999
3629830050,620000,4,4,2850,2970,2,2120,730,1999
9257900010,499900,4,2.25,2360,7650,1,1640,720,1963
6072000440,620000,5,3,2540,11422,1,1270,1270,1962
6844702630,450000,3,1.75,1160,6120,1,1040,120,1941
3630090050,690000,4,3.5,2710,2147,2,2220,490,2007
9809000020,1.895e+006,5,2.25,3120,16672,2,3120,0,1969
9809000020,1.94e+006,5,2.25,3120,16672,2,3120,0,1969
5021900050,832500,3,2,1870,9527,1,1870,0,1951
1003600080,245000,3,1,1010,9678,1,1010,0,1955
7701960130,820000,3,2.5,2980,18935,1.5,2980,0,1990
2395710020,369000,4,2.75,2420,6495,2,2420,0,2005
7203230010,1.05e+006,4,3.25,3830,8331,2,3830,0,2014
9830200380,653000,3,3,3040,5067,3,3040,0,1993
9407111100,220650,2,1.75,1460,10500,1,1460,0,1980
9572000080,300000,5,3,1940,6355,1,1200,740,2007
3629870420,970000,4,3.5,3780,20023,2,3780,0,2001
2459970020,360000,4,2.5,1950,5451,2,1950,0,2004
5547700190,672500,3,2.5,2450,5760,2,2450,0,2000
0421000285,268000,4,1.5,1730,7020,1.5,1730,0,1953
3277801640,440000,4,1.5,1690,3245,1.5,1690,0,1929
1250203070,1.4e+006,3,2.5,2550,7200,2,2550,0,1981
8077200470,590000,4,2.5,2290,11072,2,2290,0,1986
0302000545,359000,4,2.25,2710,22860,1,1850,860,1962
9542801990,266500,4,1.75,1880,7632,1,1180,700,1978
3343901403,635000,4,2.5,2930,8679,2,2930,0,2014
1121059030,559000,3,2.5,3110,217800,2,3110,0,2001
9290850950,895000,4,2.5,3480,38985,2,3480,0,1989
1136100006,625000,2,1.5,1110,118047,1,1110,0,1961
7923300285,650000,4,2.25,2440,9320,1,1880,560,1957
1823059028,312500,4,1.75,2280,7840,1,1280,1000,1957
8864000440,225000,3,1,900,6099,1,790,110,1944
9512500680,425000,4,1.75,1980,8400,1,1330,650,1968
3421069120,329999,3,2.75,3360,41250,1,1820,1540,1988
4376700430,572000,5,2.25,2340,9225,2,2340,0,1973
8562890430,386500,4,2.5,3110,5048,2,3110,0,2002
0452002005,452000,2,1,980,5000,1,980,0,1904
7228500094,278000,4,2,1480,6324,1,1480,0,1943
8078700020,474900,3,2.25,1800,43647,1,1800,0,1976
5035300255,450000,2,1.75,2130,6574,1,1500,630,1946
9528104985,611000,2,1,1270,5100,1,1100,170,1900
7237590010,214100,2,2.5,1150,2064,2,1150,0,2004
3158500250,317000,3,2.5,1840,5011,2,1840,0,2012
0868001402,1e+006,4,3.5,3180,12528,2,2060,1120,1979
5606000233,1e+006,5,2.75,1510,5700,2,1510,0,1946
5214500660,525000,4,2.5,3070,7200,2,3070,0,2005
3578110020,436000,3,2.25,1800,6680,2,1800,0,1983
3578401330,450000,3,1.75,1540,9154,1,1540,0,1983
7525000080,588500,3,1.75,2330,14892,1,1970,360,1980
4273000095,340000,4,1.75,1400,8374,1,1400,0,1953
4014400190,482000,4,2.5,2846,85377,1.5,1976,870,2000
8678500020,1.575e+006,4,3.5,5830,131116,2,5830,0,2005
6918700130,749000,3,2.5,3380,7126,2,3380,0,1965
2473350470,330000,3,1.5,1440,7875,1,1440,0,1968
9274200314,568000,3,2.5,1740,1279,3,1740,0,2008
2938100010,239000,3,1.75,1470,8925,1,1470,0,1957
8564950250,528000,3,2.5,2810,4932,2,2810,0,2003
3438502715,385000,4,3,2090,5102,1,1350,740,1994
0280610020,825000,4,3.25,4110,14219,2,2570,1540,1979
2487200938,815000,5,3.25,3230,5000,2,2350,880,2002
1775500362,625000,4,2.5,2601,34335,2,2601,0,1995
2483200010,690000,3,1.75,2070,6000,1,1340,730,1955
4365700130,210000,3,1,1660,7440,1,1270,390,1957
9136101271,599000,4,1,1590,4280,1.5,1590,0,1924
1370804295,860000,3,1.75,1860,5584,1,1310,550,1951
0422049178,147200,3,1,1420,9600,1,1420,0,1954
9161100795,476900,3,1,1240,5758,1.5,960,280,1910
5561300380,450000,4,2.5,2500,36254,1,1590,910,1978
1443550020,570000,4,2.5,2640,11816,2,2640,0,1999
9547201155,567500,3,1,1440,3060,1.5,1440,0,1910
3625059120,790000,5,3.25,3030,20446,2,2130,900,1976
0644000185,875000,3,1.5,1820,12686,1,1820,0,1952
5710500010,490000,3,2,2220,10275,2,1640,580,1980
2482410130,335000,3,1.75,2430,9133,1,1410,1020,1978
6071900130,550000,3,1.75,1670,10798,1,1670,0,1962
6817800630,385000,3,1.75,1180,10541,1,940,240,1981
6204400130,395000,3,1.75,1620,8085,1,1210,410,1976
9274203190,650000,2,1,1030,5750,1,1030,0,1928
0293610020,637000,4,2.75,2900,5803,2,2900,0,2007
3583400130,692500,3,2.25,3420,9900,1,1710,1710,1963
7230400430,322400,3,1.75,1710,15844,1,1710,0,1964
7140600190,233500,3,1.5,1580,10517,1,1580,0,1957
6817801410,400000,3,2,1230,11413,1,990,240,1984
6430500010,547000,5,2.5,2200,4080,1.5,1420,780,1916
3023049215,519000,5,2.25,2570,13054,1,1470,1100,1950
3625710080,1.025e+006,4,3.5,3320,19850,1,2040,1280,1977
3390600010,365000,3,1,1090,6435,1,1090,0,1955
9238480020,699000,5,2.75,2970,36817,2,2970,0,1978
1036000080,525000,3,1.75,1970,8000,1,1970,0,1968
1561930020,430000,4,3,3220,8936,2,2450,770,1990
3876100080,325000,3,1,1600,7500,1,1600,0,1966
7454000605,279000,2,1,670,6300,1,670,0,1942
1870400635,805000,4,1.75,2360,4750,2,1660,700,1911
8820900299,419950,3,3,2150,3962,1.5,1540,610,1949
8132700185,425000,2,1,620,4455,1,620,0,1927
6413600275,446000,4,1.75,1730,5922,2,1730,0,1949
2888000020,455000,5,2,2500,7860,1,1040,1460,1963
3298700426,226550,3,1,990,4440,1,990,0,1943
3362401815,764000,3,2,1420,4080,1.5,1420,0,1904
5469500020,439950,3,2.25,2170,15000,2,2170,0,1978
6430000280,453000,4,2,1880,5100,1,1880,0,1952
1140000190,219950,3,1,1300,9620,1,1300,0,1971
8021700715,702500,3,1.5,2360,6750,2,1930,430,1926
5151600170,285000,3,1.5,1780,12231,1,1780,0,1956
8129700255,798750,2,2.25,2160,2578,3,2160,0,2005
9285800345,320000,2,1,950,5316,1,950,0,1948
5706200170,425000,3,1.75,1680,14630,1.5,1680,0,1985
5536500020,540000,4,2.5,2290,4450,2,2290,0,2004
0098000950,1.06e+006,4,5.25,4140,14757,2,4140,0,2005
3362401611,1.165e+006,4,3.75,3920,4500,3,3920,0,2013
6205500280,576000,3,1.75,1500,13891,1,1500,0,1951
7199330010,525000,3,1.75,1720,7200,1,1140,580,1977
1332200130,324950,4,2.5,2641,8615,2,2641,0,1998
3244500078,600000,3,2.5,4930,77536,2,3930,1000,1981
3342102880,464000,3,2.5,2460,5400,1,1520,940,2001
2557000630,266000,4,2.25,1995,7102,2,1995,0,1981
1117200190,775000,3,2.5,3010,74390,2,3010,0,1998
8122100130,415000,3,1.75,1270,4800,1,1270,0,1952
9558040050,550000,4,2.75,3080,6731,2,3080,0,2003
5702380630,235000,3,2.25,1670,7606,2,1670,0,1990
3300790670,280000,3,2,1470,8089,1,1470,0,1987
2558660190,459000,3,1.75,1730,7807,1,1260,470,1976
4388000460,195000,3,1,1070,7615,1,1070,0,1969
3224800010,235000,3,1.5,1660,8738,1,1080,580,1959
1672000020,711800,4,2.25,2410,16650,1,2410,0,1965
2767701416,440000,3,2.5,1040,1032,3,1040,0,2007
7821200307,515000,2,1,970,3300,1,970,0,1916
4219400290,1.2e+006,5,2.75,2910,9480,1.5,2910,0,1939
6072650290,560000,3,1.75,2340,12443,1.5,2340,0,1965
5647900670,340000,3,1.75,1880,11249,1,1330,550,1985
1965200010,600000,2,1,1110,3500,1.5,970,140,1912
0319500080,764000,4,2.5,2790,7938,2,2790,0,1997
9526500080,337000,4,2,1590,8779,1,1590,0,2001
7856410430,1.385e+006,6,2.75,5700,20000,1,2850,2850,1977
8128700005,249000,4,1,1200,7552,1,1060,140,1919
3444910020,350000,3,3,3200,35782,1,2360,840,1978
2025700130,269950,3,2.25,1510,6000,1,1150,360,1993
0224069134,735000,3,1.75,1880,108900,1,1880,0,1978
4217400305,1.295e+006,4,2.5,3070,4000,2,2070,1000,1940
3288301410,475000,4,2.25,2110,7560,2,2110,0,1974
9264950660,339000,3,2,2350,8459,1.5,2350,0,1989
6744700285,600000,4,3.5,3270,15160,1,1660,1610,1997
7750500275,397500,4,1.75,2220,4760,1,1320,900,1918
1125069153,1.525e+006,4,3.5,5990,111078,2,5990,0,2004
1425059178,460000,3,2,1760,9055,2,1760,0,1985
6671900130,370000,4,2.75,2200,5207,1,1120,1080,1951
3172600151,250000,4,1,1550,7296,1.5,1550,0,1957
7237550020,1.1e+006,4,3.75,5070,60123,2,5070,0,2000
1934800078,430000,2,2.25,1040,1516,2,1040,0,2008
4385700660,1.085e+006,3,1.5,2560,4000,1.5,1660,900,1927
0923000414,670000,3,1.75,1850,8160,1,1850,0,1952
2624049167,461550,3,1.5,2090,11895,1,1790,300,1954
8929000380,479990,3,2.5,2010,2386,2,1390,620,2014
4221250010,643000,4,2.5,2518,4663,2,2518,0,2005
8861500080,607000,3,2.75,2810,12813,2,2040,770,1988
1592000780,625000,3,2.5,2600,10092,1,2600,0,1984
2484200080,731100,3,2.5,2060,8778,1,1160,900,1953
2322059136,859000,3,2.5,2920,434728,2,2920,0,1999
2591820080,435000,4,2.5,2130,10375,2,2130,0,1986
5729000080,465000,3,3,2290,15600,1,1420,870,1948
5100402764,740000,3,1,1230,6380,1.5,1230,0,1927
5454000010,740000,3,1.75,2020,9478,1,2020,0,1961
5412300130,250000,3,2,1430,7280,1,990,440,1980
6873000190,656000,2,2.5,2270,1763,3,1820,450,2009
9485300190,300000,4,2.5,1910,8058,2,1910,0,1992
0326069132,643000,3,1.5,1780,214315,1,1780,0,1954
3832061060,311000,4,2.5,2690,6124,2,2690,0,2007
6918730130,360000,3,1.75,1330,7482,1,1330,0,1975
7952800010,475000,4,2.5,3060,10043,1,1700,1360,1968
3834500417,469950,3,3.25,1760,1778,3,1760,0,2008
5071700020,240000,3,1.75,1570,8750,1,1570,0,1960
3826000470,232000,2,1,960,8100,1,810,150,1936
0921059132,350000,3,2,1680,81893,1,1680,0,1991
1926059027,803000,2,1,1440,33747,1.5,1440,0,1928
1328320440,355000,3,2.25,1960,7000,1,1600,360,1980
1972202005,475000,4,2,1790,2250,1,840,950,1909
2592201350,823000,3,2.5,2560,9825,2,2560,0,1988
6430500293,395000,2,1.5,1010,3060,1,1010,0,1918
6450300840,499000,4,3.75,2560,5250,2,1900,660,1963
1189000225,420000,2,1.75,1200,3136,1,800,400,1904
7804700020,961500,3,2.5,3910,14000,2,3910,0,1999
9542300430,833000,4,1.75,2260,12238,1,2260,0,1967
1775930440,479000,3,2.25,2110,11319,2,2110,0,1978
1725059182,1.15e+006,4,2.5,3340,10422,2,3340,0,1996
3992700130,267000,3,1,1400,8100,1.5,1400,0,1944
0824069193,555000,4,1.75,1760,94525,1.5,1760,0,1988
3904910480,490000,3,2.5,2010,9725,2,2010,0,1987
2877102651,619000,4,2,2300,3400,1.5,1550,750,1915
9289100170,569950,5,2.75,2510,28185,1,1600,910,1963
3797000680,549000,3,2,1340,3000,2,1340,0,1905
3378900020,422500,3,1.75,1560,7245,1.5,1560,0,1962
4180300050,400000,4,3.5,3350,9681,1,2140,1210,1980
7852010670,692500,4,2.75,3710,7984,2,3710,0,1999
8562890280,310000,4,2.5,2430,5499,2,2430,0,2002
3991400080,499900,3,1.75,2430,8820,1,1630,800,1977
8651510020,492000,3,2.25,2100,7335,2,2100,0,1983
3924500130,460000,2,2.5,1880,40575,1,1880,0,1987
2533300130,800000,3,2.5,1630,2640,2,1630,0,1919
0510002995,832600,4,1,1640,4200,1.5,1640,0,1925
3825500080,470000,4,2.75,2310,7350,1,1670,640,1989
8682231190,542000,2,2,1930,4500,1,1930,0,2003
9412400185,1.3095e+006,4,4.5,4750,13912,2,3600,1150,2005
7893804790,308130,4,2.5,2300,7500,1,1650,650,1959
3630070010,310000,2,1,1050,2699,1,1050,0,2005
0723049132,235000,2,1,1500,8015,1,1500,0,1947
1432600415,215000,3,1,1150,7560,1,1150,0,1958
3306200010,210000,4,1.5,1920,10403,1,1370,550,1959
0425069102,730000,4,2.75,3660,150282,2,3660,0,1990
1683600130,245000,3,1.75,1720,9342,1,1140,580,1981
3741600020,540000,3,2.25,2100,20018,1,1470,630,1948
5412101150,299000,4,2.5,2400,6078,2,2400,0,2001
0509000020,510000,3,2.5,2540,40106,2,2540,0,1991
1311500020,198000,4,1.75,2080,7200,1,1050,1030,1966
0662350050,950000,5,3.25,3400,7452,2,3400,0,1999
3327020290,300000,4,1.75,2200,7600,2,2200,0,1978
1086100130,528000,5,1.75,2140,8580,1,1200,940,1962
2111011060,507000,5,3.25,3850,16249,2,3030,820,2002
7852090280,770000,4,3.25,4270,6384,2,3060,1210,2001
2873000780,255000,3,1.75,1340,7210,1,1340,0,1975
3530470190,220000,1,1.5,1100,3451,1.5,1100,0,1978
5014600440,690700,5,2.75,2870,5349,2,2870,0,2005
5049800005,447000,2,1,1320,8380,1,1320,0,1953
7443001470,755000,6,2,2150,4505,1,1270,880,1952
2771604640,700000,4,1.5,2470,6000,1.5,1480,990,1940
7140200280,250000,4,2.75,1910,7700,1,1000,910,1980
3793500780,320000,3,2.5,2130,6969,2,2130,0,2003
5525400420,565000,4,2.5,2240,14667,2,2240,0,1989
7986400305,754300,5,2.75,1800,4500,2,1680,120,1939
3619600143,650000,3,1.5,2160,9000,1,1400,760,1949
7787890050,529888,4,2.5,3140,8455,2,3140,0,2003
2780700050,432000,3,2.5,1920,9812,2,1920,0,2000
5595900280,235000,3,1,1050,7670,1.5,1050,0,1955
7203220130,994900,4,3.5,3695,6556,2,3695,0,2014
9406540130,489000,4,2.5,3910,8442,2,2710,1200,2000
9526600250,800000,4,2.75,3010,7427,2,3010,0,2010
9542900190,370000,4,1.5,1370,9957,1,900,470,1972
3840700653,436000,4,2.75,2080,9600,1,1240,840,1979
6084200080,395000,3,2.5,2250,3757,2,2250,0,2006
3705900130,377691,5,1.75,2120,8399,1,1320,800,1942
3333002385,370000,5,3,2220,5185,2,2220,0,2003
3904910050,515000,3,2.5,1440,4394,1,1440,0,1987
5556900080,169000,3,1,910,7686,1,910,0,1969
4443800415,475000,3,1,1270,4268,1,1270,0,1921
3791400250,420000,3,2.5,2480,6180,2,2480,0,1999
9551201585,1.297e+006,6,2.75,2630,9420,2,2510,120,1900
7856620050,822000,3,2,2410,13300,2,1840,570,1985
9320200050,1.5e+006,4,2.75,2930,25697,1,2310,620,1964
1954420380,485000,3,2.25,1570,6810,1,1180,390,1988
0740500010,270000,4,1,1900,8505,1,1200,700,1956
6673050020,300000,6,2.5,2590,11250,1,1390,1200,1978
1853081060,878000,4,2.5,3810,7728,2,3810,0,2007
6308000020,590000,3,2.5,2290,4203,2,2290,0,2001
1720800305,611900,1,2.25,1220,2100,2,1220,0,1946
1682000280,240000,3,1.75,1100,7373,1,1100,0,1968
3814800280,395000,4,2.5,2810,10951,2,2810,0,2003
3352402195,169000,3,1,890,7110,1,890,0,1957
9320600170,200500,3,2,1280,14972,1,1280,0,1963
5205000250,308000,3,2.5,2320,7140,2,2320,0,1990
9264920250,290256,3,2.25,1720,7885,2,1720,0,1983
2473101190,279950,3,1.75,1530,8800,1,1040,490,1967
5437820020,195000,3,1.75,1580,7875,1,1580,0,1979
4067600275,630000,3,1,1360,13000,1,1360,0,1945
6447300345,1.16e+006,4,3,2680,15438,2,2680,0,1902
3905100280,478000,3,2.25,1640,3896,2,1640,0,1994
9285800275,835000,3,2.25,2520,6690,2,1700,820,1944
1891100130,639000,3,2.25,1400,2421,2,1400,0,2005
1592000250,623000,4,2.75,2300,12633,2,2300,0,1984
2328800130,220000,3,1.75,1900,7680,1,1260,640,1959
6067910130,526000,3,2.25,2000,18099,1,1250,750,1978
3333002790,243500,2,1,900,5016,1,900,0,1948
9478400080,750000,4,2.5,2980,4930,2,2890,90,2000
3450300020,329000,4,2,1850,9126,1,1850,0,1963
2663000050,525000,4,1,1570,4000,1.5,1570,0,1920
3145600250,190000,2,1,670,3101,1,670,0,1948
6206100130,772650,4,2.5,2660,10800,1,2660,0,1955
8944320420,355000,3,2.5,2110,4038,2,2110,0,1989
0224069145,650000,3,1.75,1970,54450,1,1570,400,1980
3363900280,678500,3,2.75,1210,3600,1.5,1210,0,1910
7504110050,669950,4,2.5,2670,11877,2,2670,0,1996
0624100950,850000,3,2.25,3000,18450,1,3000,0,1983
9416400020,572000,3,2.75,2200,3885,2,2200,0,2002
3578400950,492450,3,1.75,1540,13002,1,1200,340,1984
4100000050,813000,3,1.75,2080,11866,1,2080,0,1960
3475000080,710000,3,2,1780,9732,1,1780,0,1967
7871500345,792500,3,1.5,1960,2400,2,1330,630,1911
8857600680,285900,5,1.5,1690,7725,1.5,1690,0,1961
2817100430,389000,3,2,2080,12972,1,1250,830,1981
7649400170,675000,3,2.25,2070,2833,2,1490,580,1966
4048400185,352000,2,0.75,760,33801,1,760,0,1931
3303960250,1.05e+006,4,3.25,4020,11588,2,4020,0,2000
2785000480,768500,4,1.75,3620,10400,1,1820,1800,1965
2926049400,500000,4,2,2330,7778,1,1230,1100,1961
5452302195,685000,3,2.5,1460,8800,1,1460,0,1956
3528900980,648475,4,2.75,2250,5700,1,1200,1050,1951
3886901795,655000,6,5,2850,6600,2,2850,0,1994
1868900675,895000,4,2.75,2640,4000,2,1730,910,1925
4031000290,195000,3,1,1310,9554,1,960,350,1962
9264960480,368000,4,2.5,2720,7350,2,2720,0,1989
3303980680,997000,4,3.5,3430,13609,2,3430,0,2001
1775930010,335000,3,2.75,1990,19991,1,1340,650,1977
3329520170,250000,3,2,1170,7258,1,1170,0,1984
9321010130,278500,3,1.75,1390,8980,1,1390,0,1985
7696600020,260000,4,1.5,1540,7300,2,1540,0,1973
2690600005,162500,2,1,760,6141,1,760,0,1920
0923049323,239000,4,1,1280,8316,1,1280,0,1950
6705870080,600000,4,2.5,2990,5122,2,2990,0,2004
3797710010,350000,4,2.25,1770,7778,2,1770,0,1998
0098030630,852500,5,3.75,3830,8131,2,3830,0,2005
8106300840,485000,3,2.5,2870,5490,2,2870,0,2008
1074100020,299000,3,1,1520,8320,1,1520,0,1953
0418000010,227450,2,1,660,6509,1,660,0,1952
1782000130,383000,3,1,1800,5612,1,1200,600,1942
2124079093,835000,2,3.25,3570,392475,1,2370,1200,1998
9828702890,760000,5,1.5,3050,2992,1.5,1920,1130,1931
3797001815,532500,2,1,820,3000,1,820,0,1924
6979900080,635000,3,2.5,3610,26359,1,1950,1660,1998
7319900345,438500,3,2,1490,3072,1,770,720,1912
4346300010,545500,3,2.5,1560,9361,1.5,1360,200,1936
2432000130,675000,3,1.75,1660,9549,1,1660,0,1956
9165100130,450000,3,1.75,1180,4080,1,760,420,1928
0844000425,199999,3,1,960,10815,1,960,0,1900
6076500364,375000,3,1.5,1630,16170,1,1630,0,1988
9238430430,600000,4,2.25,2260,43847,2,2260,0,1982
2854800095,292600,3,1.5,1520,7123,1,1520,0,1959
0031200020,1.038e+006,5,2.75,3050,8904,1,1650,1400,1956
5364200381,610000,3,1,1000,4959,1,1000,0,1945
1515910290,397450,4,2.5,2650,9451,2,2650,0,1993
3459000020,382000,3,2.25,1750,15528,1,1270,480,1963
3303000130,370000,3,2.25,1770,7667,1,1270,500,1966
3303000130,520000,3,2.25,1770,7667,1,1270,500,1966
3235100080,260000,2,1,770,7906,1,770,0,1948
7284900460,890000,4,2.5,3370,7200,2,3370,0,2014
6332940020,344000,5,2,2130,8412,1,1440,690,1946
8802400415,205000,3,1,1050,8498,1,1050,0,1958
4131500190,379000,5,2.5,2803,8550,1,2803,0,1963
7524400250,424240,3,2,2080,12094,2,2080,0,1982
7524400250,589950,3,2,2080,12094,2,2080,0,1982
4441300440,582000,4,1.75,2120,4650,1,1190,930,1951
1898200080,349000,3,2.5,2550,7709,2,2550,0,1989
1245003375,658000,3,1,1290,12005,1,1290,0,1966
3574300250,294000,5,2.75,1790,5000,1.5,1060,730,1915
5071400104,690000,5,3.5,2720,7598,2,1860,860,1993
9287801150,600000,3,1,1040,5000,1.5,1040,0,1912
8651431100,199990,3,1,840,5200,1,840,0,1969
0236500010,220000,3,1.75,1650,8850,1,1650,0,1959
1441800250,440000,4,2.25,2080,15750,1,1460,620,1976
8929000050,439990,4,2.5,1540,1994,2,1540,0,2014
0098030660,815000,4,2.5,3880,7208,2,3880,0,2006
3905100380,535000,4,2.25,1860,3766,2,1860,0,1995
1140000050,215000,3,1.75,1280,10016,1,1280,0,1975
5561000010,605000,3,2.5,3200,35012,1.5,2100,1100,1965
8856920250,349900,3,2.5,2200,7278,2,2200,0,1990
5100402668,495000,3,1,1570,5510,1,1070,500,1940
2426049180,515100,3,2.5,2074,4900,2,2074,0,1997
0205000010,620000,4,2.5,2450,55387,2,2450,0,1994
7504060020,657500,4,2.25,2520,10370,2,2520,0,1980
4204400098,250000,5,1.75,2190,8250,1,1190,1000,1963
4204400098,385000,5,1.75,2190,8250,1,1190,1000,1963
2131200766,307000,3,1.5,2320,7500,1,2320,0,1976
7760400480,288000,3,2.5,1370,9253,1,1090,280,1994
1863900225,226450,3,1.75,1730,7200,1.5,1730,0,1944
1787600224,390000,3,2.5,1640,6991,1,1110,530,1967
0323089134,350000,3,1,1300,10236,1,1300,0,1971
7663700759,368000,3,1.5,1560,7884,1,1060,500,1969
3856904970,469000,2,1,1120,4284,1,730,390,1921
1126059007,865000,3,2.25,2670,150270,2,2670,0,1985
2473002850,515000,5,2.5,3810,15916,1.5,3810,0,1967
1112700130,410000,3,1.75,1440,8560,1,1440,0,1979
0121059007,210000,4,1,1200,43560,1,1200,0,1968
2896600020,460000,3,1.75,1520,7700,1,820,700,1969
9264900660,241500,4,2.5,2500,9654,1,1830,670,1979
7754900280,322200,4,2.25,2010,19000,2,2010,0,1975
9282801950,279000,4,1,1210,6000,1.5,1210,0,1943
3123039063,303000,2,1,1100,27007,1,1100,0,1943
2770606915,420000,3,1.5,1050,6615,1,800,250,1950
5379804690,249000,3,1.75,2120,18335,1,1380,740,1961
6855700080,294950,3,1,1240,8840,1,1240,0,1952
3856900507,1.315e+006,4,3.5,3460,3997,2,2560,900,2004
3501600185,335000,3,1.75,1270,4800,1,1270,0,1953
1068000235,1.155e+006,4,2.25,2980,8051,1.5,2020,960,1935
7519000585,520000,2,1,1250,3708,1.5,1250,0,1926
1562200380,560000,4,1.75,1740,8800,1,1740,0,1965
7523700305,243400,4,1.5,1730,7464,2,1730,0,1959
8807810050,405000,3,2,1240,14404,1,1240,0,1988
3699100130,495000,2,1,1670,14695,1.5,1670,0,1930
2215901650,350000,4,2.5,2140,7095,2,2140,0,1992
1099900020,368500,5,2.75,2530,7601,1,1520,1010,1992
5128000010,99000,2,1,960,8236,1,960,0,1948
3303980660,1.07e+006,4,3.75,4130,12320,2,4130,0,2001
1155640050,430000,4,1.75,1710,7724,1,1710,0,1983
8087800020,412500,3,1.5,1490,8475,1,1490,0,1963
3293200190,1.1225e+006,4,3.25,4750,62365,2,4750,0,1988
1862000010,915000,4,2.5,3400,35062,2,3400,0,1988
5711200170,535000,3,2.5,2210,7620,2,2210,0,1994
8690800130,390000,3,1.5,1650,8676,1,1130,520,1979
2768100545,499000,3,1.5,1260,3135,1,780,480,1944
2596400050,375000,3,1,1960,7955,1,1260,700,1963
2641400290,349000,4,2.5,1800,7620,2,1800,0,1995
3210600010,635000,3,2.25,1940,7482,1,1240,700,1964
8691370290,682000,4,2.75,2820,8009,2,2820,0,2001
1790000080,321027,4,2.25,2820,16770,1,1920,900,1966
7116000425,150000,2,1,720,4120,1,720,0,1915
8143100500,410000,3,1.75,1640,17583,1,1110,530,1969
3735900545,449950,3,2,1560,4080,2,1560,0,1923
1443500305,194990,6,2.5,1560,7144,1,1060,500,1913
3649100103,475000,4,1.75,1910,8775,1,1210,700,1956
6746700605,530000,5,1.75,1570,3000,2,1570,0,1908
7999950020,319950,4,2.5,2038,7643,2,2038,0,2011
9211500010,210000,3,2.25,1720,9435,1,1220,500,1978
1324300290,485000,3,2.75,1670,3330,1.5,1670,0,1925
8691310380,774000,4,2.75,2830,10240,2,2830,0,1998
4037400430,478000,4,2,1690,8208,1,1210,480,1958
0254000545,385000,4,2.5,1620,5280,2,1620,0,1924
7214780020,595000,4,2.5,2360,43017,2,2360,0,1989
0114100314,285000,3,1.5,1480,7117,1,1170,310,1960
3629930170,723000,4,2.5,2700,4004,2,2700,0,2004
2946002140,279000,3,1.5,1780,16000,1,1240,540,1960
1432400525,195000,3,1.5,1430,7560,1,1430,0,1958
7011201470,625000,2,1,2160,2192,1,1170,990,1925
7697800170,270000,3,1.75,1800,9314,2,1800,0,1979
8682291630,559000,2,2,1930,5520,1,1930,0,2006
1775800420,474000,4,2.25,1960,14834,1,1330,630,1976
2215901310,303500,4,2.5,1920,7345,2,1920,0,1992
1440500020,350000,3,1.75,1470,8645,1,1470,0,1949
6632900574,367500,5,3,2980,10064,1,1680,1300,1940
6632900574,595000,5,3,2980,10064,1,1680,1300,1940
7933510080,589000,3,2,2360,118483,1,2360,0,1981
1926069063,585000,3,1.75,1790,87213,1,1790,0,1974
0973600020,482975,3,2.25,2130,8801,1,1370,760,1976
9558010190,365500,4,2.5,2030,4499,2,2030,0,2003
0267010020,570000,4,2,1790,7800,1,1790,0,1972
8097000170,335000,3,2.5,2260,8040,2,2260,0,1990
9136100420,767500,4,2,2350,4815,1.5,1450,900,1914
8929000280,386591,3,2.5,1690,1613,2,1150,540,2014
7883603190,279000,3,1,1320,5750,1.5,1320,0,1913
0203600470,620000,4,2.5,2690,32780,2,2690,0,1998
8643200020,407000,4,2.25,2810,23400,1,1710,1100,1958
0322069153,364250,3,2.5,2280,213879,2,2280,0,1994
2473450430,399000,4,2.5,2870,9292,2,2540,330,1979
7574910780,766950,3,2.5,3030,30007,1.5,3030,0,1992
3629980780,710000,4,2.75,2940,4232,2,2940,0,2004
3332000091,320000,3,1,1190,4120,1,1190,0,1929
3395041236,300000,3,2.5,1800,3253,2,1800,0,2001
2310030500,263000,3,1.75,1580,9187,1,1180,400,1993
8665050080,445000,3,2.5,1730,4408,2,1730,0,1996
4037000840,554000,3,2,1910,9001,1,1910,0,1957
2856101845,335000,2,1.75,1000,5100,1,940,60,1906
8078550250,307000,4,2.75,2520,6964,1,1260,1260,1987
1837000010,404000,3,1,1420,8160,1,970,450,1947
8691390280,775000,4,3.5,3080,5250,2,3080,0,2003
2372800050,220000,3,1,1060,9126,1,1060,0,1956
6600250050,518000,4,2.5,2160,9750,2,2160,0,1983
7215900020,1.6e+006,4,3.5,4060,9486,2,4060,0,2005
6450304600,315000,1,2.25,1940,2550,2,1100,840,1979
2541100050,572650,4,2.5,2250,11349,2,2250,0,1991
1853200080,350000,2,1,1620,9205,1,850,770,1921
3058600050,285000,2,1,920,5850,1,920,0,1900
3148750050,231000,3,2.5,1370,7247,2,1370,0,1995
8651400680,179000,3,1,920,5200,1,920,0,1969
4359100050,244000,3,1.5,1360,9625,1,1360,0,1963
5379806185,185850,3,1.5,1630,11662,1,1630,0,1943
1737300130,610000,6,2.5,3610,12033,2,3210,400,1970
2781200010,419000,4,2.5,3010,9155,2,3010,0,2005
0269000221,779000,3,1.75,2320,6400,1,1420,900,1957
6421100502,695000,5,3,3290,14134,1,1870,1420,2004
4136900190,319900,3,2.5,2040,7580,2,2040,0,1998
8731980680,329000,3,2.75,1920,7700,1,1320,600,1978
2095800250,475226,3,2.5,2120,4512,2,2120,0,1988
3629920630,638000,3,2.5,2170,5000,2,2170,0,2003
6817800840,440000,2,1.5,1330,15873,1,900,430,1984
7520000440,214000,3,2,1580,5080,1,800,780,1942
0587550470,600000,3,2.75,3580,14217,2,2210,1370,1989
6851700381,935000,4,2,2580,4500,2,1850,730,1905
4077800029,630000,4,1.75,1930,10210,1.5,1670,260,1941
7202350480,575000,3,2.5,2120,4780,2,2120,0,2004
1021079099,345000,3,2.5,1990,20466,1.5,1410,580,1987
6075000050,323000,4,1.75,1310,9690,1,1310,0,1967
5467910020,425000,3,2.5,2670,13218,1,2670,0,1988
0322069109,411000,2,2.25,1910,108900,1,1010,900,1972
8658300480,299800,4,1.5,1530,9000,1,1530,0,1976
9187200285,823000,6,1.75,2920,5000,2.5,2780,140,1908
3670500605,200000,3,1,1010,8108,1,1010,0,1955
2141330050,760000,4,1.75,2450,13300,1,1630,820,1987
3820350020,359950,4,2.5,1820,3899,2,1820,0,1999
3291800780,375000,4,2.5,2090,8325,1,1470,620,1983
2423069120,295000,2,1.75,2200,89298,1,1100,1100,1973
6918100170,250000,4,3,2250,7882,2,1570,680,1986
7169200221,497000,3,2.25,1450,1387,3,1450,0,2000
3579000440,520000,4,2.5,2280,8798,2,2280,0,1987
8860500130,365000,4,3.5,2720,6781,2,2100,620,1999
1441800010,459900,3,2.25,2250,8000,1,1460,790,1976
7129300595,158000,3,2,1090,6090,1,940,150,1940
4322300010,294700,3,2,1970,9600,1,1300,670,1967
7229800066,439950,4,2.25,2780,15075,2,2780,0,1985
3625059071,899000,4,2.25,2290,40946,1,1550,740,1960
9517200480,535000,3,1.75,2330,12141,1,1390,940,1983
0240000269,530000,4,4.5,4060,10800,2,4060,0,2007
9835800840,215000,4,2,1470,7000,1,1470,0,1967
8058500005,290000,2,1,1620,5400,1,920,700,1926
2568200170,798000,5,2.75,3220,5934,2,3220,0,2006
9545250010,785000,4,2.5,3270,9578,2,3270,0,1993
4140090420,433000,3,1.75,2160,8565,1,1730,430,1971
3334000050,425000,2,1,1150,6835,1,1010,140,1922
5101404144,654000,4,2.5,2240,7540,1,1540,700,1962
7338001190,215000,3,1.5,1280,5065,2,1280,0,1983
1865810290,232000,3,1,840,6540,1,840,0,1970
2785000290,675000,3,1.75,1680,10500,1,1680,0,1959
7955040080,665000,5,2.75,2330,8000,1,1550,780,1972
5480900010,835000,4,2.5,3030,29163,2,3030,0,1998
6362900080,525000,6,3,2880,7560,2,2880,0,1980
4078300050,780000,3,2.75,2910,3094,2,2010,900,1939
3528000545,844000,4,3.25,3090,67518,2,3090,0,1988
0710300010,680000,4,2.75,2720,54048,2,2720,0,1985
3764800630,290000,3,1.5,1310,8100,1,1310,0,1965
6383000825,560000,2,1,1790,15783,1,1360,430,1959
9465900500,605500,3,2.5,2830,6536,2,2830,0,1989
2568200290,762500,4,2.5,3150,5979,2,3150,0,2005
3885808005,1.74e+006,5,3.25,3930,5500,2,2910,1020,2014
3723800086,665000,6,2.75,2840,8346,1,1420,1420,1961
6840701150,540000,5,1,2480,4400,1.5,1640,840,1919
7301300050,375000,3,2.5,1930,6180,1,1330,600,1961
6381500635,342000,3,1,1260,6826,1,720,540,1944
3980300020,340000,3,1,670,23522,1,670,0,1968
1923000050,1.25e+006,5,3.25,3930,12719,2,2540,1390,1974
7215720250,693000,4,2.5,3160,13063,2,3160,0,1999
3123049230,638500,4,1.75,1770,12462,1,1770,0,1962
8163000020,805000,5,3,2240,18265,2,2240,0,1963
7893808220,250000,3,1,990,8062,1,990,0,1960
0538000440,325000,3,2.5,1580,4698,2,1580,0,1998
7883603390,270000,4,1.75,1560,4290,2,1560,0,1994
7645900235,880000,6,2.5,2640,3680,2,1760,880,1922
9232900050,300000,2,1.75,2120,6350,1,1440,680,1924
7305300500,290000,2,1,1200,8750,1,1200,0,1948
6065300840,2.85e+006,4,4,5040,17208,1,2870,2170,1976
7227500020,259950,3,1,1460,5825,1,1260,200,1942
7237501190,1.78e+006,4,3.25,4890,13402,2,4890,0,2004
0422000010,299950,3,1,1580,5250,1,1580,0,1954
0826069127,483000,3,2.25,2100,43560,1,1330,770,1977
9413600420,890000,3,2.25,2060,8640,1,2060,0,1966
9151600541,719000,3,2.5,1690,4500,1.5,1690,0,1928
3423059153,785000,4,3,3370,100681,1,1920,1450,1977
3630120190,660000,3,2.5,2330,3995,2,2330,0,2006
2787320430,264000,4,1.75,1820,8118,1,1080,740,1980
1672000170,575000,3,1.75,1890,11141,1,1890,0,1968
2050000020,1.215e+006,4,3.75,3820,53574,1,3820,0,1994
3221079069,475000,3,2.5,2770,98881,2,2770,0,1991
7501000080,845800,4,3.5,3020,12750,2,3020,0,1990
3500100078,352500,3,1.75,1170,8182,1,1170,0,1962
9493200010,347000,3,1,1270,8400,1,1270,0,1955
3905081350,560000,4,2.75,1950,6192,2,1950,0,1992
6061000010,323000,4,2.75,2230,50094,1,1330,900,1977
7635801350,595000,3,1.75,2220,22081,1.5,2220,0,1922
7806210380,257500,4,2,2060,6400,1,1170,890,1977
7577700440,450000,3,1,1100,4600,1,1100,0,1917
3876810190,410000,4,1,1140,7208,1,900,240,1970
1224059049,810000,3,1.75,1980,13503,1,1320,660,1952
3348401319,372500,5,3,2480,10090,1,1300,1180,2004
5589300585,325000,3,1,1050,9083,1,1050,0,1951
3293700221,280000,3,1,1260,7660,1,1260,0,1947
2013300050,258000,3,2,1680,19978,1,880,800,1948
0408100050,329950,4,1,1360,5900,1.5,1360,0,1949
4178300080,836000,4,2.5,2450,12987,1,2030,420,1980
2310040020,365000,5,2.5,2260,7040,2,2260,0,1999
8698100170,111300,2,1,1060,6000,1,1060,0,1908
1330910280,864000,4,2.5,3720,105850,2,3720,0,1984
9413600670,725000,3,1.75,1610,8613,1,1610,0,1962
3825500020,550000,4,2.5,3350,6605,2,2670,680,1990
2500600289,130000,2,1,790,7500,1,790,0,1951
4385701440,765000,2,1.75,1660,4000,1,990,670,1940
8645501330,255000,3,1.5,1420,7480,1,1420,0,1963
2323069073,439500,3,2.5,2050,40003,1,1570,480,1977
2475200080,268000,3,1.75,1250,5546,1,1250,0,1987
9533600185,985000,3,1.75,1700,8534,1,1700,0,1953
4139440460,751305,4,2.5,2660,8469,2,2660,0,1994
1443500725,280000,3,1,1350,7553,1.5,1350,0,1914
0984000780,304000,4,2,1810,8750,1,1110,700,1967
7575610170,200000,4,2.75,2210,13235,2,1730,480,1988
2025800080,325000,3,1.5,2120,41325,1,1420,700,1973
1425059180,736000,3,2.25,2470,11603,2,1540,930,1988
1310440280,426500,4,2.5,2700,6515,2,2700,0,1998
2264500425,640000,2,1.75,1760,4400,1,880,880,1930
1721800470,230000,5,2,1930,6120,1.5,1930,0,1941
2589300170,366350,4,1,1680,5043,1.5,1680,0,1911
2338800161,365000,2,1,1390,8336,1,910,480,1946
0855700170,482000,4,2.25,2240,8322,2,2240,0,1979
1431700250,345000,4,1,1980,7991,1.5,1980,0,1962
7942601410,682000,3,1.75,1830,5120,1.5,1830,0,1903
4151800420,657500,3,1.75,980,6002,1,980,0,1942
5700003280,895000,6,2.5,3550,6533,2,3550,0,1925
1105000780,425000,3,1.5,1660,5665,1,920,740,1918
4046400440,532500,4,2.5,2490,8750,2,2040,450,1976
1089700010,540000,4,2.5,2329,9436,2,2329,0,1995
2600040130,578000,3,2.25,1790,9580,2,1790,0,1984
8121100715,1.086e+006,3,3,2830,6041,2,1840,990,1915
1771000440,322500,3,1,1160,9750,1,1160,0,1968
7875200005,140000,3,1,1000,10560,1,1000,0,1955
1822069109,485000,3,2.5,2540,51836,1,1820,720,1976
9283800050,575000,2,1.5,1750,19709,1.5,1440,310,1978
0238000244,421000,3,2.5,2890,21780,2,2890,0,2000
7972600430,355000,4,2,1870,3497,1,1200,670,1954
6204200470,515000,4,2.25,2200,6967,2,2200,0,1986
0123039420,309000,3,1,1300,7200,1,1300,0,1952
1525059215,815000,5,2.25,3410,35536,2,2530,880,1974
1787600094,285000,3,1,1160,7875,1,1160,0,1953
2877101100,700000,3,1.75,2100,5000,1.5,2100,0,1916
9406550050,289000,3,2.5,1490,8628,2,1490,0,1994
0826069016,458000,4,3,3280,62726,1.5,3280,0,1979
8732030080,230000,3,1.75,1450,8378,1,1450,0,1978
2231000020,432500,3,2.5,1930,7120,1,1420,510,1961
9407000840,288000,3,1.75,1660,10440,1,1040,620,1978
1775800290,354000,3,1.75,1260,12330,1,1260,0,1968
3821200050,119500,3,1,1170,11000,1,1170,0,1980
3224510080,805000,4,3,3350,23781,1,2020,1330,1979
3626039415,435000,3,2.5,1420,2581,3,1420,0,2004
9262800294,260000,3,1.75,2170,10018,1,1630,540,1978
0127100005,377000,4,1.75,1800,8385,1,900,900,1950
3905040170,602000,4,2.5,2000,7376,2,2000,0,1990
0148000680,530000,3,1.75,1660,4800,1,960,700,1941
0458000235,525000,4,2,1540,3740,1,770,770,1946
1445200050,250000,2,1.5,1160,1086,2,890,270,2006
7950300005,681000,3,1,1700,6356,1.5,1700,0,1907
2726049169,625000,3,1.75,1580,20588,1,1580,0,1970
8944550050,448500,3,2.5,2080,3920,2,2080,0,2010
0623049341,260000,3,2,1030,7260,1,1030,0,1947
7922900380,538000,3,1.75,1770,8050,1,1020,750,1963
2248000080,385500,3,2,1540,7947,1,1120,420,1961
9406540050,428400,4,2.5,2650,6000,2,2650,0,2000
5416100190,346290,4,2.75,2690,9240,2,2690,0,1998
7215720680,587000,4,2.75,2210,8430,2,2210,0,1999
4307330280,355000,4,2.5,2390,6775,2,2390,0,2003
1562000050,650000,5,2.75,2580,7865,1,1480,1100,1964
4307320280,340000,4,2.5,2160,5455,2,2160,0,2003
0569000050,565000,4,2.5,2230,8624,1,1430,800,1969
5700000595,630000,4,2,2000,5000,1.5,2000,0,1925
8029200190,227000,3,1,1280,7198,1,1280,0,1916
2896000680,600000,4,2.75,2810,17674,1,1640,1170,1978
9328500680,540400,4,1.75,1680,6758,1,1680,0,1974
3295730050,569000,3,2.5,2150,8060,2,2150,0,1995
3629970130,735000,3,2.5,2820,8159,2,2820,0,2004
3574801310,434000,3,2.25,1750,9353,1,1210,540,1987
4083802195,578888,2,2,1060,4000,1,1000,60,1914
9238500480,465425,4,2.75,2430,20720,1,2430,0,1967
9264910280,280500,4,2.75,2660,7754,1.5,1590,1070,1986
3630120380,539950,2,2,1670,3507,1,1670,0,2007
0424069088,406430,3,2,1380,15426,1,1380,0,1968
2954400020,1.15e+006,4,3.75,4160,35000,2,4160,0,1991
2154550020,250000,3,2.5,1790,6191,2,1790,0,1992
5420800010,266000,3,2.5,1940,8547,1,1460,480,1989
2459950010,258000,3,2,1390,7200,1,1390,0,1996
4019301300,472000,3,2,2200,21890,1,1200,1000,1961
3179100480,530000,3,2.25,1264,1536,2,1264,0,2003
7942601155,302282,2,1,1095,5120,1.5,1095,0,1901
2493200235,370000,2,1,850,6213,1,750,100,1916
6338000014,625000,4,2,1760,5307,1.5,1170,590,1948
1735800050,142500,1,1,690,6825,1,690,0,1917
2783100050,334000,3,1.75,1400,7405,1,1400,0,1961
1604600095,362000,5,3,1810,3000,2,1810,0,1998
3080000005,181000,2,1,1310,4000,1,950,360,1942
2268000470,241500,3,1,1400,10425,1,1400,0,1968
0807800190,245000,3,1.75,2350,12720,1,1180,1170,1964
1274500170,227500,3,1,1150,8848,1,1150,0,1968
8857600780,158550,5,1.5,1710,8100,1.5,1710,0,1961
5145000130,450000,3,2.25,1660,10247,1,1130,530,1968
3288200470,485000,3,1.75,1950,10080,1,1950,0,1967
1771000950,353000,4,1.75,1780,9794,1,1780,0,1967
3818400050,500000,4,3,2450,4668,2,2450,0,2004
0537000130,360000,1,2.25,2060,10600,1.5,1560,500,1927
5127000420,357500,3,1.5,1540,11858,1,1540,0,1966
8656300380,272000,3,2.5,1650,13816,2,1650,0,1998
6632300161,422000,3,1,1160,7854,1,1160,0,1960
0622100130,365000,2,2,1440,15000,1,1440,0,1985
4028900048,450000,3,1.75,2150,13789,1,1610,540,1966
0411100005,275053,2,1,1060,6504,1,1060,0,1950
6447300225,1.88e+006,3,2.75,2620,17919,1,2620,0,1949
5739600427,725000,3,1.75,1630,9000,1,960,670,1955
5412310080,235000,3,1.75,1840,9697,1,1500,340,1985
2726049071,510000,2,1,820,4206,1,820,0,1949
2726049071,489950,2,1,820,4206,1,820,0,1949
3764650050,463000,3,2.5,2010,4195,2,2010,0,1998
3905030480,536000,4,2.25,1990,5948,2,1990,0,1991
2345700500,375000,4,2.5,2990,6145,2,2990,0,2003
8650300130,630000,4,2.5,2540,4727,2,2540,0,1999
2923049372,362000,3,2.25,1640,14374,1,1140,500,1963
5437200080,350000,4,2.75,2500,11659,1,1490,1010,1979
9808100185,1.691e+006,4,3.5,4020,13515,2,4020,0,2001
4337000285,255000,3,2,1500,8775,1,1390,110,1943
2891000010,269000,4,2.5,1594,7665,1,1088,506,1975
7224000545,370000,4,3,2130,4838,1.5,2130,0,1930
3243100080,270000,3,1,1130,7920,1,1130,0,1961
3925000020,265000,3,2,1690,9516,1,1690,0,1997
0546000020,487000,2,1,1440,4046,1,960,480,1946
8651611060,835000,4,3.25,3270,6027,2,3270,0,2001
3024079063,850000,4,3.25,4350,112750,1,2200,2150,2006
3039000050,575000,4,2.75,1610,11201,1,1020,590,1982
1839900080,335000,3,1,950,8000,1,950,0,1968
4024101434,318000,3,1,1010,7200,1,1010,0,1948
2824069142,510000,3,2,1420,11325,1,1420,0,1980
2618300080,242500,3,1.5,1200,9720,1,1200,0,1965
7785000010,750000,5,2.25,2020,8400,1,1010,1010,1963
4307330050,439900,5,3.5,3390,7950,2,3390,0,2003
2867100005,710000,2,1,1700,3040,1.5,1460,240,1914
3880900010,2.4e+006,5,3.25,3410,9088,2,2760,650,1912
5255710010,435000,3,1.75,2030,13700,1,1630,400,1976
3213200314,874000,4,2.75,2860,6867,1,1560,1300,1946
9834200950,385000,4,1.75,1690,4080,1,870,820,1984
3806000005,110000,2,1,760,4746,1,760,0,1930
6204400170,477000,3,1.75,1780,8085,1,1210,570,1976
2491200675,500000,3,2,1550,6394,1.5,1550,0,1918
0098020480,885000,4,2.5,4090,11225,2,4090,0,2005
8068000585,235000,2,1,880,5600,1,880,0,1955
4345000170,210000,3,2.75,1320,15236,1,880,440,1995
3101500010,320000,2,1,950,4000,1,950,0,1910
3291800660,406000,3,1.75,1390,7904,1,1390,0,1985
3541600235,350000,3,1.75,1900,10225,1,1220,680,1963
2923039217,350000,2,0.75,1392,43710,1.5,1392,0,1978
7852010290,720000,4,2.5,3340,8930,2,3340,0,1999
7695450010,604700,4,2.75,2750,14982,1,1720,1030,1981
3424069145,343000,3,1,1400,5662,1.5,1400,0,1920
3578400500,558000,3,2.25,2220,15757,1,1280,940,1982
4365200895,364000,4,1,1210,7740,1.5,1210,0,1922
4027700321,420000,3,1.75,2390,11242,1,1290,1100,1959
7923600250,450000,5,2,1870,7344,1.5,1870,0,1960
8122100290,392000,2,1.5,940,5000,1,810,130,1925
7224000980,100000,4,1,1120,2685,1,860,260,1939
9521100280,480000,3,2.5,1250,1103,3,1250,0,2005
7875400050,212000,3,1.5,1060,9225,1,1060,0,1955
6204420290,560000,5,2.5,2410,8960,1,1600,810,1978
1041440050,359950,5,2.75,2844,3990,2,2844,0,2013
1626069178,535000,4,2.5,2200,110642,1,1330,870,1979
3342101937,980000,5,4,3460,5400,2,2830,630,2012
9178601630,720000,2,1,1580,2199,2,1580,0,1921
5273200080,619950,2,1,1520,5400,1,920,600,1951
7701930010,489000,3,2.5,2260,19821,2,2260,0,1994
6820100010,415000,4,2,1800,2970,1,1000,800,1923
3066400130,672500,4,2.5,2650,11108,2,2650,0,1987
0339600010,352500,3,1,1000,4171,1,1000,0,1985
3391900130,258750,4,2,2300,8400,1,1150,1150,1962
7283900010,350000,3,1,1080,7000,1,1080,0,1916
1113000430,152000,3,1,902,10464,1,902,0,1965
5101405276,378500,2,1,730,7528,1,730,0,1946
7796100050,1.017e+006,4,1.75,2600,41041,1.5,2600,0,1965
2207200675,419000,3,1.5,1570,6700,1,1570,0,1956
3622910190,895000,5,3,2876,13927,1,1970,906,1973
9346930250,668500,4,2.25,2290,9546,1,1780,510,1976
3886000010,487000,2,2.5,1470,2533,2,1470,0,2005
6326000130,538000,3,3.5,2620,10137,2,1970,650,1992
0686900010,898000,5,1.5,2680,28014,1,1450,1230,1963
1310000130,315000,4,2,2020,7767,1,2020,0,1995
0139000185,800000,3,2.5,2100,4440,2,2100,0,1945
4039000050,516130,3,1.75,1510,8250,1,1510,0,1962
9253900417,1.6e+006,3,2.5,2850,19593,1.5,1790,1060,1978
4128500380,1.2e+006,4,2.5,4280,12796,2,3400,880,1999
8159300050,355425,4,2.5,3238,9112,1,1678,1560,1979
1338600185,1.1574e+006,3,2.5,2740,5925,2,2740,0,1913
7625703900,689000,4,2.5,2020,9600,2,2020,0,1954
2767700022,500000,3,3.25,1520,1500,3,1520,0,2000
3914000095,430000,5,2.5,3860,42733,1,2300,1560,1955
7334501410,299500,4,2.25,1600,15312,1,1080,520,1979
2597710050,349950,4,2.5,2090,5289,2,2090,0,1989
7933250050,1.419e+006,5,3.25,4020,4500,2,3120,900,2010
2600140500,998000,4,2.25,2910,10189,2,2910,0,1988
3876810170,329000,3,1,900,9600,1,900,0,1970
3740000010,575000,3,1.75,1720,5956,2,1720,0,1981
6895300050,529900,5,2.25,3030,9430,2,2600,430,1961
6645900010,1.47e+006,4,2.5,3030,10189,1,2380,650,2003
9413600380,725000,4,1.75,2190,9400,1,1450,740,1962
2115720500,286000,3,2.5,1680,5000,2,1680,0,1987
2202500255,335000,3,2,1210,9926,1,1210,0,1954
2207100255,395300,3,1.5,1120,7000,1,1120,0,1955
8035350010,510000,4,2.75,3180,13348,2,3020,160,2004
1555300010,203000,3,1,920,7500,1,920,0,1970
6135300010,248000,2,1,700,8301,1,700,0,1953
1321730470,265000,3,2.25,2540,7216,2,2540,0,1991
4083306345,1e+006,4,1.5,2100,4560,1.5,2100,0,1912
1453602360,1e+006,3,1,1540,24500,1.5,1540,0,1949
2025600280,241400,3,2,1420,9828,1,1420,0,1990
1423800380,309950,4,1.75,1450,10074,1,1450,0,1966
2113701100,294010,3,1.75,1550,4057,1,830,720,1945
3578401060,345000,3,2.25,1920,9672,2,1920,0,1984
3578401060,625000,3,2.25,1920,9672,2,1920,0,1984
7691800020,660000,4,2.5,2510,4543,2,2510,0,2002
8682230950,559000,2,2,1660,4500,1,1660,0,2003
7202360010,866000,4,3.25,3990,9786,2,3990,0,2004
2125049120,770000,3,2,2350,5700,1.5,1810,540,1939
5540000010,259950,3,1.5,1350,7827,1,1350,0,1968
1552800010,352000,5,2.75,2980,9838,1,1710,1270,1968
1118002000,2.46635e+006,5,4.75,6390,13180,2,4560,1830,1940
8564600080,395000,3,2,1590,10229,1,1590,0,1966
1446800660,276500,4,1.75,1400,6650,1.5,1400,0,1942
2624079022,530000,3,2.25,1880,100623,1.5,1880,0,1987
5051800130,798000,4,3.25,3500,10260,2,3500,0,1987
7940700190,380000,2,2,1370,5756,1,1370,0,1986
5422810010,350000,4,2.5,2810,10433,2,2810,0,2001
3529200190,325000,3,2.5,2220,6049,2,2220,0,1990
8944320280,336000,3,2.5,2110,4549,2,2110,0,1989
3222069153,286900,3,2.25,1720,17235,1,1440,280,1974
7211300050,472000,5,2.25,1780,7245,1,1330,450,1976
1545806980,263000,3,1.75,1410,8100,2,1410,0,1985
9297300255,565000,3,3,2110,4000,1,1110,1000,1965
4139400280,765000,3,2.5,2700,8444,2,2700,0,1992
9201300020,1.517e+006,3,2.25,2610,9409,1,2610,0,1963
8663280080,405000,3,2,1660,8174,1,830,830,1981
0098000980,1.098e+006,4,3.5,4570,16219,2,4570,0,2002
1796100010,555000,3,3,3760,188760,1,2640,1120,1979
2781280290,305000,3,2.5,1610,3516,2,1610,0,2006
1448800010,289950,3,2.25,1740,9370,1,1390,350,1992
1526079026,487500,5,3.5,3530,218472,2,2380,1150,1999
1788800630,96500,3,1,840,12091,1,840,0,1959
1788800630,185000,3,1,840,12091,1,840,0,1959
8864000250,150550,4,1,1470,6061,1.5,1470,0,1945
7972600670,339000,4,2,2470,5080,1.5,1970,500,1948
4077800094,675000,4,1.75,2220,7230,1,1280,940,1950
9834200440,615000,3,1.75,1720,4080,1,960,760,1924
1245002125,837500,4,2.5,2700,9320,2,2700,0,1994
5634500170,250000,2,1,950,11835,1,950,0,1932
1954400500,583000,3,2.5,1790,8144,2,1790,0,1989
9528102771,499000,3,2.5,1610,1728,3,1610,0,2000
2895600095,550000,3,2.5,2290,6328,2,2290,0,2001
2921079027,400000,4,2.5,2170,204296,1,2170,0,1980
0524059323,990400,3,2.5,2100,4097,2,2100,0,2008
0824069173,600000,3,2.5,2320,52272,1.5,2320,0,1974
2678100005,325000,2,1,1120,6236,1,1120,0,1954
2025700080,265000,3,2.5,1530,6000,2,1530,0,1991
6613000585,1.6205e+006,3,2.5,3490,9362,1,1770,1720,1960
2597000006,347500,3,1.5,1180,8353,1,1180,0,1960
1923300170,629000,5,2,2050,3000,1.5,1470,580,1912
1224049005,1.0875e+006,2,2,2360,11340,1.5,2360,0,1997
4123840050,397500,4,2.5,2570,7859,2,2570,0,1992
1937300280,404500,2,1,1270,3700,1.5,1270,0,1909
9183703376,225000,3,1.5,1250,7500,1,1250,0,1967
9542801310,267000,3,2.25,2510,9900,1,1610,900,1978
2771104830,800000,4,3.75,2690,4000,2,2120,570,1909
7967650010,339000,4,2.5,2900,6918,2,2900,0,2001
6744701310,1.85e+006,4,2.5,3830,11972,1,2370,1460,1981
3131201310,525000,5,1,1280,3876,1.5,1280,0,1923
3630180500,1.15e+006,5,3.5,4350,6218,2,3520,830,2007
7624700050,565000,1,1,1370,6250,1.5,1370,0,1921
3274800460,387000,2,2.25,1230,1280,2,960,270,2012
1939000010,720000,4,2.5,2440,34290,2,2440,0,1987
4139490190,1.5e+006,4,3.5,4410,12426,2,3420,990,1996
6381500170,235000,2,1,910,7617,1,910,0,1936
6381500170,365000,2,1,910,7617,1,910,0,1936
1954420170,368250,3,2.5,2150,7484,2,2150,0,1988
1954420170,580000,3,2.5,2150,7484,2,2150,0,1988
0623059016,1.1e+006,4,3.25,3190,11774,2,2610,580,1956
6181400470,215000,4,2.5,2130,4496,2,2130,0,2004
3904920980,648000,4,2.5,2740,9959,2,2740,0,1989
7215730430,705000,4,3,3150,9318,2,3150,0,2001
0475000190,465000,3,2.25,1450,1540,2,1180,270,2005
2877100235,650000,5,2,2400,3500,1.5,1900,500,1911
7893202340,335000,4,2.25,2280,7500,1,1140,1140,1963
9238430190,640000,4,2,2310,31850,1.5,2310,0,1984
1939120050,638250,4,2.5,2460,8029,2,2460,0,1989
9197800010,1.46e+006,4,3.5,4200,14353,2,3640,560,1996
5248800250,375000,4,2,1620,4600,2,1620,0,1909
4457300630,842000,4,1.75,2170,9525,1,2170,0,1960
2228900161,499950,3,2.25,2880,7200,1,1710,1170,1970
6817850050,810000,4,2.5,3280,25211,2,3280,0,1985
1775800280,310000,5,2,2900,11970,2,2900,0,1969
0263000050,730000,3,2.5,2160,8809,1,1540,620,2014
1870400470,637800,4,1.75,2250,4750,1.5,1420,830,1924
7839300185,225000,3,1,1340,4800,1.5,1340,0,1903
2426039130,417500,4,1,1390,10800,1.5,1390,0,1941
2938200170,265000,4,2,1600,10160,1,1600,0,1972
1954440050,550000,4,2.5,2050,8683,2,2050,0,1987
2224079001,625700,3,2,2570,159865,1,2570,0,1968
0200520080,595000,3,2.5,2660,10637,2,2660,0,1991
2195900010,270000,3,1.5,1540,13475,1,1540,0,1972
5707500050,739375,5,3,2640,3200,2,2140,500,1906
8929000130,357562,2,1.75,1210,1032,2,1210,0,2014
2944000170,1.01e+006,4,2.5,3760,29224,2,3760,0,1987
8682262330,455000,2,1.75,1350,4286,1,1350,0,2004
4167800130,310000,5,2.25,2600,9600,1,1810,790,1969
1624079088,415000,3,2.75,3900,111514,2,3460,440,1967
7370600050,452000,2,1,1340,8100,1,1340,0,1950
2025059134,810000,3,2,1760,16928,1,1760,0,1953
7522500020,730001,3,2,1840,4750,1,1010,830,1951
1125069134,825000,3,2.25,2980,86636,1,2230,750,1989
8032700010,665000,3,2.5,1730,3000,2,1730,0,1996
2473370050,327500,4,1.75,1650,7800,1,1650,0,1968
3276930050,699950,3,2.5,3370,36218,2,3370,0,1988
3211230080,424000,3,2.5,2200,34680,2,2200,0,1985
7519000471,657000,4,2.5,2180,3375,1.5,1420,760,1926
8563000130,445000,3,1.75,1490,10844,1,1210,280,1974
2770604103,450000,3,2.5,1530,762,2,1050,480,2007
3581000020,350000,3,1,1180,7455,1,1180,0,1964
9432750190,460000,4,2.5,2080,17532,2,2080,0,1996
1622059088,385000,4,2.5,3200,22651,1,1610,1590,1970
5559900080,272000,4,2.25,1880,6160,2,1880,0,1993
7202260780,535000,3,2.5,2510,5544,2,2510,0,2001
8651410950,216500,2,1,1060,5200,1,1060,0,1969
7843500080,325000,3,2.5,2130,12245,2,2130,0,1989
3205400290,420200,3,1.75,1320,7280,1,1320,0,1968
7129300420,258000,3,1.75,1040,5650,1,1040,0,1951
0263000280,450000,3,2,1150,4500,1.5,1150,0,1917
2919200280,720168,4,2.25,2120,3794,2,1420,700,1926
2769602880,652000,3,2,2130,5000,1.5,1330,800,1925
8078440050,569500,4,2.5,2340,8248,2,2340,0,1989
1922069071,411000,4,1.75,2250,292288,1,2250,0,1963
7518502945,524950,3,1.75,1890,3825,1,1290,600,1974
7568700480,153000,2,1,1140,10152,1,760,380,1942
9577800005,775000,3,2.5,2780,5467,2,2780,0,2000
7436050170,338500,4,2.5,2390,6111,2,2390,0,1997
7200001259,570000,3,1.75,2390,9000,1,1500,890,1975
4127000095,653000,3,2,2680,8429,1,1880,800,1950
1934800086,435000,2,2.5,1560,1222,2,1080,480,2008
3361401025,207000,2,1,1130,8160,1,1130,0,1952
7430500415,540000,2,1,1120,7500,1,1120,0,1971
1622049182,386000,4,2.25,2050,9583,2,1770,280,1965
7749500250,265000,5,2.25,2600,8075,1.5,2600,0,1969
1773101159,250000,3,2.25,1050,572,2,740,310,2006
9829200250,1.697e+006,3,2,2600,6600,2,1930,670,1970
3303860130,455000,4,2.5,2811,7251,2,2811,0,2009
9359100500,1.795e+006,4,3.25,4060,13000,2,4060,0,2000
1250203860,759000,3,2,2260,7200,1,1130,1130,1941
2386000170,970000,4,2.75,4430,74358,2,4430,0,1990
5702500050,280000,1,0,600,24501,1,600,0,1950
2600000050,690000,3,2.25,2430,8327,1,1430,1000,1978
7856640170,789900,3,2.5,3420,25150,1,1750,1670,1987
5540800130,447500,2,1,1180,5100,1.5,1180,0,1926
7955060010,440000,4,2.25,2010,7575,1,1220,790,1974
7760400470,278000,3,2,1230,7789,1,1230,0,1994
9551202130,980000,5,2.5,2750,6000,1.5,1750,1000,1904
4345000050,245000,3,2.75,1300,14197,1,860,440,1996
7334501440,287000,3,1.5,1150,11475,1,1150,0,1971
1523069215,435000,3,1.75,2220,132858,1,1110,1110,1988
5525400430,585000,3,2.5,2050,11690,2,2050,0,1989
0871001611,616000,4,1.75,1700,5846,1,1700,0,1957
1685200190,203000,3,1.75,1610,9000,1,1100,510,1978
1982200675,860000,4,2.75,2720,3840,2,1790,930,1920
1201500010,833000,4,2.5,2190,12690,1,1170,1020,1973
1822360080,565000,4,2.75,2730,6856,2,2730,0,2003
4113800500,572500,3,2.5,2490,7589,2,2490,0,1991
4299700095,254000,4,2,1510,4235,1,1510,0,1955
3585900500,1.525e+006,4,4.25,4720,21000,3,4720,0,1971
0326069026,900000,4,3,3810,217800,2,3810,0,2003
4070700290,899000,3,2.5,1950,3730,2,1950,0,1996
7625703800,560000,3,2,1300,6000,1,1300,0,1943
0643400130,512500,3,1.75,1610,7200,1,1180,430,1976
2877103070,775000,4,2.5,2040,5000,1.5,1180,860,1924
0421000185,200000,2,1,700,4700,1,700,0,1953
2113700825,172000,3,1,970,4700,1,720,250,1943
0623049093,219900,3,1,910,6000,1,910,0,1956
4348800080,641200,3,1,1060,9123,1,1060,0,1952
3762900010,473000,5,3.25,2180,7200,2,2180,0,1982
3578401700,540000,3,1.75,2050,9580,1,1400,650,1984
1211000280,295000,2,1,750,4500,1,750,0,1945
1324300091,370000,3,1,800,2296,1,800,0,1908
4141800285,1.727e+006,4,2.25,3470,8000,1.5,2360,1110,1906
1524079088,275000,3,1.5,1390,48257,1,1390,0,1922
9320900420,89000,3,1,900,4750,1,900,0,1969
7349800780,175000,2,1.75,1050,9800,1.5,1050,0,1975
1196002948,490000,3,2.5,2410,11900,1,1600,810,1989
5631500213,342400,3,2.25,1180,9630,2,1180,0,1986
3416601045,345000,3,1,1140,4200,2,1140,0,1904
9828701650,399000,2,1,700,3400,1,700,0,1946
6071300500,550000,4,2.5,2060,9719,1,1320,740,1960
6072760670,652450,3,2.25,2230,11835,1,1630,600,1974
9141100255,438000,2,2.25,1950,29347,1,1350,600,1953
2824600290,605000,3,1.75,2100,5058,1,1340,760,1941
2787720170,395000,4,2.5,2130,11733,1,1330,800,1969
9826701735,449950,3,2,1880,3048,2,1880,0,1902
1703050420,651100,4,2.5,2310,5526,2,2310,0,2003
4060000440,241000,3,1,880,6050,1,880,0,1945
2525049148,3.4188e+006,5,5,5450,20412,2,5450,0,2014
8857310010,268500,2,1.5,1290,1749,1,660,630,1969
1823049178,200000,2,1,1010,7200,1,1010,0,1956
4364200250,400375,4,1.75,1690,7680,1,890,800,1946
8682260480,429000,2,1.75,1350,6315,1,1350,0,2005
1250200345,230000,3,1,680,2400,1,680,0,1903
9808590460,1.2e+006,4,2.25,2860,10702,2,2860,0,1982
7818700480,314200,1,1,610,6000,1,610,0,1918
2792000010,513000,4,2.5,2660,8887,1,1880,780,1967
1705400244,535000,2,1,1390,5346,1,960,430,1908
9358002375,420000,6,3,2290,6344,2,2290,0,1980
8944320470,345950,3,2.5,2110,4118,2,2110,0,1989
6372000101,483500,3,2,1200,2016,1,600,600,1931
2877100655,695000,4,2.25,2360,2500,2,1520,840,2001
9378500050,295000,4,2.5,2350,8906,2,2350,0,1993
3790600080,434975,3,2.25,1590,9960,1,1060,530,1976
8944360080,513000,3,2.5,1810,4592,2,1810,0,1992
7979900225,360000,3,1.75,1900,11407,1,1900,0,1963
3163600130,234900,3,1,1250,8000,1,1250,0,1956
4139380050,963000,4,3.5,3280,6603,2,3280,0,2007
2749600095,595000,2,1.5,870,4800,1,870,0,1924
7852160250,942500,4,3.25,3570,14408,2,3570,0,2006
3303980500,1.029e+006,4,3.25,3780,11200,2,3780,0,2002
1250200605,350000,3,1,1190,3600,1.5,1190,0,1904
8887001640,416500,4,2,2280,39848,2,2280,0,1991
2122059127,209900,3,1,1030,60720,1.5,1030,0,1912
5700001045,802000,3,1.75,2870,5000,1.5,1840,1030,1907
7331900290,230000,4,1.5,1520,8800,1,1520,0,1960
7844200415,489000,3,3,3700,10375,2,3700,0,1982
4055700345,497000,3,1.5,2240,28750,1,1620,620,1956
2923049421,250000,3,2.25,1920,7738,1,1520,400,1965
1860600840,925000,3,3,2560,3600,2,2110,450,1994
5095400460,390000,4,2.5,1840,15496,2,1840,0,1991
3819750170,415000,3,2.75,2080,9600,1,2080,0,1988
5021900779,785000,3,2,1600,9638,1,1600,0,1952
4206901155,575000,3,2,2168,4000,1.5,2168,0,1907
6303400290,170000,2,1,860,8636,1,860,0,1924
7871500440,750000,4,1.75,2100,3400,1,1100,1000,1915
6085000130,230000,3,1,1140,9639,1,1140,0,1967
1896700080,855000,4,3,3090,35074,2,3090,0,1978
6197800101,235000,3,1,1330,45738,2,1330,0,1967
7802900380,335000,2,1,1360,69260,1,1360,0,1937
3024059126,1.195e+006,5,3,3420,18129,2,2540,880,1952
7128300630,677000,4,2,2180,6000,1.5,2060,120,1927
7626200305,575000,3,2,1800,5000,2,1600,200,1925
7950300670,450000,2,1,1120,4590,1,1120,0,1924
1233100321,817250,3,2.5,2980,7202,2,2980,0,1999
9238500190,440000,4,2.25,2600,28600,1,1810,790,1968
1972201856,526000,2,2,1550,2400,1.5,1550,0,1900
0624110920,762500,3,2.25,3330,15258,2,3330,0,1986
5003600080,325000,4,2.5,2200,7719,2,2200,0,2000
0853600020,840000,4,3.5,3840,85728,2,3840,0,1998
7625704317,377500,2,1,840,4500,1,840,0,1939
2946000912,212500,3,1.5,1270,7128,1,1270,0,1954
4188000670,749400,4,2.5,3240,20301,2,3240,0,1985
5215200010,663000,3,2.5,2480,37843,1.5,2480,0,1974
2911700020,1.476e+006,3,2.25,4470,22518,2,3240,1230,1953
0185000161,261000,3,1,1780,7800,1,1060,720,1957
2140700190,515000,4,2.5,1850,9248,2,1850,0,1997
9406600050,410000,3,2.25,2200,16921,2,2200,0,1987
2473000470,336000,3,2.25,2760,10160,1,2760,0,1969
5100403952,440000,2,1,1090,4128,1,1090,0,1948
2024059127,908950,4,2.75,3090,6200,2,3090,0,2014
1483300430,554000,2,1,820,3700,1,820,0,1968
0291300170,387000,3,2.25,1445,1606,2,1300,145,2003
9117000170,268643,4,2.25,1810,9240,2,1810,0,1961
0461004095,514000,3,1.75,1620,5000,1,920,700,1954
9547201850,420000,2,1.75,1060,4182,2,1060,0,1977
7942100290,199000,3,1.75,1050,9871,1,1050,0,1968
4336000050,225000,3,1,1010,15701,1,1010,0,1949
2571910420,320000,4,2.5,2050,8424,2,2050,0,1993
8802400896,204995,2,1,970,8185,1,970,0,1904
3630010020,376000,3,2,1540,1827,2,1540,0,2005
6793300010,705000,4,2.75,3000,6222,2,3000,0,2004
7852020250,725995,4,2.5,3190,7869,2,3190,0,2001
2473400290,285000,4,2.5,1870,8190,1,1100,770,1977
3328500250,285000,4,2.5,2200,9397,2,2200,0,1987
0629420080,731000,4,2.5,3070,5936,2,3070,0,2005
2524049215,1.56435e+006,4,3.75,3730,17000,2,2820,910,1986
8663310050,510000,4,2.5,2440,10423,1,2440,0,1955
4083304835,620000,2,1,990,4332,1,990,0,1909
8155800050,1.11e+006,3,4,4160,31796,2,4160,0,1989
4403200255,796000,4,3.5,3670,4960,2,2870,800,2005
5379800500,255000,3,1.5,910,25500,1,910,0,1943
7010700660,807000,3,2.5,1940,4000,2,1940,0,2000
9406540190,315000,4,2.5,1780,6000,2,1780,0,2000
1795920250,637000,3,2.25,2200,7355,2,2200,0,1986
5249800010,2.725e+006,4,4.25,6410,43838,2.5,5610,800,1906
8651510420,490000,3,2,2070,10023,1,1220,850,1981
1422700080,253000,3,1.75,2040,7281,1,1020,1020,1962
5468780250,325900,4,2.5,2320,6270,2,2320,0,2004
3723800415,425000,2,2,1440,6677,1,870,570,1952
1545800290,215000,4,2.5,1700,6675,2,1700,0,1997
1545800290,315000,4,2.5,1700,6675,2,1700,0,1997
2804100095,724800,3,2,2050,3933,1,1180,870,1926
7282300095,295000,2,1,800,6500,1,800,0,1953
0930000289,509007,3,1.75,1800,7620,1,1350,450,1951
2822059181,306000,5,2,1460,169448,1.5,1460,0,1910
1761100080,205000,3,1.75,1290,7210,1,1290,0,1984
2953000250,275000,3,1.5,1900,9737,1,1200,700,1968
3416600185,685000,3,1.75,1480,7000,1,1480,0,1963
0927200380,465000,4,2.5,2090,12833,1,1220,870,1969
7922750020,560000,4,2.25,1950,9800,1,1330,620,1968
0259600050,458500,3,1.75,1250,9605,1,1250,0,1964
3298300420,354000,3,1,990,7590,1,990,0,1959
1310440470,441000,3,2.5,2740,7923,2,2740,0,1998
3438502668,194000,3,1.75,1260,10488,1,1110,150,1952
5591700290,316500,4,2.5,2150,6807,2,2150,0,1991
4172100050,524950,3,1.75,1750,3250,1.5,1230,520,1929
9275700005,1.052e+006,3,2.25,2880,6092,2,1920,960,1983
1089000190,925000,4,2.25,2590,13894,2,2590,0,1975
9523103000,780000,3,1.75,2430,4524,1.5,1830,600,1924
2781270440,241000,2,2,1470,3128,2,1470,0,2005
2105200050,519000,3,2.75,2020,10744,1,1270,750,1954
7625703637,286000,2,1,610,4000,1,610,0,1918
2926049408,400000,3,2,3000,17800,1,1500,1500,1962
3224079005,255000,2,1,920,43560,1,920,0,1923
5147600095,152000,3,1.75,1070,7754,1,1070,0,1953
2413900050,599000,4,2,3410,15143,2,3410,0,1972
3820350050,330000,4,2.5,1820,3905,2,1820,0,2001
8910500675,461000,2,1,1060,7193,1,1060,0,1926
1461200020,620000,5,2.5,3070,34991,2,3070,0,1995
0722079056,352500,4,2.5,2300,219106,1,1840,460,1958
8663370020,435000,3,2,1610,6911,1,1260,350,1988
2568200130,725000,5,2.75,2830,5310,2,2830,0,2006
8947800080,300000,3,1,970,12300,1,970,0,1982
1545803390,252000,3,2.5,1680,8284,2,1680,0,1989
1088030010,464625,4,2.75,2040,8996,1,1260,780,1974
1829700080,340000,3,1,1450,9586,2,1450,0,1950
2125049024,1.325e+006,4,2.25,2870,6280,1.5,1980,890,1905
5706200020,455000,5,2,1870,13970,1,1120,750,1969
2316400285,495000,4,3.5,2490,18042,2,2490,0,2003
7588700080,925000,4,2.5,3350,4501,2,2640,710,2002
7853310380,587000,4,2.75,3190,8737,2,3190,0,2006
6821101870,524000,3,1.75,1560,5520,1,780,780,1944
9551201660,1.03e+006,4,2.5,2750,4800,2,1960,790,1905
3530500010,176000,2,1,920,2332,1,920,0,1980
7387500185,249900,2,1,1140,5500,1,1140,0,1947
1626079132,499500,3,2.5,2520,53143,1.5,2520,0,1988
8854100130,600000,5,3.5,3150,10542,1,1620,1530,1974
2123049142,294000,4,2.5,2040,7800,2,2040,0,2003
3423059109,272000,4,2,1780,19843,1,1780,0,1963
5631500992,390000,3,2.5,2240,10800,2,2240,0,1996
6641800020,700000,4,2.5,3270,9650,1,2320,950,1971
7853301700,635000,5,2.75,3110,6621,2,3110,0,2006
2158900290,920000,4,1.5,1850,3600,2,1660,190,1929
2273600250,500000,3,1.75,1570,8530,1,1190,380,1983
3298700840,263500,2,1,750,4515,1,750,0,1942
5450500010,975000,4,2.25,2240,9990,2,2240,0,1967
3629870020,575000,3,2.5,1870,3485,2,1870,0,2001
8856700130,822000,4,2.5,2683,40386,2,2683,0,1987
6381502155,300000,3,1,1490,7200,1,1490,0,1954
1443550080,487600,4,2.5,2340,12080,2,2340,0,1999
2205700345,500000,4,2,1700,8640,1,850,850,1955
6926700660,680000,2,2,1450,989,3,1450,0,2014
3279050130,419000,3,2.5,3310,21096,2,3310,0,2004
2770606890,450000,4,1.75,1520,5250,1,1520,0,1949
2867100190,650000,5,1.75,1260,4500,1.5,1260,0,1926
8562600190,550000,3,1.75,1840,8086,1,1840,0,1964
5680000545,330000,4,2,1750,5202,1,1070,680,1942
1922059027,282510,4,1,1450,32234,1.5,1450,0,1932
1725059316,2.385e+006,4,4,6330,13296,2,4900,1430,2000
3275300440,230000,2,2,1260,10200,1,1020,240,1983
0952001735,750000,4,1.75,2100,6613,2,2100,0,1909
1402950190,321000,4,2.5,2430,5366,2,2430,0,2002
4045100190,2.196e+006,4,3.25,4250,18000,2,3350,900,1980
1207200010,245000,4,2,1830,10416,1,1370,460,1958
6815100095,510000,2,1,1310,4000,1,1310,0,1913
3825310130,751000,4,3.25,3090,9571,2,2370,720,2004
3276930380,675000,4,2.5,2560,36601,2,2560,0,1987
8937600080,295000,3,1.75,1930,13350,1,1930,0,1967
8024200010,312000,2,1,1460,6000,1,1260,200,1925
0624110020,730000,3,3,3460,13129,2,2560,900,1988
6192410280,762500,5,3.5,3290,5880,2,2670,620,2005
4302201045,150000,3,1,820,7680,1.5,820,0,1910
0507100020,270000,3,1,1480,7374,1,760,720,1954
0259600280,400000,4,2,1420,9301,1,1420,0,1963
7691800130,650000,3,2.5,2790,6720,2,2790,0,2002
2056100275,530000,2,1.5,1390,5000,1,970,420,1954
2202500080,248000,3,1,950,9400,1,950,0,1954
3179102155,760000,4,3.5,3000,5300,1,1780,1220,1949
0937000280,199000,4,1,1280,10521,1.5,1280,0,1960
5379805253,240000,2,1,870,8400,1,870,0,1960
6821102340,415000,3,1.5,1360,1795,2,1360,0,1945
7229900250,228000,3,1,1000,16376,1,1000,0,1959
7287100177,525000,4,2.5,2740,12106,1,1980,760,1992
8820900670,399950,3,1.75,1560,5223,1,810,750,1940
3275850020,781000,4,2.5,2590,8571,2,2590,0,1988
9528100899,827000,3,2.5,1850,1330,2.5,1560,290,2004
7016000440,525000,5,2.25,2500,8621,1.5,2500,0,1968
7202340010,671300,4,2.5,3280,5232,2,3280,0,2004
6911700066,175000,2,1,670,2378,1,670,0,1919
7511000050,1.1e+006,5,2.75,2890,22547,1,2150,740,1963
2925059260,800000,5,2.5,3000,10560,1,1500,1500,1966
3558000170,329950,4,2.5,1920,4600,2,1920,0,2002
8651730290,445000,4,3.25,1960,7200,2,1960,0,1979
9197100263,237000,3,1.75,2000,12208,1,1140,860,1979
8941100095,1.1125e+006,6,4,3600,6224,2,2610,990,1945
2781100080,438900,4,2.5,2740,5700,2,2740,0,2006
9822700190,1.28e+006,9,4.5,3650,5000,2,2530,1120,1915
3630030290,600000,4,2.5,2310,3866,2,2310,0,2005
9510910250,670000,4,2.5,2095,4569,2,2095,0,2002
8682231330,519000,2,2,1560,4823,1,1560,0,2004
2473480780,320000,3,2.25,1880,7350,1,1390,490,1984
8641500280,270000,2,1.5,840,867,2,840,0,2005
7605800050,1e+006,3,2.5,2730,5832,2,2730,0,1998
9828200525,330000,1,1,860,4800,1,860,0,1907
7971300050,657500,3,2,2320,10960,1,1510,810,1956
0126049169,450000,3,1.75,1540,61419,1,1540,0,1967
5062300280,150000,3,1,890,6488,1.5,890,0,1928
7167000020,792500,4,2.5,4290,175421,2,4290,0,2004
3303910010,540000,3,2.5,1950,13227,2,1950,0,1978
2268000050,229900,3,1,1010,8848,1,1010,0,1968
8857640170,533000,4,2.5,2830,6536,2,2830,0,2003
7806210190,239000,4,1.75,1500,12560,1,1000,500,1977
9206700190,713900,3,2.5,3370,167706,1,3370,0,2000
4136930190,427500,4,2.5,3160,8726,2,3160,0,1999
5666300010,302000,3,1,1110,7000,1.5,1110,0,1955
1424059022,1.15e+006,3,2.5,3830,48743,2,3830,0,1991
6204050080,555000,3,2.5,3160,4270,2,2650,510,2006
7128300500,495000,3,2.25,2100,3000,2,2100,0,1996
1233100642,495000,3,1.5,2240,13288,1,2240,0,1953
0222029026,340000,2,0.75,1060,48292,1,560,500,1947
9485940290,464950,4,2.25,2350,36116,1,2350,0,1983
4136890280,320000,4,2.5,1940,7040,2,1940,0,1998
1775500050,440000,1,1,1160,64469,1,1160,0,2009
7611200086,686000,3,1.5,1840,9990,2,1840,0,1961
3376600010,555000,4,1.75,2260,11000,1,1620,640,1976
7519001990,361500,2,1,840,3860,1,840,0,1909
7613700950,1.24e+006,5,3,2830,7500,2,2460,370,1923
3802000020,154950,4,1,1600,10183,1,1600,0,1966
1796360470,247200,3,1.75,1370,8719,1,1370,0,1982
8732160050,250000,3,2.25,1960,7414,1,1490,470,1984
5249800345,590300,3,1.5,1470,7200,2,1470,0,1907
6071200545,541125,5,2.75,2740,8426,1,1370,1370,1960
0291300280,310000,2,2.5,1090,923,2,1090,0,2004
3261000080,704111,4,2.75,2460,9520,1,1680,780,1976
0321049127,277500,3,2.25,1820,19602,1,1820,0,1964
5379804393,325000,4,2.75,1960,8937,1,980,980,1954
1559900080,289200,3,2.25,1760,7023,2,1760,0,1995
7135300275,185000,1,1,720,5000,1,720,0,1908
1377300005,1.445e+006,4,3.5,3470,8580,2,2500,970,2007
6668900020,420550,4,2,1370,8100,1,1370,0,1947
0326049024,603000,4,2.25,2370,11310,1,1550,820,1968
7942600006,345000,3,1,1390,2640,1.5,1230,160,1903
6430500233,650000,3,2,1840,3075,1,920,920,1928
7701800050,589950,5,3,2790,19439,1,1500,1290,1973
8165501640,309950,2,2.25,1460,1607,2,1460,0,2007
2623069069,775000,3,2.5,2620,241200,1.5,2620,0,1998
8024201870,590000,4,1.5,2230,5109,1.5,1330,900,1918
9126101511,863500,4,3,3250,2760,2.5,2420,830,1905
1377800010,517500,3,1,1190,7000,1,1190,0,1943
6813600380,700000,3,3,2090,7440,1.5,1290,800,1922
0923000280,699000,3,2.5,2580,8154,1,2090,490,1956
0255550190,350000,3,2.5,2100,3574,2,1690,410,2005
1829300130,795000,4,2.5,3160,16564,2,3160,0,1987
3645500050,543000,3,2.5,2090,7640,1,1360,730,1962
1518000080,325000,3,2.5,1570,3143,2,1570,0,2001
7883605915,337500,3,1,1020,6000,1.5,1020,0,1900
1112700170,425000,2,1,1300,11080,1,1300,0,1955
8965500020,780000,3,2.5,2110,9773,1,2110,0,1986
0323059167,259000,2,1,1210,17389,1,1210,0,1948
1951700480,524400,4,1.75,1990,12950,1,1850,140,1968
2005950050,260000,3,2,1630,8018,1,1630,0,2003
9406500480,273000,2,2,1384,1822,2,1384,0,1990
3522049063,639900,4,2.5,3380,75794,2,3380,0,1997
2085700050,420000,4,2.5,2480,8626,2,2480,0,2001
6751300130,510500,3,1,1270,8000,1,1270,0,1957
2610100020,290000,4,1,1010,7200,1.5,1010,0,1947
9476200680,226000,3,1.75,1490,6269,1,990,500,1944
6145600285,300000,2,1,820,3844,1,820,0,1916
0203900460,407450,3,2,1810,10860,1,1810,0,1967
7878400022,390000,4,2.25,3060,7920,1,1530,1530,1965
3585900460,1.0588e+006,6,2.75,2980,20000,1,2130,850,1965
1321720170,610000,3,2.5,3440,18167,2,3440,0,1991
0236400130,239975,3,2.5,1820,7242,1,1220,600,1959
4141680190,375000,3,2.5,2320,5760,1,1480,840,1987
3629980440,742500,4,2.5,2620,4400,2,2620,0,2004
1223039173,450000,4,1.75,2190,11625,1,2020,170,1956
2473000130,300000,3,2.25,1780,10395,1,1780,0,1967
2893000280,216600,3,1.75,2200,7700,1,1240,960,1975
7977201845,525000,3,1.75,1600,6120,1.5,1600,0,1924
4197400005,455000,4,2.25,2450,21000,1,1650,800,1954
5561200980,390000,4,2.25,2680,35218,2,2680,0,1986
3039000020,450000,3,1.75,1850,8667,1,880,970,1982
6840701100,382000,4,1,1740,4400,1.5,1740,0,1924
2130410050,287000,3,2.25,1490,9600,1,1170,320,1987
1924079091,460000,4,2,1960,190357,1,1960,0,1971
3570300080,435000,3,2.25,1380,3015,2,1380,0,2009
2321300351,575000,2,1,1510,4032,1.5,1310,200,1935
2652501630,626700,3,1.5,1410,3600,1,1410,0,1906
3810000020,352000,4,1.5,1440,8680,1.5,1440,0,1922
8084400010,650000,3,1,920,6750,1,920,0,1951
0304000380,197000,3,1,1090,17630,1,1090,0,1962
1873400020,340000,8,2.75,2790,6695,1,1470,1320,1977
4359700080,560000,3,2,1840,14985,1,1840,0,1968
1727500010,354000,3,1.75,1340,6300,1,1340,0,1972
8651610680,670000,4,2.5,2570,9086,2,2570,0,1999
3629970190,769000,4,3.5,3010,6202,2,3010,0,2005
9136102057,650000,4,2.5,2160,3139,1,1080,1080,1940
1266200130,650000,3,1.75,2140,9484,1,1290,850,1953
2787310130,289950,4,1.75,2090,7416,1,1050,1040,1970
8645511350,300000,3,1.75,1810,21138,1,1240,570,1977
9284801435,471000,4,1.75,1760,5750,1,1070,690,1962
3905010010,639000,4,2.5,2500,8540,2,2500,0,1990
4058801310,287000,2,1,930,6900,1,930,0,1952
6705850020,740000,4,2.5,3030,8335,2,3030,0,1992
1623800440,499922,3,2,1460,3000,1,940,520,1990
3904902500,675000,4,2.5,2940,14071,2,2940,0,1986
7308600050,738515,5,2.75,3360,9200,2,3360,0,2014
5679501310,445000,3,1.75,2110,4800,1,1210,900,1956
3935900005,1.039e+006,4,2.25,2740,11343,1,1980,760,1953
3726800285,346000,2,1,1070,2196,1,880,190,1917
1183000005,450000,3,2,1680,4886,2,1180,500,1940
5469502780,350000,4,2.5,2260,13755,1,2260,0,1975
9185700440,2.4e+006,4,3.5,5860,7200,2,3690,2170,1907
0629600130,594950,4,2.25,2380,35008,1,2380,0,1977
9178601660,1.695e+006,5,3,3320,5354,2,3320,0,2004
2191600780,219000,2,1,1050,9000,1.5,1050,0,1984
7852180430,450000,4,2.5,2070,3982,2,2070,0,2004
8155820080,402000,4,2.25,1790,7311,2,1790,0,1992
5248800440,275000,2,1,840,4000,1,840,0,1942
9818700430,421500,3,1.5,990,4500,1,990,0,1948
0425079099,560000,3,3,4120,60392,2,3180,940,1994
5127000670,314000,3,1.75,1620,9600,1,1620,0,1966
6341000221,287000,4,2,1340,8190,1,1340,0,1942
7231501665,277000,4,1,1500,5750,1.5,1500,0,1925
5014000225,337500,2,1,1300,6731,1,1300,0,1950
4401200130,792000,4,2.75,3100,10245,2,3100,0,1999
1558500050,435000,3,2.5,3380,7074,2,2200,1180,1999
8899000050,313100,4,2.5,2660,9030,1,1450,1210,1977
2877102846,575000,3,2.25,1700,3333,1.5,1100,600,1924
7280300080,510000,4,2.5,1840,7800,1,1240,600,1972
3624039073,299950,2,1,890,5200,1,890,0,1941
3271300345,1.028e+006,3,3,2800,5800,1,1580,1220,1953
6190701483,364000,4,1.75,2010,8625,1,1340,670,1957
0414100630,335000,3,1,1380,7470,1,1380,0,1965
7686202275,219950,3,1,1210,8000,1,1210,0,1954
5113260170,215000,3,2,1280,6994,1,1280,0,1991
2421059090,640000,4,2.5,4090,215186,2,3670,420,1979
2770601734,535000,3,1,1580,6300,1,1180,400,1925
4222310290,253000,4,2,1910,7826,1,1140,770,1973
5016001060,650000,2,2.5,1740,2500,2,1210,530,1994
5445300050,672000,3,2.25,1130,4445,1.5,1130,0,1930
7370600020,606000,3,1.75,1970,8540,1,1130,840,1950
5127000470,292000,3,2.25,1780,9720,1,1280,500,1981
1330250010,289950,3,2,1670,7757,1,1670,0,1992
1898600050,257500,4,1.5,1360,9323,1,1360,0,1968
9561100010,380000,3,2.5,1840,6985,1,1290,550,1971
9524100050,360000,3,1.75,1255,1113,3,1255,0,2010
2212200500,269500,3,1.75,1840,7412,1,1240,600,1976
5416500680,449000,4,2.5,2960,6031,2,2960,0,2005
6412600005,375000,4,1.5,1430,7232,1.5,1430,0,1948
2024069008,2.2e+006,5,4.75,5990,10450,2,4050,1940,2002
2195700050,810000,4,2.5,3480,59242,2,3480,0,1988
1437580480,994000,5,3.25,4260,7861,2,4260,0,2005
2796100680,275000,5,2.25,1820,10500,1,1080,740,1979
7203102140,300000,2,1,1290,2482,2,1290,0,2008
0040000235,380000,5,2.5,2130,8428,2,2130,0,2013
2946000285,200000,3,2,1170,10051,1,1170,0,1957
6848200221,635000,3,3.5,1730,1349,3,1350,380,2009
0952004725,280000,2,1,880,5750,1,880,0,1939
7852110050,574000,3,2.5,2380,6832,2,2380,0,2002
5536100010,1.05e+006,4,1,1330,9729,1,1330,0,1952
5703000050,545000,3,2.25,1780,191228,2,1780,0,1988
6071800480,271950,3,1.5,1220,8400,1,1220,0,1962
1954600050,630000,5,1.75,2490,24969,1,1540,950,1959
3819800280,400000,2,1,1180,10800,1,1180,0,1984
7300400170,334000,4,2.5,2310,6200,2,2310,0,1998
9834201100,332500,4,2,1440,4855,2,1440,0,1972
8850000509,525000,2,1.5,1620,1444,2,1080,540,2007
4123840470,408000,3,2.5,2620,8403,2,2620,0,1991
1150900080,846450,4,2.5,3710,7491,2,3710,0,2003
0514500235,411100,3,1.5,1040,10323,1,1040,0,1958
1522059120,409124,5,3.25,3320,11340,2,2480,840,1999
2895600680,335950,2,1.5,800,5192,1,800,0,1951
8087800480,480000,5,2.5,2040,9597,1,1240,800,1963
7931000066,280000,2,1.75,1960,30144,1,980,980,1957
5406500480,668000,4,2.5,2670,4410,2,2670,0,1999
2540820010,750000,4,2.5,2930,8641,2,2930,0,2010
3300700470,394475,2,1,830,4000,1,830,0,1955
8823902005,848000,5,1.75,2290,4320,2,1980,310,1928
6003001760,675000,3,1.5,2510,3600,2.5,2510,0,1907
1432400095,175000,3,1,1280,7572,1,1280,0,1958
2483700095,560000,4,1.5,1810,6000,1,1350,460,1952
6600220380,538888,5,2.75,2080,13189,2,2080,0,1987
3990200020,359000,4,1.75,1680,9244,2,1680,0,1991
0112900020,300000,3,2.25,1660,5128,2,1660,0,2001
8700110020,273000,3,2.5,1650,5994,2,1650,0,1989
9831200221,670000,3,2.5,1420,1438,2,1280,140,2003
8078400010,530000,4,2.25,2240,8376,1,1740,500,1984
9550200225,625000,3,1.5,1230,3060,1,910,320,1927
2946001950,248000,3,1,1260,6000,1,1260,0,1954
3905050280,533000,3,2.5,2060,4812,2,2060,0,1990
3026059341,549950,4,3.5,3090,10510,1,2190,900,1991
7292700005,485000,4,1.75,3220,7392,1,2010,1210,1959
8856970440,353500,3,2.5,2020,4845,2,2020,0,2001
7504001440,435000,2,1.75,1910,12142,1,1910,0,1976
8068000305,241000,3,1,1150,10000,1,1000,150,1951
1681400010,885000,4,2.75,2730,3560,1.5,1550,1180,1921
6850700670,799200,6,3,2890,2370,2.5,2290,600,1906
1546600020,760000,3,2.5,2280,12746,1,1490,790,1973
8071000050,270000,2,1,1040,5700,1,1040,0,1922
1036000280,675000,4,1.75,2440,7475,1,2040,400,1969
5422560380,499000,3,2.5,1720,5940,1,1000,720,1977
1762600280,1.2025e+006,3,2.5,3430,28718,1.5,3430,0,1984
5416500840,320000,4,2.5,2570,4865,2,2570,0,2005
3523069008,890000,4,3.25,4360,210254,1,2320,2040,2000
8001210170,275000,4,2.75,2060,7350,1,1210,850,1978
6806300920,490000,4,2.5,3020,8302,2,3020,0,1994
9826701665,550000,3,2.5,2340,4200,1.5,1540,800,1906
2253200010,390000,5,2,2400,9537,1,1210,1190,1959
1941400080,277000,3,2.25,1610,11920,1,1110,500,1968
3317010130,236000,3,1.75,1090,7647,1,1090,0,1994
1721059230,265953,3,1.75,1470,13068,1,1470,0,1975
9328500630,545000,3,2.25,1670,6240,1,1240,430,1974
6301800020,535000,3,2.5,1850,10109,2,1850,0,1991
7855000460,1.45e+006,3,2.75,3940,9671,1,2140,1800,1967
9320350020,490000,4,3,2330,3497,2,1920,410,2003
7849201061,319950,4,2.5,2020,7200,1.5,2020,0,1954
3885805640,625000,3,1.5,1300,7200,1,1300,0,1960
8960200630,248000,3,1,1180,6947,1,1180,0,1968
1736800920,475000,3,1.75,1320,7840,1,1320,0,1966
6152900402,410000,6,2.75,2520,9324,1,1320,1200,1962
9822700255,670000,3,2.5,1680,2000,3,1680,0,1909
1423069102,430000,3,2.5,2000,35438,2,2000,0,1968
5279100675,313000,2,1,1180,4900,1,1180,0,1954
2524049056,950000,3,3.25,3330,15093,2.5,3330,0,1988
4232400470,751750,2,2,1880,5400,1.5,1880,0,1902
8562740440,760000,4,2.5,2990,5280,2,2210,780,2003
8114000020,310650,3,1.75,1510,12408,1,1510,0,1969
6600780130,367500,4,3,3110,7231,2,3110,0,1997
5100403947,580000,4,2.5,2150,5000,2,2150,0,2001
1189000825,580000,3,2.25,1900,3960,1.5,1200,700,1905
3066400080,665000,4,2.5,2720,10000,2,2720,0,1987
2214800630,239950,3,2.25,1560,8280,2,1560,0,1979
4027701253,470000,4,2.5,1990,30083,2,1990,0,1998
9547205260,733000,3,1.75,1740,3060,1,950,790,1930
9320600020,250000,4,2,2130,8400,1,1350,780,1962
2807100095,402000,4,1.75,1510,9176,1,1510,0,1957
8067000020,295000,5,3.5,2100,5107,2,1410,690,1999
8731980440,355000,5,2.5,2344,8000,1,1560,784,1976
5112800233,289000,3,1.5,1970,22486,1,1970,0,1968
6141600179,376000,3,2.25,1470,9140,2,1470,0,1982
8122100595,212700,2,1,940,5040,1,940,0,1926
5467910190,325000,3,1.75,1780,13095,1,1780,0,1983
0808300460,415000,4,2.5,2230,5743,2,2230,0,2002
7785350010,935000,3,2.5,3570,15151,1,2400,1170,1981
2133020020,372000,3,2.5,1920,15260,2,1920,0,1990
2588800006,240000,3,1.5,1290,8366,1,1020,270,1957
5169700022,334950,3,1.75,1880,16262,1,1880,0,1980
5416500660,426500,4,2.5,2960,4640,2,2960,0,2005
6117502745,430000,2,1.75,1840,14874,1,1300,540,1952
2624049169,400000,3,1.5,1890,6183,1,1090,800,1967
1426300842,455850,3,2.25,1820,6000,1,1120,700,1964
0824059321,1.96522e+006,4,3.5,4370,8510,2,3610,760,2003
0126049217,400000,3,1.75,1530,10731,1,1530,0,1986
2201500185,397500,3,1,1030,10480,1,1030,0,1954
1972205790,755000,3,2.5,2000,1950,3,2000,0,2005
6843000080,287000,5,1.5,1730,9230,1,1010,720,1962
1442700250,480000,4,2.5,3620,16000,2,3620,0,1976
2607760680,490000,3,2.5,2040,9622,2,2040,0,1995
3523059056,365000,3,2.5,2640,6715,2,1680,960,1991
1657530010,260000,3,2.5,1600,2244,2,1600,0,2005
7276100020,505000,4,1,1480,12675,1.5,1480,0,1929
9828200460,260000,2,1,700,4800,1,700,0,1922
9828200460,430000,2,1,700,4800,1,700,0,1922
5608000840,905000,4,2.5,3520,12193,2,3520,0,1993
5422560470,440000,3,2,1650,6408,2,1650,0,1977
0446000020,439500,4,1,1360,5500,1.5,1360,0,1950
9476200545,270000,3,2,1350,6696,1,680,670,1944
8648100130,306500,3,2.5,1970,6291,2,1970,0,1998
9358002232,380000,3,2,1470,1656,2,1310,160,2003
2212900920,215000,4,1.75,1610,9652,1,1610,0,1969
6149700380,299900,2,1,810,6150,1,810,0,1950
4340000080,1.45e+006,4,3.5,2820,7809,2,2820,0,1995
3751605432,239950,3,1,1900,33888,1.5,1900,0,1942
6384300020,494000,4,2.5,1830,7345,1,1540,290,1973
3450300430,317500,4,1.5,1730,7700,1,1010,720,1963
1245001763,670000,4,2.5,2110,7291,2,2110,0,1977
7853240660,650000,3,2.5,3060,7831,2,3060,0,2004
3723800414,852000,4,2.5,2620,7328,2,2620,0,1983
5104500020,250000,2,1.5,1088,1360,2,1088,0,1983
5438000080,264950,3,1.5,1400,10853,1,1400,0,1964
9498200091,582500,2,2,1540,6804,1,1020,520,1942
1498301213,384000,3,2.5,1540,1564,2,1300,240,1998
2652500285,817000,3,1.5,2310,3360,1.5,1790,520,1926
5127000430,320000,4,1.75,1730,9520,1,1730,0,1971
4017110020,445800,4,2.25,2070,39446,1,1470,600,1977
3336001946,263300,2,1,900,4500,1,900,0,1951
5253300387,215000,3,1,860,6635,1,860,0,1952
9222400605,842500,5,4,2980,4500,1.5,2070,910,1921
9222400605,850000,5,4,2980,4500,1.5,2070,910,1921
2163300130,386000,5,2.5,2740,12413,2,2740,0,1990
8662500130,251100,4,2.5,1790,5257,2,1790,0,1996
1770000130,435000,3,1.75,1750,16748,1,1330,420,1978
1888120080,870000,4,4,3610,12811,2,3610,0,2000
0862000020,800000,6,1,1430,20620,2,1430,0,1954
7199100020,555000,3,1.75,1570,15500,1,1570,0,1968
9169600275,280000,2,1,2280,37500,2,2280,0,1932
2767601815,356000,3,1,940,2366,1,940,0,1916
7853221330,675000,4,2.5,2920,6000,2,2920,0,2004
7504010780,605000,4,2.25,2260,11900,2,2260,0,1976
5015000190,690500,5,2,2000,4211,1.5,1280,720,1908
8682260470,437000,2,1.75,1440,4225,1,1440,0,2005
4122700020,850000,5,2,2310,13430,1.5,2310,0,1966
8850000285,350000,4,2.25,2300,4600,1.5,1340,960,1904
4174600185,480000,2,2.25,1490,6770,1.5,1490,0,1926
7229800430,379500,3,2.25,1830,25641,2,1830,0,1989
0042000130,600000,5,4.5,4440,9784,2,4440,0,2012
4139430250,1.436e+006,4,3.5,4970,16582,2,3930,1040,1992
9834201470,303000,2,1.5,1000,1075,2,840,160,2007
4058801702,800000,4,2.5,4940,10037,1,3450,1490,1953
3363400655,549000,2,2,1980,6000,1.5,1220,760,1906
8700500020,324950,3,2.5,1560,9600,1,1210,350,1964
8148600020,170000,2,1,870,6537,1,870,0,1948
8651430780,178000,3,1,840,6500,1,840,0,1969
1432400345,144000,3,1,1250,8314,1,1250,0,1958
2524049148,1.58e+006,4,2.75,3120,20031,1,1980,1140,1954
2475900840,258000,2,1,750,7000,1,750,0,1932
7452500190,345000,3,1.75,710,5050,1,710,0,1950
3459000050,470000,3,1.75,2290,14800,1,1620,670,1965
2624049091,2.903e+006,5,2.5,3750,91681,2,3750,0,1925
1138000250,350000,3,1.5,980,7790,1,980,0,1969
4399210130,225500,2,1.75,1590,11276,1,1590,0,1972
2770601365,473000,2,1,940,4000,1,720,220,1942
7272000980,279000,3,1.75,1750,9623,1,1150,600,1962
1566100010,470000,3,1,1460,8227,1,880,580,1948
6338000592,565000,3,1.75,1540,4800,1,770,770,1925
2815600305,695000,3,2,2560,6800,1,1380,1180,1952
0561500290,315000,3,1.75,1660,37642,1,1660,0,1991
3905080280,529000,3,2.5,1880,4499,2,1880,0,1993
0925069071,750000,5,3.75,3500,101494,1.5,3500,0,1967
2426049174,481500,3,2.25,1840,10500,2,1840,0,1993
9407600250,211000,3,2,1060,7412,1,1060,0,1987
7955050170,455000,3,2.25,1790,7500,1,1390,400,1973
7224000950,238950,2,1,810,4838,1,810,0,1938
0464001025,722500,4,3.5,2600,5100,2,1820,780,2003
5569700020,795000,4,2.5,3230,19193,1,2000,1230,1973
1310910290,327500,4,2.25,2240,9600,2,2240,0,1971
5104531640,585000,4,3,3400,5100,2,3400,0,2006
1025039145,775000,4,2,3140,10875,1,1940,1200,1939
5406500170,645000,4,2.5,2780,4200,2,2780,0,2001
1826049426,445000,4,2.75,2320,12368,1,1670,650,1968
2011000010,257950,3,1.75,1370,5858,1,1370,0,1987
9368700006,375000,5,1.75,2230,7560,1,1230,1000,1959
8016250080,245000,3,2.5,1610,7223,2,1610,0,1994
4053200285,725000,3,2.5,3410,41022,2,3410,0,1990
5411600020,702000,4,2.5,2810,4922,2,2810,0,2005
0847100078,330000,3,1.75,1850,14986,2,1850,0,1943
4232903295,940000,3,1.5,1790,4800,1.5,1790,0,1912
7979900680,354500,3,1,1150,11396,1.5,1150,0,1950
0492000532,279950,4,2.75,2420,8700,1.5,2420,0,1914
2310000430,284000,3,2.25,1580,7034,1,1180,400,1989
8832900780,480000,5,2,1760,21562,1,1560,200,1959
8832900780,647500,5,2,1760,21562,1,1560,200,1959
3249500020,625000,3,2.5,2750,35000,2,2750,0,1993
8651442810,152000,3,1,920,4875,1,920,0,1978
8564500020,322000,3,1,960,10181,1,960,0,1961
3019300050,445000,3,1.75,1120,4000,1,870,250,1916
2460900020,595000,3,1,1560,3960,1.5,1560,0,1907
2698200010,165000,3,1,1380,7334,1,980,400,1981
0104560010,278500,4,2.5,1940,6206,2,1940,0,1990
5710610430,517500,3,1.75,1810,10625,1,1370,440,1973
0034000005,343566,2,1,1100,4200,1,1100,0,1954
7349400420,286285,4,2.25,1980,9714,1,1170,810,1977
3298300130,474905,4,1.5,1340,6200,1,1340,0,1959
7312400080,550000,3,1.75,1680,4800,1,1400,280,1960
3356404198,286000,4,2.5,2060,16000,2,2060,0,1993
2344300122,900000,3,3.25,2620,7215,1,1770,850,1980
3904901330,449950,3,2.25,1610,5159,2,1610,0,1985
7524100280,259000,4,1.5,1490,7560,2,1490,0,1966
2473390440,340000,3,2.25,1900,8125,1,1540,360,1969
2215800050,785000,4,2.5,3440,56192,2,3440,0,1994
2769602475,490000,2,1,1840,3300,1.5,1130,710,1910
9183700470,344950,4,2,2330,6250,1,1400,930,1941
1337800284,950000,3,2,2250,2975,2,1880,370,1905
3867400130,810000,4,1.75,2000,3988,1,1000,1000,1958
7856410020,998160,2,2.5,3010,16050,1,1260,1750,1976
9477730080,377000,3,1.75,1680,7389,1,1150,530,1979
3300760020,595000,3,2,1530,6773,1,1530,0,1984
0148000440,313300,2,1,970,4800,1,970,0,1911
1708400595,360000,5,1.75,1550,5225,1.5,1550,0,1941
9264901680,188000,3,1.75,1660,7350,1,1660,0,1979
3226079091,755000,3,2.5,3680,203860,1.5,3680,0,1994
2877104175,1.289e+006,5,3.5,3210,4060,2,2290,920,1917
8843900396,455000,3,1,1480,13280,2.5,1480,0,1940
1425059193,817500,5,3.5,3600,9312,2,2680,920,2005
5694000768,550000,3,2.25,1700,1481,3,1700,0,2002
8732190460,260000,3,1.75,1680,8725,1,1240,440,1978
0723099028,320000,3,2,1550,34175,1.5,1550,0,1999
4139480190,1.153e+006,3,3.25,3780,10623,1,2650,1130,1999
1133000050,362000,4,2.5,2360,7370,1,1460,900,1985
2770601462,503500,3,2.5,1810,1750,2,1350,460,1997
3630120480,653000,3,2.5,2290,3475,2,2290,0,2006
0624110050,760000,4,2.75,3370,12447,2,3370,0,1991
2301400655,775000,4,1.75,2090,5050,1,1090,1000,1916
7936500190,1.339e+006,4,3.75,2130,34689,1.5,2130,0,1955
0126039323,417500,5,1.75,2060,10911,1,1360,700,1954
9512500460,525000,3,1.5,1560,9350,1,1220,340,1969
7203601405,217000,2,1,730,2400,1,730,0,1934
6204200170,525000,4,2.75,2910,6308,1,1640,1270,1985
5027800190,442500,4,2.25,2490,8700,1,1890,600,1976
2206500430,525000,4,1.75,1710,10440,1,1710,0,1955
9477001410,425500,4,1.75,1520,10630,1,1520,0,1967
2324079073,710000,3,2.75,2930,218235,2,2930,0,1990
2817210420,545000,4,3,3160,10948,1,1930,1230,1991
1402200440,410000,5,2.75,2910,16410,1.5,2910,0,1967
1545808370,245000,3,2.25,1700,8100,1,1200,500,1980
7335400500,194900,2,1,810,6697,1,810,0,1923
1843130980,284000,4,2.5,2000,5390,2,2000,0,2003
9262800255,280000,2,1.75,1894,52769,1.5,1520,374,1936
8656800190,280000,3,1.75,2080,87991,1,1040,1040,1970
2113700235,360000,4,2,1730,5500,1,1010,720,1943
4235400255,405000,2,1,720,4323,1,720,0,1942
8691360380,865000,4,2.5,3560,13981,2,3560,0,2000
2205500080,483300,4,2,1210,11100,1,1210,0,1955
4137000250,355000,4,2.5,2130,9268,2,2130,0,1985
2310010050,274950,3,2.25,1570,8767,1,1180,390,1990
1370802115,1.925e+006,3,4.5,3950,6134,2,2880,1070,1998
6117900010,755000,3,3.25,3450,15586,2,2690,760,1989
2626069030,1.94e+006,4,5.75,7220,223462,2,6220,1000,2000
9407102360,309212,3,1.75,1150,9600,1,1150,0,1979
0104510440,219950,3,2.25,1500,7615,1,1150,350,1984
7519000170,690000,3,2.5,1300,5150,1.5,1300,0,1920
2113700500,250800,3,1.75,1290,4000,1,1170,120,1943
1560930050,557500,3,2,2510,35255,1,2510,0,1994
9550204590,941000,4,1.75,2320,3825,1.5,1820,500,1926
4217402115,3.65e+006,6,4.75,5480,19401,1.5,3910,1570,1936
9412710440,305000,4,2.75,2030,8600,1,1230,800,1977
6043400006,815000,4,1.5,2060,16110,1,2060,0,1949
1024039049,1.015e+006,3,2.5,2920,34527,1,1800,1120,1954
1250204835,1.24e+006,4,3,3330,6990,1.5,2330,1000,1928
6388920460,535000,3,2.5,2110,8164,2,2110,0,1990
1925059049,775000,3,1,1175,10454,1,1175,0,1949
7760400420,255000,3,2,1590,8670,1,1590,0,1994
6163901271,327000,2,1,1070,9750,1,1070,0,1947
5437200050,560000,4,2,2720,8819,2,2240,480,1976
3885806565,1.339e+006,4,3.5,2980,6349,2,2980,0,1998
8651443190,199500,3,1.75,1160,5200,1,1160,0,1977
1722069145,760000,4,2.5,3580,97574,2,3580,0,2004
7883605985,439000,3,2.25,3020,6000,3,1980,1040,1994
4038700190,527000,4,2.25,2380,5250,1,1410,970,1961
8661000089,199950,3,2.75,2270,13590,1.5,1300,970,1948
2329800430,254000,3,2.25,1660,8188,2,1660,0,1988
6431500280,393000,2,1,830,5000,1,830,0,1921
6204430250,585000,5,2.25,2480,12614,1,1860,620,1979
4365200630,450000,2,2,1900,7740,1,1150,750,1923
3630120050,565000,2,1.75,1670,4008,1,1670,0,2005
7844200050,330000,5,2.25,2000,7900,1,1300,700,1986
1240700006,870000,3,2,2320,65340,1.5,2320,0,1992
8563000470,585000,4,2.5,1860,8117,1,1460,400,1966
3221069091,500000,3,2.5,2110,208737,2,2110,0,1977
8645530010,225000,3,2,1400,7384,1,1150,250,1979
8645530010,295000,3,2,1400,7384,1,1150,250,1979
2141300420,775000,3,2.75,2850,14800,1,1920,930,1976
9407101900,280000,3,1,1370,11050,1,1370,0,1981
1931300425,539000,3,2.5,2170,3200,1.5,1280,890,1923
9290800050,567500,3,1.75,2570,14033,1,2570,0,1953
9421500010,442500,4,2.25,1970,7902,1,1310,660,1960
3333500151,598200,5,3.75,2980,4635,3,2980,0,1997
3759500006,610000,4,2.5,2300,10843,2,2300,0,1955
4221270290,544900,3,2.5,1990,4936,2,1990,0,2004
1775801405,557500,4,2.5,2390,38258,2,2390,0,2001
3575302575,532500,3,2.5,2160,7500,1,1430,730,1979
2581300010,1.35e+006,4,3.25,3300,15907,2,3300,0,1985
8805900080,750000,3,2,1840,2825,1,1040,800,1920
8121200460,530000,3,2.5,2030,10958,2,2030,0,1983
2461900609,346100,3,2.5,1400,2036,2,1400,0,2003
3298600440,260000,4,2.25,2320,16800,2,2320,0,1977
0643300010,365000,3,1.75,1410,9150,1,1410,0,1959
0224069102,615000,3,2,1860,42800,1,930,930,1983
8856960050,318400,4,2.5,1820,6916,2,1820,0,1994
4024101478,498500,4,2.5,1910,7172,2,1910,0,1993
1839910470,450000,3,1.75,1540,7490,1,1540,0,1971
3668000670,200000,3,2,1430,7905,1,1430,0,1988
1274500420,234000,3,1,1010,8906,1,1010,0,1968
8151600470,121800,2,1,940,8384,1,940,0,1947
0056000095,805000,3,2.75,2600,5875,1.5,1600,1000,1929
3432500980,410000,4,2.25,2060,7283,1,1220,840,1963
7940700050,475000,3,2.5,1920,4534,2,1920,0,1986
1025039292,1.3375e+006,4,2.5,2900,21074,2,2900,0,1986
3438503140,269000,1,1,1020,7920,1,1020,0,1947
7558750190,573000,4,2.25,2150,9520,2,2150,0,1979
3395040440,330000,3,2.5,1660,2890,2,1660,0,2001
4338800190,252750,4,1,1230,7410,1.5,1230,0,1944
8682290670,745000,2,2.5,2170,7546,1,2170,0,2007
5113260430,280000,3,2,1280,7633,1,1280,0,1991
0387000190,535000,4,2.5,2240,6920,1,1380,860,1974
6844703135,580000,4,1.5,1780,5100,1,1320,460,1953
8899000190,301000,3,1.75,1840,7200,1,1220,620,1968
3275760190,600000,4,1.75,1740,7700,1,1740,0,1968
3438500924,538900,5,3,3040,6604,2,3040,0,2005
5104530430,366000,3,2.5,2370,4375,2,2370,0,2006
5468770250,303000,4,2.5,2100,6783,2,2100,0,2003
4318200440,432000,3,2.25,1470,1578,2,1090,380,2007
1721800190,300000,2,1.5,1300,6120,1,820,480,1945
1250202285,908800,3,3,3420,7826,2,2430,990,1939
2767602945,500000,3,1.5,1190,4750,1,970,220,1940
0321049090,254000,5,2,2080,16117,1,1740,340,1959
4443801495,470000,5,1.5,2180,4268,1.5,1340,840,1924
3275750290,480000,3,2,1460,7860,1,1460,0,1967
2273600460,536000,3,1.75,1530,8503,1,1150,380,1983
8562720420,1.349e+006,4,3.5,4740,8611,2,3640,1100,2006
1330900250,550000,3,2.25,1980,40887,1,1980,0,1980
1099600250,260000,3,1.75,1710,6400,1,1240,470,1976
1445200190,284900,2,1.5,1160,982,2,890,270,2006
1929300052,740000,3,2.5,2200,3000,2,1530,670,2002
7626200280,425000,2,1,1170,5000,1,1030,140,1920
7211402115,230000,3,1,1120,7500,1,1120,0,1965
0324000280,675000,3,1.5,1710,4000,2,1710,0,1926
8091410080,267500,3,1.75,1650,7807,1,1650,0,1986
6616000010,814000,4,2.5,2840,8820,1,1420,1420,1952
1125069102,1.25e+006,4,3,3310,217800,1.5,3310,0,1989
6413600151,460000,3,2,1860,7232,1,1320,540,1985
2607720420,445000,3,2.5,2250,9608,2,2250,0,1994
1854900470,715000,3,2.5,2890,7027,2,2890,0,2004
8901000911,425000,3,1.75,2120,5992,1,1060,1060,1947
3709600190,370000,4,2.5,2130,4750,2,2130,0,2009
0537000255,302000,2,1.75,1170,8200,1,780,390,1937
4036800170,453000,4,1.75,2120,7420,1,1060,1060,1956
5127100190,290000,3,1.75,1280,10716,1,1280,0,1969
1762600190,1.035e+006,4,2.5,3170,47502,2,3170,0,1988
7796100080,925000,4,2.25,2260,41984,1,2260,0,1967
9465910190,600000,3,1.75,2930,19876,1,2030,900,1993
9284801845,354000,3,1.5,1060,5750,1,1060,0,1981
3210200373,204950,4,1.75,1740,9344,1,1180,560,1978
1854900430,675000,4,2.5,2990,5400,2,2990,0,2005
2944000050,995000,4,3.25,3530,20012,2,3530,0,1986
7971300020,800000,5,2,2960,10960,1,1500,1460,1957
1542800010,472500,3,2.5,1650,3711,2,1650,0,1996
1433500050,549950,4,2.5,2720,13500,1,1510,1210,1969
9482700080,575575,3,1.75,1516,2897,1,998,518,1925
3303870050,545000,4,3.25,4386,12275,1,2356,2030,2006
2071700010,340000,3,2.25,2580,7434,1,1630,950,1963
0421000430,225000,3,1,960,5512,1,960,0,1963
2787460430,299950,2,1.75,1460,10506,1,1460,0,1983
2436200185,829900,4,3.5,3840,4000,2,2640,1200,2001
9542830440,340000,4,2.5,2090,4200,2,2090,0,2007
0023500190,515000,4,2.25,2470,7800,1,1470,1000,1975
3905030190,601000,4,2.5,2090,6906,2,2090,0,1992
8079050010,470000,3,2.5,2070,8581,2,2070,0,1994
3172600095,371500,3,1,1650,6400,1,980,670,1954
0126059242,550000,3,1.75,1880,45738,1,1410,470,1980
2944510080,242550,4,2.5,2060,7720,2,2060,0,1995
7019000050,367500,3,1.5,1410,9647,1,1410,0,1961
7212680460,359000,4,3.5,2770,8763,2,2100,670,1996
5706600170,204900,3,2,1390,8245,1,1390,0,1984
3322049005,850000,4,2.75,5440,239580,1,2720,2720,1969
7338000950,187000,3,1.5,1280,4452,2,1280,0,1985
3323059027,326000,3,2.75,1720,28000,1,1720,0,1958
3323059027,340000,3,2.75,1720,28000,1,1720,0,1958
5502700005,330000,6,2.25,3040,28535,1,1890,1150,1951
7205930050,782000,4,3.5,3780,7769,2,3110,670,2001
1853200190,612000,4,2.5,2670,5974,2,2670,0,1999
2697400020,400000,3,2,1350,7216,1,1350,0,1964
0226039316,941500,5,3.5,3490,9680,2,2460,1030,1980
3126049439,313000,2,1.5,870,747,2,800,70,2004
3491300052,735000,4,2.25,2410,4250,1.5,1460,950,1929
6662410020,471000,3,1.75,1640,10123,1,1340,300,1977
6139100086,350000,3,1,1540,9800,1,1540,0,1950
5710610670,530000,4,2.5,2370,9601,1,1570,800,1976
7503000020,415000,4,3,1830,9548,2,1830,0,1991
1795920440,639500,4,2.25,2330,8994,2,2330,0,1986
3570000130,580379,4,2.75,2240,27820,1.5,2240,0,1976
7853340430,378000,2,2.5,1700,2513,2,1700,0,2009
2473380010,265000,3,2.25,1750,9298,1,1410,340,1969
3306300630,212000,3,1.75,1100,9750,1,1100,0,1967
3222049120,400000,4,3,2320,13068,2,2320,0,1998
2425059173,750000,4,2.5,2540,6491,2,2540,0,1997
1196000007,384900,5,2.5,3090,12750,1,1750,1340,1968
8651402910,176000,2,1,770,5200,1,770,0,1969
3558000130,350000,3,2.75,2370,4632,2,2370,0,2002
3830210020,168000,3,1,1200,7210,1,1200,0,1977
7950302210,358000,4,2,2200,3060,1,1100,1100,1908
1774200190,580000,3,2.75,2660,32757,1,2660,0,1975
3715500170,442500,3,1.75,1600,10280,1,1050,550,1977
2436700655,515000,2,2.5,1330,1249,3,1330,0,2004
5072100095,554000,5,2.5,3440,12900,1,1720,1720,1958
0305000170,659000,3,2.5,2510,6320,2,2510,0,1996
2570300130,414999,4,2.5,2150,10098,1,1090,1060,1963
0776600130,275000,3,1.5,1180,10277,1,1180,0,1983
5379802181,193000,2,1,680,8640,1,680,0,1951
9558020380,525000,4,2.5,2840,4750,2,2840,0,2002
3396830020,424000,3,2.5,1820,7500,2,1820,0,1985
7519001825,455000,2,1,1070,5150,1,870,200,1908
2324039069,463000,2,1,1250,5650,2,1250,0,1943
1245500950,1.1e+006,4,2.5,2190,6300,1,1240,950,1960
5100404030,523000,3,1.75,3000,5413,2,1900,1100,1963
9542000050,615000,4,1.75,2270,9830,1,2270,0,1959
5608000630,1.515e+006,4,4,4500,11795,2,4500,0,1991
0475001235,870000,5,4,3400,5000,2,2320,1080,1900
2725069150,710000,3,2.5,2830,9680,2,2830,0,1991
9202000080,215000,3,1,960,9563,1,960,0,1967
0225039049,590000,2,1,1530,6450,1,1530,0,1920
2212500430,323000,5,2.5,2500,13034,1,1300,1200,1962
2473100010,279000,4,2,1560,7569,1.5,1560,0,1966
2795000080,535100,3,2.25,2070,7207,1,1720,350,1973
9541800010,830000,5,2.25,2710,19800,1,1910,800,1959
2619920010,815000,4,2.5,3150,4203,2,3150,0,2002
4046400010,535900,3,2.25,1880,10880,1,1480,400,1975
7642200095,230000,3,1,1250,8800,1,1250,0,1955
8899000430,325500,4,1.75,2290,8142,1,1490,800,1969
8944750480,359000,3,2.25,1990,4331,2,1990,0,1997
7852020660,505000,3,2.5,2100,5824,2,2100,0,1999
7789000080,253905,3,1,940,8400,1,940,0,1958
6413100122,369950,3,1.75,1640,4860,1,1200,440,1965
8856960280,350000,3,2.25,1860,8378,2,1860,0,1995
1868901190,650000,4,2.25,2100,2500,3,2100,0,2001
3123039136,295000,3,1.75,1500,15246,1,1500,0,1925
3585300415,620000,3,1.75,1680,28046,1,1180,500,1948
2624089007,1.998e+006,2,2.5,3900,920423,2,3900,0,2009
4338800170,246000,3,1,1400,7410,1,1400,0,1944
4046501300,430000,3,2.75,2600,12860,1,1350,1250,1965
3331001995,509990,3,2,1440,4859,2,1440,0,1921
0802000130,490000,4,1.75,1870,9500,1,1090,780,1962
2011400779,385000,4,2.75,2960,10454,1,2360,600,1979
8651610660,769000,4,2.5,2440,6733,2,2440,0,1999
1788900380,185000,2,1,1122,9100,1,1122,0,1960
2121000250,303500,3,1.5,1060,10464,1,1060,0,1973
2110900050,468000,4,2.5,2150,8165,1,1430,720,1957
5469503280,449950,4,2.5,3100,10000,2,3100,0,1978
6300000364,235000,2,1.5,880,1805,2,880,0,1999
2616800050,520000,4,2.5,2490,34947,2,2150,340,1985
1446400648,203000,2,1,1080,9067,1,1080,0,1951
4038700380,657000,5,2.5,2530,10190,1,1290,1240,1960
9109000050,275000,3,1,1200,7800,1,1200,0,1954
9465910380,540000,4,2.25,2850,7453,2,2850,0,1991
1137400460,455000,4,2.5,2950,4502,2,2950,0,2005
2545700020,458500,2,1.75,1160,6828,1,860,300,1941
3260570290,549900,4,3.5,3420,4751,2,3420,0,2003
5652600185,750000,3,1.75,2240,10578,2,1550,690,1923
7347600507,235000,4,1.75,1450,8891,1.5,1180,270,1962
1545802850,286000,4,2.5,1820,7930,2,1820,0,1989
3126059027,2.65e+006,4,3.5,4700,13730,2,3500,1200,1958
8087800430,602000,4,1.75,2430,14000,1,1580,850,1963
9547200460,640000,3,1.5,1960,4080,1.5,1960,0,1915
3826501060,267000,3,1.75,1440,10920,1,1440,0,1977
5406500430,712000,4,2.5,2730,4385,2,2730,0,2001
5417600130,244500,2,1,910,9000,1,910,0,1923
5417600130,301000,2,1,910,9000,1,910,0,1923
2138700345,990000,4,2.5,2430,6325,2,2020,410,1919
5611500170,739999,4,2.75,3350,6500,2,3350,0,1999
5700002125,480000,4,1.75,2320,4322,1,1140,1180,1910
1473200170,305000,3,2.5,1260,1622,3,1260,0,2009
2922702965,703300,3,2,1980,3525,1.5,1590,390,1932
7895500290,265000,4,1.5,1580,8468,2,1580,0,1971
7338200170,600000,4,2.5,2710,35009,2,2710,0,1992
6929603769,253000,3,1,1400,9750,1,1400,0,1968
9429000170,617950,4,2.5,2410,7950,2,2410,0,1997
2114700190,385000,4,3.25,1790,2460,2,1100,690,2000
0323049148,319000,3,2,1640,9234,1,1060,580,1967
4038700290,696000,3,2.5,1670,8023,1,1170,500,1960
9284802045,345000,2,1,970,5750,1,970,0,1932
3188100007,380000,3,2.5,1610,1778,3,1610,0,2002
0001200019,647500,4,1.75,2060,26036,1,1160,900,1947
2616800480,725000,3,2.5,3570,35271,2,3570,0,1997
2310000380,269950,3,1.75,1400,7735,1,1400,0,1989
4054560170,875000,4,2.5,3470,32109,2,3470,0,1995
7972601900,299950,3,1,1210,9525,1,1210,0,1955
3391500050,1.875e+006,4,3.25,3930,10929,2,3930,0,2006
8132700190,430000,2,1,990,4802,1,990,0,1947
3904990430,495000,5,2.5,2200,4942,2,2200,0,1989
5469700052,275000,3,1.5,1510,16200,1,1510,0,1970
4006000509,333000,3,1,1620,5040,1,1120,500,1964
9269750460,247000,3,2.25,1580,7941,2,1580,0,1986
2721059173,204555,3,1.75,1260,15000,1.5,1260,0,1983
3981200660,432000,3,2,2190,13673,1,2190,0,1994
4012800050,175000,3,1.75,1230,13056,1,1230,0,1962
3275750050,556300,4,2.5,2030,7140,1,1400,630,1968
8572900275,286000,2,1,780,3475,1,780,0,1930
0993000950,320000,2,1.5,1110,1200,3,1110,0,2000
0426069099,815000,3,2.5,2790,53143,2,2790,0,1991
3276180020,385000,4,1.75,1660,10757,1,1000,660,1980
5700001640,1.039e+006,4,1,3410,5000,2,2190,1220,1910
9264940130,350000,4,2.25,2390,13002,2,2390,0,1987
7300400670,277000,4,2.5,1850,5880,2,1850,0,1998
4112100101,415000,6,2,2500,5200,1,1250,1250,1966
6163901381,295000,3,1,1000,8320,1,1000,0,1951
7603100020,969000,4,2,2450,5000,2,2200,250,1919
4302200415,339888,4,1.75,1440,6144,1,720,720,1947
3876760430,269950,3,2.25,1660,7003,2,1660,0,1996
3754501235,1.185e+006,3,2.5,2510,4600,2,2510,0,2006
8691330500,780000,4,2.5,3090,12511,2,3090,0,1998
8651401680,198000,3,1,860,5185,1,860,0,1968
8011100050,350000,2,1,1220,28703,1,1220,0,1953
3768000280,350000,3,1,1010,7680,1,1010,0,1967
1321710460,319000,4,2.25,2390,7350,2,2390,0,1990
8731981680,311000,4,2.25,3340,8000,2,3340,0,1973
7714000250,394000,5,3.25,3620,4650,2,2790,830,2004
1336800010,1.335e+006,5,2.25,4200,5800,2.5,2910,1290,1906
5442300807,2.7e+006,5,2.75,3831,13800,2,3831,0,1959
6190701112,396000,3,1,1980,9540,1,1080,900,1949
2680700280,809000,4,1.75,1790,8372,1,1340,450,1976
1025059181,480000,3,2,1580,7400,1,1050,530,1977
3856900005,535000,6,1.75,2460,6000,1,1230,1230,1913
4302700425,425000,5,2.75,2110,5120,2,1870,240,1947
6824100005,408000,3,2.5,1470,1204,3,1470,0,2006
3625600190,1.255e+006,4,2.5,3510,13100,2,3510,0,1966
7588700177,310000,1,0.75,520,2885,1,520,0,1947
3303950080,292000,3,2.5,1950,7421,2,1950,0,1996
0985000950,217000,2,1,770,9715,1,770,0,1942
8011100005,398500,4,2.5,2250,6064,2,2250,0,2005
5316100980,2.25e+006,3,3,4040,7200,1.5,3340,700,1930
6819100345,700000,4,1.75,2360,6000,1,1280,1080,1955
3276930420,585000,4,2.5,2330,45860,2,2330,0,1989
6648900005,399950,3,1,1720,8910,1,1720,0,1954
6083000050,235000,3,1.75,1900,8540,1,950,950,1980
1180008315,212000,3,1,1040,6800,1,1040,0,1951
8651510380,310000,3,2,2070,9195,1,1220,850,1982
8651510380,539000,3,2,2070,9195,1,1220,850,1982
9826701794,390000,3,3,1550,1608,2,1280,270,2001
2790400380,560000,3,2.5,2020,11935,1,2020,0,1976
6979940050,800000,5,2.5,3320,9024,2,3320,0,1999
1727001300,1.9e+006,4,3.25,4130,112521,2,4130,0,1978
0686100380,472000,5,2,2030,9804,1,1110,920,1963
4037400280,502550,3,1.75,1770,7875,1,1170,600,1958
8691400010,830000,4,3.25,3330,7809,2,3330,0,2004
1450300050,224950,4,2.5,2260,9686,1,1520,740,1965
4024101440,375000,3,2.5,1950,6871,2,1950,0,1997
0624100010,645000,3,2.5,2930,19900,1.5,2930,0,1983
9523102580,599000,3,2.75,1960,2500,1.5,1410,550,1926
7429000130,515000,4,2.5,2980,12534,2,2980,0,1996
7335400345,135000,2,1,780,6685,1,780,0,1948
7215721330,485000,3,2.5,1650,4218,2,1650,0,2000
3117100130,890000,3,3.25,4030,12765,2,2800,1230,1975
2868900020,215000,3,1,1010,10125,1,1010,0,1972
5703500130,299500,3,1,1190,9600,1,1190,0,1981
3025059136,800000,2,1,1050,8750,1,1050,0,1951
6679000130,275000,3,2.5,1560,4244,2,1560,0,2002
4222500020,256400,3,1.5,1490,7800,1,1010,480,1963
3997500130,310000,2,1,770,8149,1,770,0,1948
9834201205,385000,1,1,620,5100,1,620,0,1954
0806000020,203000,3,1.5,1200,9120,1,1000,200,1963
0507100005,285000,4,2,2120,6865,1,1060,1060,1954
8635760480,473975,3,2.5,2330,3610,2,2330,0,1999
1328330190,320000,3,1.75,2000,9760,1,1400,600,1978
2919702040,599000,5,2.75,2820,4608,1,1450,1370,1967
3095000095,580000,3,2,2040,4800,1,1020,1020,1925
0304100010,269500,4,2.25,1700,7056,2,1700,0,1999
0617000089,274000,2,1,820,6200,1,820,0,1954
3582750280,347000,2,1.75,1315,2162,2,1315,0,1974
3438500430,270000,3,1.75,1390,10905,1,860,530,1957
8964800225,1.43e+006,3,2,1890,12017,1,1890,0,1949
2013801350,220000,3,1.75,1460,7226,1,1460,0,1993
1320069163,243000,3,1,1480,15416,1,1480,0,1955
7549800168,457500,3,1.75,1840,4030,1,1050,790,1925
3226049466,340000,2,1.75,1880,7208,1,940,940,1951
9822700285,657500,4,1.5,1910,5000,1.5,1610,300,1912
0538000250,332500,4,2.5,2220,4720,2,2220,0,1998
5702450250,340000,3,2,1410,10015,1,1410,0,1993
8835900086,350000,4,3,3380,16133,1,2330,1050,1959
3333002302,428000,4,2.5,1950,5602,1,1120,830,1966
7787120500,515055,4,2.5,2400,8320,2,2400,0,1999
8563010420,450000,3,1.75,1560,8968,1,1560,0,1972
3361400190,190000,3,1,1040,8910,1,1040,0,1943
1024039001,1e+006,4,2.75,3090,16538,3,2590,500,1919
6806100420,299000,3,2.5,1850,4600,2,1850,0,2005
3204300225,508000,2,1,1200,2500,2,1090,110,1927
8857640420,294000,4,2.25,2190,3746,2,2190,0,2005
4443800130,320000,2,1,1380,5820,1,1380,0,1918
3449800290,641000,5,2.75,3710,8674,2,3710,0,1996
2426059071,675000,3,2.5,2320,98445,1,1380,940,1978
2618300190,255000,3,1.5,1110,10296,1,1110,0,1964
6181400920,286651,3,2.5,1830,4997,2,1830,0,2004
0424069150,607500,4,2.5,2460,45738,1,1650,810,1969
0856000255,765000,3,1,1270,6500,1,1270,0,1956
1841500050,334950,4,1.75,1700,40973,1,1700,0,1961
3226059071,426000,3,1,1130,9147,1,1130,0,1952
0524059093,775000,3,1.75,1640,18730,1.5,1640,0,1946
1568100225,343000,2,1.5,1040,8526,1,1040,0,1953
4027700726,470101,4,2.5,2320,7800,2,2320,0,1986
5198600005,195000,3,1.5,1200,7800,1,1200,0,1958
7677300010,772500,4,1,1720,4410,1.5,1720,0,1928
7979900006,450000,3,1.5,2330,11740,1,1330,1000,1954
1102000527,1.4375e+006,4,3.75,4410,9231,3,4410,0,2001
1115800440,525000,4,1.75,1650,8560,1,1650,0,1970
9407110680,280000,3,1.5,1370,11400,2,1370,0,1980
6084601060,270000,3,2.5,1770,8640,1,1420,350,1986
0993001330,406100,3,2.25,1410,1332,3,1410,0,2005
2475200290,332544,2,1.75,1710,4187,1,1710,0,1987
5381000048,110000,2,1,790,8250,1,790,0,1947
5605000595,685000,6,2.25,2770,5854,1.5,2120,650,1921
1124000050,461000,4,1,1260,8505,1.5,1260,0,1951
3558900430,615000,3,2.25,2300,8067,1,1300,1000,1979
2708100130,550000,2,1,1070,3000,1,870,200,1926
1236300290,1.06e+006,4,3.5,3850,8100,2,2430,1420,1995
0525069099,685000,3,2.5,2320,219978,2,2320,0,1993
3262300235,1.555e+006,5,2.5,2870,16238,2,2870,0,1962
5104510130,312000,4,2.5,1830,5175,2,1830,0,2003
7197350050,507500,3,1.75,1990,9594,1,1190,800,1977
2822049148,217000,3,1,1110,9827,1,1110,0,1966
7558300170,439000,3,2.25,1830,13477,1,1170,660,1981
7852190050,620000,6,3.5,3600,6875,2,2740,860,2004
1277000020,915000,4,2.5,3210,8532,2,3210,0,1998
0567000660,425000,4,2,1490,5300,1,1110,380,1977
9214400396,435000,2,1,990,5643,1,870,120,1947
9406520290,305000,3,2.25,1646,12414,2,1646,0,1996
2112700895,276000,2,1,720,4000,1,720,0,1918
2474400250,327500,3,2.25,2310,7200,2,2310,0,1990
3889100029,810000,3,2.5,2670,10481,2,2670,0,2003
0011501310,715000,3,3.25,3060,9055,2,2460,600,1994
5672000020,272000,3,1.5,1380,11760,1,1380,0,1963
6668900005,266000,2,1,700,5559,1,700,0,1949
2346800005,543000,3,1.5,1710,8364,2,1710,0,1944
2872900050,400000,3,2.5,1450,8064,1,1450,0,1984
4040600190,509500,5,2.25,2060,9000,1,1320,740,1961
7129301578,495000,3,3.5,2380,6250,2,1670,710,1997
3955900500,424950,4,2.5,2760,5564,2,2760,0,2001
7788400170,230000,3,1,940,10875,1,940,0,1957
3831000010,235000,4,1.5,1760,6150,1.5,1760,0,1951
3885803895,763000,3,2,1360,8752,1,1360,0,1942
3810000480,350000,3,1.75,2010,6150,2,2010,0,1939
6169901197,900000,3,1.5,2160,2260,2,1620,540,1917
6882520050,250000,3,1,930,6060,1,930,0,1973
2608300103,225000,3,2.5,1020,2040,2,720,300,2004
3530400080,255000,2,2,1360,5433,1,1360,0,1974
1099760470,161700,4,1.75,1720,7200,1,1220,500,1974
4327600010,336000,3,3,1790,13350,1,1190,600,1988
6150200005,410500,3,1,1150,6800,1,1150,0,1954
4019300480,502700,4,3.5,2710,14016,2,2710,0,1968
6855100010,505000,3,2.5,2400,9601,1,1390,1010,1977
5249801440,250000,3,1,1660,7650,1.5,1350,310,1910
5249801440,570000,3,1,1660,7650,1.5,1350,310,1910
7524350080,349900,4,2.5,2290,8796,2,2290,0,1994
1137800460,465000,3,2.5,2870,25663,2,2870,0,1988
0587550280,625000,4,3.25,4240,25639,2,3550,690,1989
0871001365,655000,3,1.75,1800,5102,1,1170,630,1952
1430800279,469000,4,1.75,2960,11347,1,1570,1390,1946
1226039130,355000,3,2.25,1980,7200,1,1300,680,1964
7254000050,596000,3,2.5,1730,2631,2,1730,0,2001
3530200020,790000,4,2.5,3020,36893,2,3020,0,1986
2386000020,885000,4,2.25,4470,86225,2,4470,0,1991
6738700225,1.03e+006,4,3.25,2830,4000,2,1910,920,1912
6821600005,710000,4,1.75,2120,5400,1,1060,1060,1941
3579000010,428040,3,2.5,2150,9266,2,2150,0,1988
9359100101,1.37e+006,5,2.25,3510,13843,1,1850,1660,1959
6819100122,546000,2,1,970,3400,1,970,0,1924
3908100020,540000,4,1,1360,5766,1.5,1360,0,1951
6392001950,435000,3,2.5,1470,3000,1,930,540,1985
2872900280,540000,4,2.25,3040,10283,1,1430,1610,1984
6437400101,284000,2,1,860,7204,1,860,0,1918
7227502155,208000,2,1,820,5700,1,820,0,1942
1115100169,315000,3,1.75,1900,7076,1,1130,770,1977
2919702705,417500,2,1,1330,5510,1,850,480,1910
7302000500,345000,3,1.75,1240,38095,1,1240,0,1978
6021503656,375000,3,2.5,1330,1064,3,1330,0,2004
8665200020,389800,3,1.75,1880,12821,1,1880,0,1959
3288301330,475000,3,1.75,1890,7560,1,1430,460,1973
2621700010,569000,4,2.25,2250,41688,2,2250,0,1980
1824079073,985000,5,4.25,4650,108464,2,3260,1390,1999
1954440080,532000,3,2.5,1830,8022,2,1830,0,1987
7452500285,280000,2,1,720,5000,1,720,0,1951
7937600380,435000,4,2,1960,50112,1,1050,910,1963
5153200651,223000,3,1,1220,71191,1,1220,0,1952
2323069022,390000,2,1,1800,119790,1,1200,600,1947
1328340380,315000,3,1.75,1340,12800,1,880,460,1981
2256500005,612000,3,3,1740,3700,1,1740,0,1982
9828200545,591000,3,1.75,1680,2400,1,870,810,1922
0686450080,800000,4,2.25,3220,8436,2,3220,0,1968
2571900380,225000,3,2,1610,8400,1,1610,0,1990
1026069120,589900,2,3,3160,66646,2,3160,0,1993
3882320010,565000,4,2.5,2520,13156,1,1520,1000,1979
1377300020,650000,3,1.5,2120,8448,1,1060,1060,1940
1124000005,499000,3,2.5,2090,8505,2,2090,0,1951
1151100010,280000,3,1,1330,20562,1.5,1330,0,1959
7997200130,649950,3,2.5,2420,7500,1,1210,1210,1944
2419600005,420000,3,1.75,1510,6360,1,1510,0,1954
5727000010,319990,4,2.5,2120,5293,2,2120,0,2003
8656300080,265000,3,2,1850,16535,1,1850,0,1992
9517200290,482000,3,1.75,2300,16474,1,1220,1080,1984
3123049142,452000,3,2.25,2600,14810,1,1490,1110,1956
4139500080,1.488e+006,4,4.25,5180,13077,2,4280,900,1998
6150200280,375000,2,1,1810,8527,1.5,1810,0,1943
6021500840,588000,5,3,2190,4900,2,1490,700,1940
8691310420,635000,4,2.5,2500,10215,2,2500,0,1998
1402900380,280500,4,2.5,1890,6962,2,1890,0,1997
2345500010,210500,2,1.75,2040,8600,1,1430,610,1985
3279000460,196500,3,2,1310,7000,1,1310,0,1979
0723000114,1.395e+006,5,3.5,4010,8510,2,2850,1160,1971
5145100080,475000,3,1.75,1780,8033,1,1210,570,1977
8078410280,550000,3,2.5,1980,9061,2,1980,0,1987
3885806105,1.58e+006,3,3.25,3690,7200,2,3690,0,2007
5702380780,240000,3,1.75,1540,6687,1,1200,340,1991
3826000280,272000,3,1,1130,8100,1.5,1130,0,1934
1421079007,408506,3,2.75,2480,209199,1.5,1870,610,2000
3702900185,640000,3,2.5,2580,7500,2,2580,0,1991
4136880460,316000,4,2.5,2010,7226,2,2010,0,1995
7885100005,299000,4,2,2320,12000,1,1720,600,1943
3037200010,447500,2,2.25,1180,2090,2,1180,0,2004
4309710250,736500,4,2.5,3180,21904,2,3180,0,2000
3401700185,665000,4,2,2970,52567,2,2970,0,1924
2141300080,707000,5,2.5,3050,13212,1,1590,1460,1975
3387800380,215000,4,1.75,1630,8000,1,1630,0,1959
2310000280,275000,3,2.25,1620,6415,2,1620,0,1989
1687900170,648000,4,2.25,2170,8240,2,2170,0,1983
8079000190,415000,4,2.5,2150,8173,2,2150,0,1987
1710400005,690000,3,2,1770,1800,3,1770,0,1999
2473420170,320000,4,2.75,2110,13260,1,1290,820,1979
1056200010,750000,3,1.75,1590,8285,1,1590,0,1956
0263000359,355000,3,2.25,1370,1524,3,1370,0,2005
6624010170,246000,3,1.75,1390,7399,1,1390,0,1975
0824059265,1.155e+006,3,1.75,1640,10464,1,1640,0,1968
2869100080,744000,3,2.5,2670,12187,2,2670,0,1986
0203100440,1.21e+006,3,3.75,5400,24740,2,5400,0,1997
9542800290,217000,3,2,1690,6750,1,1210,480,1977
3342100780,583000,3,2.5,2600,5100,2,2600,0,1998
0475000080,515000,2,1.5,1400,5000,1,1150,250,1904
1562100380,594000,4,1.75,2140,8000,1,1410,730,1965
3878900185,303100,3,1.5,1640,5650,1,1640,0,1952
6791100280,430000,3,1.75,1720,15225,1,1020,700,1970
1926059099,708000,5,3.25,3060,11778,2,3060,0,2004
2881700547,221000,3,1,1150,7260,1,1150,0,1959
3260800190,325000,3,2.5,2000,7205,2,2000,0,1998
2954400190,1.29565e+006,0,0,4810,28008,2,4810,0,1990
7715600050,385000,3,1.75,1560,5950,1,780,780,1944
3158500460,359500,3,2.5,2070,4689,2,2070,0,2013
4027700797,433000,3,2,1920,7200,1,1300,620,1984
9161100460,525000,2,1,1000,4950,1,800,200,1948
8069000216,356200,3,2,1690,10062,1,940,750,1928
3401700255,595000,4,2,3090,87120,1,1590,1500,1974
4083306720,560000,4,1.5,1790,3420,1,1020,770,1923
6377200010,2.175e+006,4,3,4750,21701,1.5,4750,0,1976
2767601100,513000,4,2,2090,4000,1,1480,610,1951
2856100185,365000,2,1,680,2550,1,680,0,1901
3438500797,368000,4,1.75,2100,11942,1,1030,1070,1964
6738700275,870000,4,2.75,2840,4000,1.5,1960,880,1912
1761100190,225000,3,2.25,1470,6808,1,1160,310,1984
0713500020,1.387e+006,4,4.5,4490,24767,2,3800,690,1998
5412310170,177000,3,1.75,1150,8079,1,1150,0,1983
7751800080,465000,3,1.5,1460,9879,1,1460,0,1956
1121000414,750000,4,2.75,3150,6343,1,1810,1340,1976
4239400920,149000,3,1,1090,2800,1,1090,0,1969
9408300380,605000,3,2.5,2670,47480,2,2670,0,1981
6865200095,725000,3,2,2110,5800,1.5,1990,120,1927
6669080010,413900,4,2.25,1770,5236,2,1770,0,2007
1446400670,199950,3,1.5,1510,6600,1,1510,0,1938
0203100460,400000,1,1,530,13679,1,530,0,1949
9523102750,870000,3,1.5,2420,5000,2,2200,220,1925
8078570380,292000,5,2.5,2490,7666,1,1490,1000,1989
1423800080,225000,3,1,990,8012,1,990,0,1966
9259900010,466750,4,2,1730,9139,2,1730,0,1957
4223400050,330000,2,1.5,1440,11954,1,1440,0,1978
0686400380,770000,7,2.25,3260,8145,2,3260,0,1967
1102001112,802500,4,2.25,1950,7000,1,1450,500,1957
0241900020,378800,5,2.5,2740,5400,2,2740,0,2005
8691300380,795000,3,2.75,2940,12487,2,2940,0,1997
3426049132,460000,3,2,1200,7320,1,1200,0,1955
3904901190,567000,3,2.5,2070,10908,2,2070,0,1986
1789900080,209950,3,1.75,1570,15570,1,1570,0,1981
1021049022,415000,2,1,1050,60113,1,1050,0,1943
5634500179,424500,4,1.5,1830,6985,1,1080,750,1967
0795002455,261000,2,1,970,12500,1,970,0,1941
6666860170,365000,3,2.5,2200,9696,2,2200,0,1987
9828200605,631000,4,2,1930,3240,1.5,1930,0,1911
0853200010,3.8e+006,5,5.5,7050,42840,1,4320,2730,1978
4449800345,584000,3,2.5,1790,3962,2,1790,0,1992
2522029136,310000,3,1.75,1560,82328,1,1560,0,1974
1149900050,717000,4,2.5,2780,7985,2,2780,0,1992
6908200080,667000,3,1.5,1720,8100,2,1720,0,1907
3395800660,190000,3,1,1640,8100,1,1040,600,1939
9414610010,430000,3,2,1730,9000,1,1370,360,1978
5379805120,213000,2,1,740,7380,1,740,0,1951
1530900290,475000,3,2.5,2280,3710,1,1550,730,1990
8886000005,649000,2,2.75,2090,23962,2,2090,0,1988
8965400010,715000,3,2.5,2550,13458,2,2550,0,1990
8644210470,845000,4,3.5,3350,19487,1,2460,890,1992
1545805980,390000,3,2.5,2770,8820,1,1900,870,1980
2841500010,390000,4,3,2860,5724,1,1730,1130,1983
1328330290,328000,4,1.75,1990,7194,1,1400,590,1978
4222100280,239999,3,2.75,1740,8436,1,1140,600,1967
4222200280,225000,3,2,1460,7740,1,1460,0,1968
3224510290,920000,3,1.75,3670,11884,1,1950,1720,1979
5196420290,940000,4,2.75,3270,9231,2,3270,0,1995
1703900005,465000,3,1,1210,4872,1,1210,0,1949
3329530480,241000,3,2,1770,7000,1,1770,0,1986
1541700170,307550,4,2.5,1980,5909,2,1980,0,2003
8833510190,490000,4,2.5,2650,9627,1,1610,1040,1976
8961970190,647000,4,2.5,3040,6887,2,3040,0,1999
0323069120,780000,4,2.75,3640,231739,1.5,3640,0,1999
8944360170,517500,3,2.5,1810,4332,2,1810,0,1992
2546500020,295000,3,2,1380,8682,1,1380,0,1966
1338801060,560000,4,1.5,1810,3400,2,1810,0,1926
3747600050,319450,5,2,2250,5472,1.5,1750,500,1930
0327000050,1.5e+006,4,3.25,3860,7199,2,2870,990,2005
1898900280,340000,4,3,2380,20277,1,1500,880,1999
1423400005,249950,3,1,1370,11658,1,1370,0,1958
9521100585,499950,3,1,1830,3000,1.5,1430,400,1926
2025059150,1.038e+006,4,1.75,1440,13296,1,1440,0,1967
8941500010,750000,4,2.5,2510,17200,1,1540,970,1977
1425069071,875000,4,2.5,3230,256132,2,3230,0,2006
0686400670,678000,3,1.75,1670,7210,1,1670,0,1967
2624049073,360000,2,1,780,4200,1,780,0,1920
1523059180,354900,3,1,1720,16552,1,1720,0,1971
8016300250,632000,5,2.5,2260,10087,1,1520,740,1967
7694600143,350000,3,1.75,1480,9375,1,1480,0,1957
0269000950,990000,3,4,2550,3900,2,2050,500,1940
2724079090,1.65e+006,4,3.25,3920,881654,3,3920,0,2002
3342103369,481000,4,2.5,2286,8269,2,2286,0,2002
7104100050,485000,3,2.5,1500,5412,1,900,600,1920
8944360290,477000,3,2.5,1740,4960,2,1740,0,1992
6072500050,560000,5,2.5,2880,9000,1,1440,1440,1966
1066000290,600000,6,3,2600,9350,1,1340,1260,1963
2817260130,622500,5,2.75,3320,23760,2,2190,1130,1975
3582750170,410000,2,2.25,1660,2128,2,1660,0,1974
0255370420,318200,3,2.5,1990,3644,2,1990,0,2010
2571910380,289000,3,2,1680,8424,1,1680,0,1993
3832150190,263000,3,1.75,1570,7775,2,1570,0,1982
5279100680,240000,3,1,1150,4825,1,1150,0,1957
7889601870,281500,3,1,1270,7500,1,1270,0,1953
5694001061,587206,3,3.5,1890,1710,2,1640,250,1999
1912100882,482000,2,2.25,1350,1248,2,1180,170,2000
8563020170,485000,3,1.75,1650,9500,1,1650,0,1967
8656800020,309000,3,2.5,1450,11480,2,1450,0,1990
3876540780,221000,3,2.25,1640,7350,1,1140,500,1984
8563030280,700000,3,2.5,2030,8398,2,2030,0,1975
2114300290,411500,5,3,2420,7740,1,1360,1060,1929
9141100005,285000,4,3.5,2770,10505,2,2770,0,1940
5727500019,395000,4,3,1980,7931,1,1160,820,1983
1796360080,237950,2,1.75,1460,7926,1,1460,0,1987
9485800050,680000,3,2.5,1610,8064,1,1160,450,1981
5560000680,199950,2,1,1010,10057,1,1010,0,1961
9297300480,765000,4,3.5,2760,4000,2,2000,760,1926
6813600415,515000,2,1,1060,4960,1,1060,0,1926
6751300255,470000,3,1.5,1510,8000,1,1510,0,1956
3300700480,330000,2,1,880,4000,1,780,100,1937
5379800446,284000,3,2.5,2150,9375,1,1550,600,1968
9558200080,295000,3,2.5,1660,8125,1,1150,510,1999
6817801150,555000,4,2.5,2160,10987,1,1440,720,1981
1454100005,350000,3,1,1370,8162,1.5,1370,0,1949
0104540840,240000,3,2.25,1460,5818,1,1140,320,1986
2207100635,419900,3,1.5,1450,7000,1,1450,0,1955
2489200250,528000,3,2,1560,6300,1,1560,0,1924
5130000080,481000,4,2.5,2480,9869,1,1240,1240,1963
6150700169,304700,2,1,740,5995,1,740,0,1949
8691350130,715000,4,2.5,2927,12171,2,2927,0,1998
6189200345,738950,4,2.75,2260,12005,1,2260,0,1956
2222059099,215000,3,1.5,1240,9405,1,1240,0,1966
7227800660,300000,6,2,2040,10812,1,2040,0,1943
1148000005,346000,3,1.75,1270,8100,1,880,390,1950
6055000430,473000,4,3.5,4370,37193,2,2780,1590,1996
7616200050,500000,3,1.75,1700,6120,1,1700,0,1952
7234601440,750000,2,1.5,1300,7632,1,1300,0,1943
8563020380,519900,4,2,1820,9350,1,1820,0,1967
1454100480,378500,2,1,880,6171,1,880,0,1949
5151600285,314500,3,1.75,1870,12381,1,1870,0,1957
2155000480,499950,3,1.5,1350,9315,1,1350,0,1968
1024049024,1.735e+006,5,3.5,4870,7700,2.5,3650,1220,1929
1026069163,630000,3,2.5,2460,38794,2,2460,0,1999
4427100095,360000,4,1.5,1720,6417,1,1720,0,1953
4047200380,460000,2,1.5,2730,19877,1,1570,1160,1976
3222049024,361000,3,1,1100,4046,1.5,1100,0,1922
2287000010,713400,3,2.25,1810,9845,1,1810,0,1959
3692900010,445000,2,1,930,3150,1,930,0,1918
0320069049,305000,4,1.5,1590,131551,1,1590,0,1966
0868002335,1.43e+006,3,2.75,2710,9204,1.5,1480,1230,1975
8945100050,222000,3,1,1460,8400,1,1460,0,1962
7853250080,510000,5,3.25,3400,4499,2,2740,660,2005
6713700250,500000,5,3,2920,11440,2,2920,0,2003
4232901990,605000,2,1,910,3600,1,910,0,1909
3578401760,393000,3,2,1320,10720,2,1320,0,1981
9113200290,725000,4,2.5,2490,5170,2,2490,0,2000
5116000250,320000,3,1.75,2220,11646,1,1270,950,1950
1099600010,210000,4,1.5,1130,7840,1,1130,0,1970
5416500980,419900,4,2.5,2750,5767,2,2750,0,2005
7312100010,410000,4,2.5,2240,4447,2,2240,0,2006
7936000562,721000,3,2.25,2680,10440,1,1540,1140,1963
9839300545,605000,2,2,1270,5500,1.5,1270,0,1921
6837700005,738000,3,1.75,1520,5500,1.5,1520,0,1936
6918720080,725000,6,3,2480,12000,2,2480,0,1972
9407001700,255000,2,1,960,20954,1,960,0,1977
1473200130,303000,3,2.25,1340,873,3,1340,0,2009
4037200585,394950,3,2.5,1090,7700,1,1090,0,1957
5249803870,530000,4,3,2240,5580,2,1830,410,1949
9558050170,475000,4,2.5,3740,8700,1,2260,1480,2004
1545808110,250000,4,2.5,1800,8100,2,1800,0,1998
1604601155,180000,3,1,780,3540,1,780,0,1920
2754700170,443500,2,1,1330,4140,1,930,400,1919
3622059180,390000,4,2,1900,76877,1,1900,0,2004
7201600190,430000,4,1.75,1570,7650,1,1100,470,1975
3450300280,460000,5,4.5,3100,7260,2,3100,0,1963
1036450170,660000,3,3.5,2740,3785,2,2190,550,2001
8965000050,515000,3,1.75,1570,10939,1,1200,370,1974
4354700010,482500,3,2,1330,6490,1,1330,0,1954
4057300170,305000,2,1.5,1140,2980,2,1140,0,1988
4217400185,835000,4,2.75,1550,4000,1.5,1550,0,1930
8155750010,237000,3,2,1290,7952,1,1290,0,1998
2159900020,445000,2,1.5,1510,2001,2,1510,0,1985
2487700130,710000,4,2.5,2720,8000,1,1360,1360,1955
2085200545,180000,3,1,840,5700,1,840,0,1945
9432900380,280017,3,2.5,1850,8770,2,1850,0,1996
2591850080,436500,4,2.5,2290,11173,2,2290,0,1988
1025049174,1.255e+006,4,2.5,3200,7535,2,3200,0,2006
5628400080,420000,3,2.25,1800,9800,1,1300,500,1959
7657000225,205000,3,1,860,7467,1,860,0,1944
6151800080,570000,3,1.5,1980,10203,1,1680,300,1946
6154900095,565000,4,1.75,2140,7102,1,1070,1070,1948
9542800050,287000,2,2.5,2410,7500,1,1550,860,1978
0526059224,260000,4,1.75,1650,7276,1,1010,640,1977
0526059224,470000,4,1.75,1650,7276,1,1010,640,1977
3275850190,700000,3,2.5,2410,9916,2,2410,0,1989
4137000460,249000,3,1.75,1520,7500,1,1520,0,1985
7936000403,568000,3,1.75,2050,3520,1,1070,980,1977
1175000073,500000,4,1,1720,4011,1.5,1720,0,1904
8645540290,358000,5,2.5,2390,8775,1,1270,1120,1980
7137960460,225000,3,2.5,1680,6755,2,1680,0,1994
8805400010,275500,3,1,1060,7246,1,1060,0,1981
1036450290,495000,3,2.5,1860,3150,2,1860,0,2001
7613700660,758800,5,2.25,1750,5000,1,960,790,1940
8648210050,280000,3,1.75,1480,8165,1,1480,0,1985
1565950670,380500,3,2.5,1900,7361,2,1900,0,1994
7159200005,3.2e+006,7,4.5,6210,8856,2.5,4760,1450,1910
8687800010,260000,3,1.75,1440,12888,1,1090,350,1958
4242900285,630000,4,2.5,1910,1502,3,1910,0,2014
7834800225,875000,3,2,2010,4000,1,1210,800,1915
5649600225,457500,3,1,960,4600,1.5,960,0,1927
1959702045,900000,2,1,1240,5500,1,1240,0,1954
0717000225,235000,2,2,870,6450,1,740,130,1954
0792500190,410000,3,2,1400,45738,2,1400,0,1981
3820100284,355000,3,3,1850,9600,1,1230,620,1981
3629890190,1.3e+006,4,4,4270,6002,2,3180,1090,2004
6868200029,467500,3,1.75,2260,8512,1,1130,1130,1948
8901000143,500000,4,4.5,2690,7350,1.5,2690,0,1949
2927600630,995000,4,3.5,2780,9550,2,2530,250,1978
3432501315,277000,3,1,1140,8144,1,1140,0,1956
5101407250,630000,4,2.25,2900,9680,2,1990,910,1947
3999200780,628000,5,2.75,2830,11795,1,1710,1120,1960
2826079145,655000,5,2.5,2560,46786,2,2560,0,1995
1446403145,170000,2,1,1240,9900,1,940,300,1950
5137000170,352500,4,2.5,2100,10750,1,2100,0,1967
2896310420,615000,4,2.75,3120,34040,2,3120,0,1997
1446400725,165000,3,1,970,6600,1,970,0,1965
4030500130,243500,4,2.5,2300,15188,2,2300,0,1966
3319500299,304000,2,1.5,950,676,2,850,100,2003
7139800020,369000,3,1.5,2110,5195,1,1210,900,1959
9433000460,779950,4,2.75,2990,4298,2,2990,0,2014
1326049130,605000,4,2.25,2940,48788,1,1520,1420,1961
7137960440,292500,4,2.5,1860,8709,2,1860,0,1994
3946900010,500007,2,1.75,1820,6050,1,910,910,1950
5592050080,449999,4,2.5,1950,4947,2,1950,0,2000
3288020050,355000,4,2.5,1890,7867,2,1890,0,1996
2459000020,258000,4,3,2710,7199,1,1710,1000,1967
0126049167,380000,4,2.25,2150,20181,1,1090,1060,1963
1525079069,650000,4,3,3720,57499,1,1880,1840,2003
1786200010,456500,4,2.5,2580,11780,2,2580,0,2003
5602000275,259950,4,2,1540,10212,1.5,1540,0,1948
1446403617,123000,2,1,1050,6600,1.5,1050,0,1964
2767603649,520000,3,2.25,1210,1250,3,1210,0,2014
3649100387,506000,4,2.25,2040,12000,1,1300,740,1963
5249802660,425000,3,1,980,4800,1.5,980,0,1926
2592400470,438000,5,2.5,1990,6840,2,1990,0,1974
6448000020,1.49e+006,4,2.5,2420,18480,1,2420,0,1967
1211000185,375000,4,2,1240,3000,1,1040,200,1908
7399300780,337500,3,2.25,1530,6600,1,1240,290,1968
0984100010,300000,4,2.25,2080,7700,1,1450,630,1968
6127010670,627000,5,3.25,3570,5425,2,3570,0,2005
1245002391,1.4e+006,5,4.25,4230,6907,2,3450,780,2008
3904921100,674725,4,2.5,2700,10160,2,2700,0,1988
2473381150,325000,3,2.75,2200,7000,1,1280,920,1977
9269750010,230000,5,2,1210,12538,2,1210,0,1982
1924069071,485000,5,1.75,2140,43124,1,1220,920,1962
2571900430,315000,4,2.5,2740,8400,1.5,2740,0,1993
8673400052,560000,3,2.75,1370,1193,3,1370,0,2003
5104511630,444000,4,3,2800,7198,2,2800,0,2002
3438500168,325000,3,1.5,1060,7488,1,1060,0,1977
1446403850,118125,2,1,790,7153,1,790,0,1944
1446403850,212000,2,1,790,7153,1,790,0,1944
5416500950,428900,4,2.5,2820,5056,2,2820,0,2006
8096600050,510000,3,2,1850,9600,1,1850,0,1968
1473000020,416000,3,1.5,1110,9762,1,1110,0,1963
0722039049,950000,4,3,3230,438213,2,3230,0,1999
2212210660,204000,3,1.5,1460,7140,1,980,480,1980
6762700020,7.7e+006,6,8,12050,27600,2.5,8570,3480,1910
5608010980,878000,4,2.5,3480,13421,2,3480,0,1995
5015001045,1.045e+006,4,3,3560,4000,3,2970,590,1996
1005000250,350000,2,1,840,5551,1,840,0,1952
7974700122,659500,3,1.75,1820,5500,1,1620,200,1957
1775910460,395000,3,2.5,1630,15200,1,1120,510,1988
3797300190,308950,4,2.5,1920,8562,2,1920,0,1994
6450300605,410000,3,2,1750,2550,1,1750,0,1955
3918400143,710000,4,3,2750,7500,1,1630,1120,1966
1022049182,175000,1,1,620,8685,1,620,0,1976
3578400780,508800,3,2,1720,10098,1,1140,580,1981
6905200050,606400,3,3,1800,5000,1.5,1500,300,1929
0303100080,245100,3,1.75,1300,7958,1,1300,0,1996
0123039642,540000,3,2.5,1970,14876,1,1320,650,1981
8718500095,415000,3,1.5,1740,9046,1,1740,0,1956
1774000780,469500,4,2.75,1930,13041,1,1180,750,1980
2421039075,195000,3,1.75,1190,14777,1,1190,0,1965
4139470010,1.615e+006,4,3.25,4250,12281,2,3020,1230,1996
0629800380,1.45e+006,4,3.5,4360,24603,2,4360,0,1998
8965520190,1.2e+006,3,2.5,3420,16622,1,2410,1010,1991
0925059193,1.065e+006,4,3.75,4260,9800,2,4260,0,2008
1245500250,555500,2,1,920,10000,1,920,0,1981
9828700005,440000,3,1,1040,4000,1,1040,0,1950
5101402312,485000,3,1,1260,7250,1,960,300,1940
0339200130,693000,3,2.5,2460,12028,2,2460,0,1996
6145602125,295000,3,1,830,3386,1,830,0,1942
9346910500,700000,3,2.5,2060,10650,1,1050,1010,1976
7986401305,767500,2,1.75,2210,9374,1,1560,650,1951
0922059169,800000,6,4.25,5480,189050,2,5140,340,1991
0123059071,440000,3,2,1860,217800,2,1860,0,1998
1626069069,600000,3,2.5,1350,187313,1,1350,0,1997
5605000430,1.16e+006,4,2.5,2790,5450,2,1930,860,1925
7640400250,506000,2,1,1570,8210,1,1150,420,1952
4477000290,474950,4,1.75,2030,15400,1,1130,900,1975
8127700440,654000,3,2.5,2570,5500,1,1320,1250,1961
6822100780,710000,2,1,1210,6000,1,1000,210,1942
9195700380,620000,4,2.25,1530,7845,1,1030,500,1981
1425059174,390000,3,2,1510,10827,2,1510,0,1984
2155000290,550000,3,2.25,1720,9600,1,1220,500,1967
4058200630,353000,3,1.75,2190,7021,1,1390,800,1953
5561400440,465000,4,2.5,3030,47958,1,1660,1370,1980
4178500440,279900,3,2,1410,6600,1,1410,0,1990
1923039022,700000,2,1.75,1679,577605,2,1679,0,2001
9412200660,395000,4,1,1980,10350,1,1430,550,1968
2780700020,375000,4,2.5,1900,9428,2,1900,0,1978
1868901815,547000,4,1,1720,2800,1.5,1200,520,1926
4022902715,525000,5,3.25,2480,10277,2,1640,840,1993
0225039145,285000,3,1,1210,4731,1.5,1210,0,1901
9274203390,570000,2,1.75,1540,4025,1,1190,350,1908
4397000020,409000,3,2.5,2740,9168,2,2740,0,1991
9415950020,260000,4,2.5,1811,4381,2,1811,0,2007
2591830020,348000,4,2.5,2720,7697,1,2120,600,1987
3211200460,389000,4,1,1520,9800,1.5,1520,0,1971
2297400250,445000,4,2.75,2160,7200,1,1220,940,1976
9268200440,400000,3,1.75,1390,4602,1,930,460,1981
0255580190,302000,4,2.5,1740,7895,2,1740,0,1999
6352600680,798000,3,2.5,2849,9588,2,2849,0,2001
1829700050,335000,2,1,1440,8842,1,840,600,1950
7859960250,585000,4,2.5,3000,6892,2,3000,0,2005
6072800170,2.5e+006,4,4,3330,24354,1,3330,0,1961
6373000130,555000,4,2.25,1720,2300,1,860,860,1940
4131900066,3.1e+006,3,3,3920,13085,2,3920,0,1996
8965450190,295000,3,2.5,1500,3060,2,1500,0,1994
1311200460,265000,4,1.5,2050,7100,1,1050,1000,1963
3764800250,330000,4,2,1180,7275,1,1180,0,1965
6607000095,286000,4,1.5,1600,5750,2,1600,0,1902
4358700188,305000,3,2.5,1260,895,3,1160,100,2009
5101403915,970000,2,1,1290,5376,1,1290,0,1945
7844200425,525000,4,2,2680,14157,1,1460,1220,1966
9407001330,355000,3,1.75,2370,9750,1,1280,1090,1979
7905370440,469950,5,2.5,2310,8303,1,1300,1010,1975
2202500290,435000,4,1,1450,8800,1,1450,0,1954
3374500250,363500,4,2.5,2680,7700,2,2680,0,1990
5244800895,595000,2,1.5,1030,4500,1,830,200,1924
0100100050,275000,3,1,1320,11090,1,1320,0,1955
7454001060,295000,2,1,670,7952,1,670,0,1942
7215400280,345000,3,2.25,2670,37089,2,2670,0,1990
0203101330,485000,3,2.25,2440,47916,2,2090,350,1991
2450000290,1.245e+006,5,2.5,3370,8113,2,3370,0,2005
5101402472,340500,2,1,940,5413,1,940,0,1923
4310700020,280000,3,1,1100,5132,1,840,260,1948
7967600285,449888,3,2.25,2520,78408,2,2520,0,1988
7905200381,483000,2,1.75,1400,4720,1,820,580,1927
3992700585,445500,3,1.75,1880,9360,1,940,940,1941
7972601950,379900,5,3.5,2800,7350,2,2800,0,1995
6870310010,599950,4,3.5,2500,3080,2,1810,690,2008
2970800130,215000,3,1,810,5240,1,810,0,1942
6084600660,263000,3,2.5,1720,6847,2,1720,0,1987
0325059126,565000,4,1,2170,12100,1,2170,0,1961
0526069024,950000,5,3,4530,258746,1.5,3200,1330,2003
6163901261,395000,4,1,1440,8320,1.5,1440,0,1946
4289900005,1.535e+006,4,3.25,2850,4100,2,1820,1030,1908
2818100255,922000,4,2.5,2620,14126,1,1620,1000,1941
1389310130,330000,3,2.5,1676,18778,2,1676,0,1997
4139910250,1.525e+006,4,3.75,5850,35070,2,4410,1440,1990
5416100020,323000,3,1.75,1910,8329,1,1910,0,2004
8682261650,554000,2,2,1670,4996,1,1670,0,2004
8100400170,500000,3,2,2050,11454,1,2050,0,1987
1604590190,775000,5,3.5,3730,16679,1,2760,970,1990
6882510020,340000,4,1.75,1800,5210,1,1080,720,1979
3459800020,560000,4,1.75,2230,6838,1,1320,910,1985
5437600010,304000,3,2.5,1670,5298,2,1670,0,2002
1395500020,279900,3,1,1400,10800,1,1400,0,1962
0807800020,315000,5,3,2110,10766,2,2110,0,2005
1563102880,849000,4,2,2160,6300,1.5,2160,0,1928
8937500020,325000,3,1.75,2420,14862,1,1380,1040,1977
0629420480,786000,4,3.5,3320,8808,2,3320,0,2005
8961950250,384000,5,2.75,3220,8160,2,3220,0,1999
4217400420,907000,3,1.5,1340,6000,1.5,1340,0,1927
3121500020,700000,3,2.5,2490,23891,2,2490,0,1993
2025700430,269500,3,2,1640,8395,1,1640,0,1991
0739800250,269000,3,2.25,1420,7297,1,1130,290,1984
8647600020,749950,4,2.5,3340,123600,2,3340,0,2005
1518000290,325000,3,2.75,1580,4007,2,1580,0,2001
8917100020,1.15e+006,3,1.5,2170,16600,1,1130,1040,1979
3205100010,406000,3,1.5,1370,7853,1,1370,0,1962
2405500050,650000,4,2.5,2840,9354,2,2840,0,1990
7823700005,295000,3,1.75,1940,7500,1.5,1940,0,1918
8642600170,375000,4,2,1757,19370,1,1757,0,1955
7518502960,395000,2,1,980,5100,1,980,0,1907
4279600080,609000,6,3,2470,9267,2,2470,0,1982
6421100592,510000,3,1.75,1610,11950,1,1210,400,1984
7967200290,190000,3,2.25,1590,11745,1,1090,500,1978
7228501903,250000,1,1,780,1033,1,780,0,1922
9275200080,295000,3,1.5,720,7450,1,720,0,1924
8825900095,740000,3,1.5,1630,4080,1.5,1630,0,1927
7849201100,323000,3,1,1590,7759,2,1590,0,1912
8562790980,713000,3,2.75,2310,1850,2,2020,290,2011
1370801435,1.07e+006,3,1.75,2320,6090,2,2040,280,1939
3897100275,460000,3,1.75,1660,9900,2,1660,0,1978
6745700190,880000,3,1.75,2070,5000,1.5,2070,0,1920
2770600795,585000,4,1.75,2500,7000,1,1250,1250,1947
1148000190,249950,2,1,940,8532,1,940,0,1959
5039300305,450000,3,2.5,1990,3478,2,1520,470,1990
3981200250,450000,3,2.5,2620,14096,2,2620,0,1989
5457300095,1.775e+006,4,3.25,3730,7071,3,3730,0,1985
1862400479,350000,3,3.25,1600,1298,3,1600,0,1999
8669160010,292500,3,2.5,2095,3438,2,2095,0,2008
2481630290,879000,4,2.75,4230,31747,2,4230,0,1985
8925100255,1.184e+006,4,2.5,3200,7500,1.5,1860,1340,1948
0424069130,584999,4,2.75,2050,17859,1,1300,750,1967
2231800020,366000,4,2.75,2020,8093,1,1300,720,1961
3625700080,987500,4,2.25,3270,15760,1,2000,1270,1974
3343901188,300000,3,1,1320,7200,1,1320,0,1959
1328330430,299000,2,1.75,1270,7800,1,890,380,1981
2464400500,560000,4,1.75,1980,2700,1.5,1210,770,1931
4054710190,695000,3,2.5,2620,51354,2,2620,0,1998
5095400630,360000,4,1.75,1750,18810,1,1220,530,1977
1788300020,183500,3,1,1040,8892,1,800,240,1958
3336001470,311000,3,1.75,1900,3000,1.5,1070,830,1903
1310960190,263000,3,1.75,1660,7210,1,1660,0,1977
1545803340,269000,3,1.75,1530,7930,1,1530,0,1986
0524059148,1.6e+006,4,3.5,4280,9583,2,4280,0,2005
7852190290,564000,4,2.5,2870,6658,2,2870,0,2004
2385200050,425000,3,2.5,2540,5612,2,2540,0,1999
8827901060,679000,4,2.75,2100,4480,1.5,1780,320,1928
6456200020,410000,3,2,1740,9300,1,1740,0,1952
4166800080,340000,4,2.5,2441,7316,2,2441,0,2007
1591600307,360000,3,1.75,1810,7200,1,1030,780,1959
0926069132,450000,3,1.5,2060,44866,1,2060,0,1953
7130300170,552000,4,2.75,3160,8429,1,1620,1540,1982
2599200460,294000,4,2,2930,12840,1.5,2930,0,1965
7214400005,663500,2,1,1310,5200,1,910,400,1946
5017000470,1.975e+006,6,4.5,4800,9097,2,3580,1220,2007
8651402660,175409,4,1.5,1450,5530,1,1450,0,1969
8665900328,459000,4,3,1900,9077,2,1900,0,1954
3881900321,339950,3,1,1050,5402,1.5,1050,0,1906
1524079028,393000,5,1.75,1610,15246,1,1610,0,1936
0626049091,275500,2,1,720,11400,1,720,0,1951
6073200020,485000,3,1,1020,9835,1,1020,0,1955
3243100050,250000,3,1,1250,7920,1,1250,0,1960
1693600080,935100,4,3.5,3200,8049,1,2700,500,1980
7140600020,245000,3,1,990,9599,1,990,0,1959
6388910280,670000,4,2.5,2850,25993,2,2850,0,1989
2524000050,1.393e+006,3,3.5,4240,21578,2,3500,740,1994
2223069120,440000,4,1.75,2800,49149,1,1400,1400,1978
1732801300,1.248e+006,2,2.5,2310,3313,2,2310,0,2006
1685200020,203000,3,1.75,1490,8000,1,1200,290,1978
9510970050,583000,4,2.5,1840,4011,2,1840,0,2005
7156200005,575000,3,1,1740,9163,1,1740,0,1954
5316100780,2.575e+006,4,3.5,3280,3800,2,2880,400,2011
9362000080,1.6e+006,5,3.5,4050,20925,2,3020,1030,1973
2221800080,312500,4,2.5,2160,8755,2,2160,0,1993
2722059075,455000,3,2.75,2720,31314,3,2720,0,1986
3459600440,1.31e+006,5,3,3650,16600,1,1860,1790,1978
6844700415,605000,4,2.25,1750,6120,1,1150,600,1962
1223089016,325000,3,2.25,2450,49658,1,1770,680,1978
8044700010,630000,3,1.75,1940,7306,1,1470,470,1982
2024059130,928950,4,3.75,3280,6000,2,3280,0,2014
8019700010,489950,3,1.75,2480,10804,1,1800,680,1976
1785400780,550000,3,2.25,2120,18255,1,1590,530,1984
4222200380,237000,3,2,1710,7920,1,1260,450,1968
7503000050,390000,3,2.5,1690,10113,1,1310,380,1991
1592000680,665000,3,2.5,2190,10370,2,2190,0,1987
4303200130,277000,4,3,1960,5160,1,1170,790,2001
7731100066,545000,3,1,1510,5000,1.5,1510,0,1909
2770602335,615000,3,2.5,1490,1410,2,1300,190,2008
6706200130,343000,3,1.75,2210,7920,1,1400,810,1966
6632300567,597000,4,2.5,2340,7877,2,2340,0,2004
7000100635,600000,3,1,940,19000,1,940,0,1945
1954420420,479000,3,1.75,1470,6018,1,1470,0,1987
7809200005,292000,3,1.75,1650,14633,1,1650,0,1958
3056000050,265000,3,1.5,1400,6527,1,1110,290,1957
7214780050,623000,4,2.5,2710,49044,2,2710,0,1988
3210950080,486000,4,2.5,2150,39449,1,1420,730,1978
6914700130,520500,3,2,1900,8100,1,950,950,1940
7237550130,1.3e+006,4,3.5,4380,74052,1,4380,0,2001
1250202660,825000,4,1,2290,6300,1.5,2150,140,1921
3546000380,259900,3,1.75,1690,7953,1,1690,0,1986
5451200280,1.17e+006,5,2.75,3090,12031,1,1600,1490,1968
7129301851,245000,2,1,1120,5650,1,720,400,1904
0582000010,830200,3,2.5,2680,4990,1,1440,1240,1951
8078360080,650000,4,2.5,2400,7351,2,2400,0,1990
2658000373,305000,4,2,1610,6250,1,1610,0,1952
7504400290,599000,5,2.5,3470,12003,2,3470,0,1978
7137950460,272000,4,2.5,2070,6175,2,2070,0,1993
3303950130,415000,3,2.5,2420,10733,2,2420,0,1996
6648500440,319000,4,2.25,2380,7400,1,1760,620,1979
3824100235,425000,4,1.75,2120,15920,1,1060,1060,1960
8732020440,297500,4,2.5,2190,8100,1,1250,940,1978
8649900480,725000,4,2.5,2740,12899,2,2740,0,1990
7708250010,325000,3,2.5,1830,7585,2,1830,0,1995
7955040130,460000,3,1.75,1370,8467,1,970,400,1972
3424069215,396480,3,1,1000,10800,1,1000,0,1959
1337801060,1.025e+006,3,1,2050,4800,2,1950,100,1922
2225300585,370000,3,2.75,1750,9166,1,1170,580,1979
2525300380,260656,3,1,1620,13803,1,1620,0,1969
5634500415,431000,3,2.5,1710,12677,2,1710,0,1996
2113700780,320000,3,1,1060,5000,1,1060,0,1958
1310970380,296500,3,2.75,2170,7900,1,1380,790,1978
8562500380,679000,4,2.5,3080,8451,1,1540,1540,1969
0567000680,359000,3,3,1320,1071,2,1080,240,2003
1623049174,330000,4,3,1920,12040,1,1920,0,1962
9406590280,350000,4,2.5,2440,4000,2,2440,0,2009
3275800050,242000,3,1.5,1640,8922,1,1640,0,1963
0326069027,692500,3,2.5,2420,198198,2,2420,0,1997
0825049073,441000,2,1.5,1190,3400,1,990,200,1919
3275870080,765000,4,2.5,2910,15016,2,2910,0,1990
6837700170,375000,2,1,1010,4050,1,1010,0,1950
0243000380,365000,3,1.75,2080,7800,1,1220,860,1955
0582000675,580000,2,1.5,1990,6000,1,1430,560,1944
2655500235,1.605e+006,4,3.5,3920,19088,1,2240,1680,2005
4178300040,841000,4,2.5,3080,13870,2,3080,0,1981
3526059115,515000,5,3,2670,11761,1,1370,1300,1981
1722069052,565000,5,2.5,4320,107157,1,2160,2160,1967
5101404698,365000,2,1.5,1200,6380,1,1200,0,1929
0013002495,295000,3,1.5,1640,7222,2,1640,0,1908
2391600555,406500,2,1,870,5750,1,870,0,1947
1133000144,614905,3,2.5,2410,7225,2,2410,0,1991
2525049133,1.398e+006,5,2.25,2640,14959,1,1770,870,1929
0345700180,250000,2,1,990,10556,2,990,0,1981
7518504775,549000,5,1,1500,3978,2,1500,0,1929
3056800230,397000,4,2.5,1790,6590,2,1790,0,2005
6143600580,184000,3,1.75,1490,10125,1,1490,0,1962
9471200265,2.5e+006,4,3.25,3960,16224,2,3100,860,1938
8024200855,499100,3,1.5,1620,5108,1,1620,0,1954
3178100065,676101,4,1.5,2270,6010,1,1290,980,1954
3432501295,290000,3,1,1150,8145,1,990,160,1932
5467500040,390000,4,1.75,2180,7560,1,1560,620,1962
2872100245,465000,3,1,910,4500,1,910,0,1948
1154100515,470000,3,2.75,2770,54707,1.5,2370,400,1938
3298300210,435000,3,1,940,7590,1,940,0,1959
2473002700,415000,3,1.75,2410,8944,1,1860,550,1967
7544800395,450000,3,2,1010,2820,1.5,1010,0,1905
0822039111,645000,3,2.5,2120,196995,1,2120,0,1997
2223059052,231000,4,2,1530,6375,2,1530,0,1942
1320069223,358000,3,1.5,1810,100188,1,1810,0,1969
2551500220,330000,3,1,1040,11900,1,1040,0,1972
1049000740,229950,2,1.5,1160,1848,2,1160,0,1972
9324800180,403250,2,1.5,1430,8137,1,1130,300,1934
7853220690,470000,3,2.5,2280,6134,2,2280,0,2004
1545803980,239000,3,1,1200,7810,1,1200,0,1967
2484700015,579000,4,1.5,2480,6000,1,1520,960,1955
0993000873,380500,3,2,1270,1348,3,1270,0,2003
9520900210,614285,5,2.75,2730,6401,2,2730,0,2015
3629960590,376000,2,2,1340,1635,2,1340,0,2003
9558200210,290000,3,1,1240,9300,1,1240,0,1954
3876000910,487000,4,2.25,2400,7000,1,1800,600,1965
7228501745,935000,4,2,1220,7489,2,1220,0,1903
8856004328,255000,4,2.5,2163,5882,2,2163,0,2006
0253600150,380000,2,2.5,1860,3504,2,1860,0,2000
5101400934,450000,2,1,810,4368,1,810,0,1958
9202650100,622000,3,2.5,1950,7481,2,1950,0,1987
2310030490,292500,3,2.25,1390,6004,2,1390,0,1993
1860600535,1.32e+006,4,3,2120,3600,2,1830,290,1908
1250201130,410000,4,2,1510,3240,1,870,640,1901
3298700820,160000,3,1.75,1010,5355,1,1010,0,1950
1339300025,809000,4,1.5,1840,4337,2,1840,0,1917
4006000571,183750,5,2.75,1650,5453,1,1650,0,1970
9310300300,411000,5,1.75,2860,12293,1,1430,1430,1947
5332200515,1.05e+006,3,1.75,2650,5512,2,2250,400,1984
0809001565,625000,2,1,1100,4160,1,1100,0,1919
9406520580,305000,3,2.25,1646,9519,2,1646,0,1994
1323059143,915000,4,4.5,5250,48352,2,5250,0,1998
2131701020,317000,3,1.5,1390,8300,1,1390,0,1974
3438503045,165000,2,1,780,6380,1,780,0,1947
3204300705,575000,2,1,1490,6000,1,1090,400,1946
7941600220,219900,3,1,970,7742,1,970,0,1967
3885805175,1.485e+006,4,3.25,3730,7200,2,2810,920,2006
1237500120,300000,3,1,1090,9900,1,1090,0,1955
0322069020,520000,3,1.75,1940,219527,1,1940,0,1991
1310700330,310000,4,2.25,1780,8820,1,1480,300,1966
0423059207,322500,3,2,1190,6445,1,1190,0,1996
7205000180,320000,4,2.25,2000,10374,2,2000,0,1967
7852180530,440000,3,2.5,1390,4997,2,1390,0,2004
6021501780,578000,3,1,1500,4500,1,1120,380,1938
8673400061,382000,2,1.5,1070,877,3,1070,0,2005
3905100220,535000,3,2.5,1720,4006,2,1720,0,1994
5104540330,679000,4,2.5,3680,7236,2,3680,0,2006
6752300120,258900,3,2.25,1400,10436,1,1040,360,1985
4077800412,563000,3,1.5,1730,9509,2,1270,460,1955
2787250090,562000,5,3,2795,15101,2,2795,0,1996
0461002150,725000,4,1.75,2000,3750,1,1120,880,1950
1898310100,236775,3,2.5,1830,8372,2,1830,0,1987
3886902950,860000,4,3.5,3380,8098,1,1690,1690,1952
4427100025,270000,3,1.5,1500,6337,1,1500,0,1953
4038700730,621000,4,2.75,1950,6930,1,1250,700,1960
7852011020,527900,3,2.5,2490,5928,2,2490,0,1998
0126059018,395000,4,2.25,1780,10748,2,1780,0,1964
9407001340,320000,3,2,1110,10500,1,1110,0,1978
2799800750,300000,4,2.5,2500,4750,2,2500,0,2003
0192000120,320000,3,1.75,1480,7225,1,1480,0,1965
0625069064,625000,3,2.25,2570,47480,1,2570,0,1979
2391600330,505000,2,1,810,5060,1,810,0,1941
4180400090,300000,4,2.5,2700,10814,1,1560,1140,1966
0050300220,363000,4,2.5,2180,9281,2,2180,0,2004
4141010110,1.7e+006,4,3.5,4330,15335,2,3230,1100,1988
6641040100,1.1468e+006,4,3.5,4210,10308,2,4210,0,2006
7922720040,680000,4,2.5,2880,9202,1,1780,1100,1977
8825900245,678940,5,2.25,2610,4080,2,1750,860,1909
3883100220,299000,3,1.75,2010,8065,1,1090,920,1984
3649100306,379900,4,1.75,1500,11600,1,1000,500,1955
1099600090,205000,3,1,1290,6566,1,1290,0,1976
9828201725,387500,4,1,1320,4440,1.5,1320,0,1929
9352901085,256000,3,1,1290,4720,1,790,500,1948
4104910040,548000,4,2.5,2440,11005,2,2440,0,1994
6147600040,163000,3,1.75,1290,4811,1,1290,0,1996
6371000026,367500,2,2,1030,600,2,680,350,2004
8121100147,390000,3,2.25,1640,2875,2,1240,400,1983
6152900332,415000,4,2.5,1160,16008,1,1160,0,1989
9522600120,449000,4,2.25,2230,8440,2,2230,0,1968
2207200405,460000,5,2,1910,12264,1,1010,900,1963
0203900690,395000,4,2,1980,15354,1,1980,0,1977
0252000300,300000,3,2,1470,16500,1,1470,0,1961
8899100230,345000,3,1.75,1520,7439,1,1520,0,1969
0685000265,825000,3,1.75,1930,8442,1,1930,0,1953
2705600068,539950,3,2.5,1330,2180,3,1330,0,2014
3326059191,410000,4,2,1580,9581,1,1580,0,1953
1207000025,245000,3,1,1370,6000,1,1370,0,1955
3288301050,482000,4,2.75,3010,15750,1,1560,1450,1973
9407001500,270000,3,1.75,1390,9000,1,1390,0,1978
3882300090,475000,3,1.75,1330,14560,1,1330,0,1983
2926049221,445800,3,2,1320,6500,1,1320,0,1947
2121000300,518000,4,3,2430,11670,1,1330,1100,1978
3885801970,785000,2,0.75,1260,4800,1.5,1080,180,1942
3869900120,430000,3,2.5,1690,1310,2,1140,550,2004
4077800026,715000,4,1.75,3420,7200,1,1770,1650,1947
9324800450,560000,3,1.5,2790,6900,1,1700,1090,1955
1250201194,449000,3,1.75,1270,6600,1.5,1270,0,1903
2597520580,805000,4,2.5,2910,9000,2,2910,0,1989
6679000720,296000,3,2.5,1560,5845,2,1560,0,2003
7312400325,275000,2,1,770,4840,1,770,0,1927
2473500110,419950,3,1.75,1770,16909,1,1770,0,1977
1773100123,285000,3,1.75,1100,1307,2,780,320,2008
6791050100,775000,3,2.5,2890,8470,2,2890,0,1996
1823059106,288250,3,1.75,2110,15400,1,1380,730,1963
3644100065,257000,2,1.75,1220,2268,1,610,610,1909
5652601075,377000,1,1,950,10585,1.5,950,0,1929
2769601250,550000,2,1,1420,3100,1,820,600,1924
9842300540,339000,3,1,1100,4128,1,720,380,1942
7818700410,481500,3,1.75,2140,6000,1,1070,1070,1948
5437810360,224500,3,1.75,1300,7735,1,1300,0,1980
5163700085,260000,3,1,1790,11884,1,1790,0,1951
1794500360,865000,2,1,1470,5400,1.5,1470,0,1912
1777600450,730000,5,3,2500,11779,1,1550,950,1971
4083800555,550000,2,1,980,3080,1.5,980,0,1910
3359500096,645000,3,2,2130,4000,2,2130,0,1908
4024100090,250000,3,1.75,1360,16000,1,1360,0,1978
7228501910,507200,3,3.5,1630,1329,2,1360,270,2000
7183000120,380000,4,2.5,2500,11070,1,1300,1200,1964
7527000090,540000,4,1.75,2260,19500,1,1450,810,1971
8682281080,738500,3,2.5,2300,6009,1,2300,0,2005
2525310040,206000,3,1,1060,10350,1,1060,0,1980
5589300210,265000,2,1,940,9458,1,940,0,1948
4008400515,190000,1,0.75,780,77603,1,780,0,1945
3268000040,339900,3,1,1200,9087,1,1200,0,1969
1022059123,250000,6,2.5,2590,10890,1,1340,1250,1970
3013300968,416500,3,1,1100,4184,1,1100,0,1965
7853220740,575000,4,2.5,2890,9775,2,2890,0,2004
3574801490,385000,3,1.75,1230,7500,1,1230,0,1987
2987400025,253000,3,1,1030,6250,1,1030,0,1960
0625049313,460000,3,1,1140,4600,1,1140,0,1942
6169901085,1.445e+006,4,2.5,3200,3600,3,2600,600,1997
9212900300,492000,2,1,950,6000,1,950,0,1942
2520069100,275000,4,2,1960,30480,1,1060,900,1972
2623069031,542500,5,3.25,3010,1074218,1.5,2010,1000,1931
7625703945,345000,2,1,1080,7775,1,1080,0,1955
9238480120,575000,4,2.75,2730,35075,1,1530,1200,1979
0626049058,275000,5,2.5,2570,17234,1,1300,1270,1959
0125059138,510000,6,4.5,3300,7561,2,3300,0,1980
9185700485,2.538e+006,4,3.5,4350,6000,2,2970,1380,1908
2523089110,830000,3,3.5,3820,145054,2,2870,950,1999
3825310540,640000,4,2.5,2260,5172,2,2260,0,2004
7202340590,702000,4,2.75,3880,15025,2,3880,0,2004
1952200410,960000,3,2.5,2010,6857,1,1450,560,1955
7137900410,190000,3,1,950,7610,1,950,0,1983
7105600085,500000,3,2.25,1730,13040,1,1290,440,1988
1461200040,529000,3,2.5,3070,22098,2,3070,0,1995
6675500035,435000,3,1.75,1500,8173,1,1500,0,1997
4322500110,670000,3,1.75,2160,5760,1,1260,900,1954
6064800090,365000,3,2.25,1960,1985,2,1750,210,2003
8085400355,1.27e+006,5,3,3950,9520,1,2250,1700,1953
0943100220,465000,3,1,1100,145490,1.5,1100,0,1915
0854000165,285000,3,1.5,1400,7582,1,1400,0,1956
1443500905,219950,3,1,1020,4960,1.5,920,100,1926
4031700210,220000,3,1.5,1600,10548,1,1600,0,1962
6169900580,1.465e+006,6,4.5,4230,6420,2,2360,1870,1916
4232401265,1.11275e+006,5,3.5,3090,3600,2,2060,1030,2000
8682290410,694000,2,2.5,2320,9311,1,2320,0,2007
3904902430,620000,3,2.5,2440,10363,2,2440,0,1988
0114101540,415000,3,1,2020,19210,1,1760,260,1949
1025069106,765000,3,3,3270,38088,2,3270,0,1992
3179101945,864000,4,1.75,2260,6600,1,1220,1040,1948
3083000355,385000,5,2,2020,4000,2,2020,0,1950
1741700040,725000,3,1,1000,19969,1,1000,0,1951
1828001130,545000,4,2.25,2030,11585,1,1590,440,1967
3211580210,299900,3,1.75,1730,9893,1,1730,0,1988
1036000610,639500,3,1.75,2010,8072,1,2010,0,1974
3378100100,345000,4,1.5,1540,7168,1,1160,380,1964
9286000150,1.125e+006,6,4,5330,18116,2,3950,1380,2000
7254200040,345000,2,1,960,2700,1,780,180,1904
8827900690,600000,3,2,1460,2800,1,730,730,1921
9202500150,355000,4,1.75,2160,7417,1,1360,800,1983
1786810040,698000,3,2.75,2640,11957,1.5,2260,380,1978
8078410210,566000,4,2.25,2170,7737,2,2170,0,1987
3905100210,449950,3,2.5,1530,3840,2,1530,0,1994
5592900015,404600,3,1,1570,7727,1,1270,300,1958
7522700110,258000,3,1,1490,7435,1,1120,370,1969
5253300243,415000,4,2,1960,10559,2,1960,0,1955
6669020490,320000,4,2.25,2190,9020,2,2190,0,1978
5104510540,295000,3,2.5,1690,4102,2,1690,0,2003
3579700100,389000,5,2,2330,10750,1,1190,1140,1962
8643200035,299900,3,1.75,1470,27000,1,1470,0,1958
2781250100,394000,3,2.5,2550,5349,2,2550,0,2004
3885807255,762000,4,2,2130,5500,1.5,2130,0,1939
1774230090,697000,4,2.75,3650,48351,1.5,3650,0,1978
3521069146,485000,3,2.5,3340,70131,2,2420,920,1994
0424500100,189900,2,1,800,5600,1,800,0,1955
3761700053,2.15e+006,3,2.75,3470,9610,3,3470,0,1989
2685600090,345000,3,1.5,1030,6969,1,1030,0,1921
6381500065,376500,3,2,1630,7800,1,1630,0,1950
9294300515,775000,3,2,2010,7017,2,2010,0,1951
2769602840,450000,3,1,1360,3737,1.5,1360,0,1910
2526039156,760000,4,2.25,2040,8315,1,1480,560,1958
7852140100,569000,4,2.5,2830,10954,2,2830,0,2003
5522600205,500000,3,1.5,2040,6750,1,1280,760,1950
1370802620,592500,2,2,1340,5350,1.5,1340,0,1941
8079100210,620000,4,2.5,2130,9139,2,2130,0,1988
0644200040,1e+006,5,4.25,3920,16258,2,2900,1020,1990
9808640090,815000,3,2.5,2415,2186,2,2415,0,1981
5104531120,775000,5,2.75,3750,12077,2,3750,0,2005
3575303970,340000,3,1,1010,7500,1,1010,0,1975
6413100090,458000,2,1.75,990,5850,1,990,0,1942
2475200870,250000,2,1.5,1200,5773,2,1200,0,1985
3423059081,151600,2,1,1060,16988,1,1060,0,1954
1137410040,515000,4,2.5,3200,6473,2,3200,0,2005
3352400330,216000,2,1,1810,10360,1,1010,800,1946
2781320100,245000,3,1.75,1670,24650,1,1670,0,1974
8894000040,645000,3,2.75,1850,16960,1,1850,0,1953
3333000775,249900,3,1,1100,5000,1,1100,0,1960
9274204230,410000,3,1.75,1660,6250,1,830,830,1980
3972900025,499000,6,1.75,2400,7500,1.5,1400,1000,1975
1159400220,790000,5,3.25,2900,12160,1,1890,1010,1967
3876313030,458000,1,2.25,2140,10350,1,1470,670,1976
2856100515,925000,4,2.5,2670,5100,2,1940,730,1929
4239400730,152000,3,1,1090,3264,1,1090,0,1969
1826059042,402000,3,2.5,1970,12205,2,1970,0,1990
3869900155,340000,2,2,1250,1178,2,980,270,1996
2600010220,1.25e+006,4,2.5,4040,11350,2,3690,350,1984
9290870040,775000,4,2.5,3220,38448,2,3220,0,1993
5347200175,299800,2,1,1310,2814,1,810,500,1944
3810000455,340000,4,2.25,2060,8400,1,1300,760,1960
1962200037,626000,3,2.25,1750,1572,2.5,1470,280,2005
0795001930,324950,2,1,1150,9186,1,1150,0,1946
3905080730,535500,3,2.5,2050,4976,2,2050,0,1994
8651611110,817500,3,3.25,3230,7639,2,3230,0,1999
5411600210,810000,4,3.5,4170,4322,2,2940,1230,2005
7519000665,565000,5,1.5,1940,3430,1.5,1220,720,1926
4217400120,978000,3,1.5,2390,4000,1.5,1690,700,1936
3586500665,530000,3,1,1440,27505,1,1440,0,1951
2582500110,305000,4,2.5,2230,6487,2,2230,0,2003
6749700031,345000,3,2.5,1210,1420,3,1210,0,2008
4136800205,258000,2,2,750,6553,1.5,750,0,1945
3438503120,275000,4,1,1770,7345,1.5,1770,0,1966
1922069089,310000,3,1,1020,55756,1,1020,0,1961
4099501215,713250,3,2,2050,9000,1,2050,0,1951
3325069025,500000,3,1,2000,21780,1,1480,520,1978
4058200985,472000,3,1.75,2180,7200,1,1090,1090,1954
3031200246,250000,3,1,920,4429,1,920,0,1952
0624101110,725000,4,2.25,3440,14237,2,3440,0,1982
4046700210,345000,3,2,1610,15005,1,1610,0,1986
2916200065,460000,3,1.5,1870,15685,1,1470,400,1936
6141100038,440150,2,1,1110,6800,1,1000,110,1947
2806800090,390000,3,1.75,2200,8036,1,1270,930,1978
0312000265,375000,2,1,790,5120,1,790,0,1950
2938200040,224950,3,1.5,1630,9282,1,1630,0,1963
0114101161,480000,3,1.5,2100,67269,1,1220,880,1949
1862400353,721000,4,2.75,2690,5400,2,2210,480,1940
0179000100,174000,2,1,600,4854,1,600,0,1922
7812800865,170000,2,1,810,9882,1,810,0,1944
0809002390,658000,3,1.5,1660,3190,1.5,1660,0,1919
2925059294,860000,3,2,1880,8494,1,1200,680,1968
7574200210,407450,4,1.5,2310,68824,2,2310,0,1968
5634500775,615000,4,1.5,2650,34000,2,2650,0,1930
8965460090,920000,4,3,3130,12381,2,3130,0,1995
1796350300,195000,2,1,860,10400,1,860,0,1983
0428000150,269950,3,1,990,9950,1,990,0,1961
2323089009,855000,4,3.5,4030,1024068,2,4030,0,2006
3528900735,620000,3,2.25,1780,1429,3,1570,210,2007
3904100220,276000,2,2,1480,6075,1,740,740,1919
0254000735,329000,3,1,1140,5258,1.5,1140,0,1911
7893205080,270000,3,1.5,1230,7500,1,1230,0,1962
4397010300,440000,4,2.5,3080,10646,2,3080,0,1993
1150000740,639000,4,2.5,1990,8034,2,1990,0,1989
1926049141,403500,1,1,700,5621,1,700,0,1945
7011201016,585000,3,2.5,1700,1156,2,1320,380,2002
3028200100,216000,2,1,860,9000,1,860,0,1942
8081010040,1.15e+006,3,2.5,3160,24437,1,2160,1000,1991
3023049186,575000,3,2,2500,30056,1,1840,660,1954
8029900110,430000,4,2.5,3000,9460,2,3000,0,2001
9367200205,660000,2,1,1670,8195,1,1670,0,1954
5550300205,338000,2,1,690,6400,1,690,0,1943
8820901415,400000,4,2.75,1240,3867,1,800,440,1987
6018500120,210000,2,1,900,5000,1,900,0,1930
3826000665,305000,4,1.75,2200,8100,1.5,1400,800,1942
1025079086,365000,2,1,960,223898,1,960,0,1985
2621660040,325000,5,2.75,2130,6222,1,1300,830,1991
8731982550,245000,4,1.75,2020,8800,1,2020,0,1969
4324500180,182000,3,1,1060,7350,1,1060,0,1959
1702901485,440000,2,1,1230,6600,1,1130,100,1906
0251300110,225000,3,2.25,2510,12013,2,2510,0,1988
0251300110,358000,3,2.25,2510,12013,2,2510,0,1988
0461002615,580000,5,2.5,2720,5000,1.5,1530,1190,1939
8091401030,240000,3,1.5,1070,8886,1,1070,0,1984
3924500040,700000,4,3.25,3580,43093,1,3580,0,1990
9432900040,325000,4,2.5,2230,8500,2,2230,0,1994
2426049125,488000,4,2.25,2500,10890,1,1800,700,1978
2883201055,875000,4,1,1670,4600,1.5,1670,0,1906
1795900360,615000,4,2.5,2150,9070,2,2150,0,1985
9542830690,321000,3,2.5,2020,4183,2,2020,0,2012
1245500690,1.035e+006,3,2.5,2230,5750,2,2230,0,2003
7454000315,299500,2,1,740,6300,1,740,0,1942
2426049113,459000,4,1.5,2020,9583,2,2020,0,1963
8665050450,435000,3,2.5,1730,4065,2,1730,0,1996
2787320620,222000,3,1.75,1370,8280,1,1370,0,1980
5100401411,485000,4,1,1210,6380,1.5,1210,0,1936
2767602855,750000,5,3.5,2160,2323,3,2160,0,2007
7575620750,266000,3,2.25,1550,6022,2,1550,0,1989
1529300115,455000,2,1,1170,6000,1,970,200,1941
0122029066,490000,3,1.75,2020,215622,2,2020,0,1975
8732130580,280000,3,1.75,1740,8625,1,1240,500,1978
1689400375,1.45e+006,4,3.25,3100,3900,2,2090,1010,1923
0985001321,291000,4,1,1590,24330,1.5,1140,450,1942
7987400475,745000,5,3,2400,10126,2,2400,0,1981
6383000820,685900,3,2.5,2290,9142,1,2290,0,1972
1311400120,160000,3,1.75,1610,7392,1,1610,0,1964
1153000040,650000,4,2.5,2240,9934,1,1490,750,1968
7452500530,250000,2,1,850,6370,1,850,0,1951
6300000212,265000,2,1.5,920,1458,2,920,0,1995
3332000530,599000,5,3.25,2590,6180,1,1330,1260,1960
7657600195,199950,3,1,1340,7260,1.5,1340,0,1944
1102000237,712500,4,2.75,2420,11201,1,1420,1000,1948
2887702070,490000,2,1,1420,4305,1,920,500,1941
6392001005,511500,4,1,1360,6000,1.5,1360,0,1917
1601600195,299000,3,1,1510,6200,1,1010,500,1955
3586500620,685000,4,2.5,2650,25248,1,2330,320,1954
6021502250,597000,4,2,2120,4000,1.5,1720,400,1927
3830210220,210000,3,1,1200,7200,1,1200,0,1977
2568300266,659000,4,2.5,3190,11375,1,2210,980,1946
3423600065,540000,3,1,1050,4160,1,1050,0,1925
3343300180,469000,3,2,1300,22605,1,1300,0,1998
3125079013,1.065e+006,3,2.5,3970,263538,1.5,3970,0,1991
6453900040,575000,5,2.5,2990,7500,1,1800,1190,1972
0148000590,725000,4,2.75,2440,7042,1.5,1640,800,1941
0419000015,299950,4,1,1170,5400,1,1170,0,1953
0303000220,375000,4,2,2270,18450,1,2270,0,1961
6450302175,342450,3,1.5,1280,5525,1,1280,0,1962
1180000625,315000,4,2.5,1950,3225,2,1950,0,2002
7972600450,328000,4,2.75,1930,3840,1,1170,760,1997
1328300180,323000,4,2.75,1970,7213,1,1170,800,1977
7866000158,320000,4,3,1820,3120,1,1000,820,1997
7518505345,550000,2,1,950,4080,1,950,0,1924
8084900195,1.646e+006,6,3.5,4010,16200,1,2090,1920,1955
4139420590,1.2125e+006,4,3.5,4560,16643,1,2230,2330,1995
4139420590,1.2e+006,4,3.5,4560,16643,1,2230,2330,1995
2621600015,120000,3,1,1150,8924,1,1150,0,1943
2621600015,175000,3,1,1150,8924,1,1150,0,1943
8005100360,169900,3,1,910,5800,1.5,910,0,1900
9527000330,508000,6,2.75,2890,7500,1,1830,1060,1976
0748000145,335000,2,1,1070,6678,1,1070,0,1951
9191200015,613200,3,2.75,2050,3320,1.5,1580,470,1927
1822300040,420000,2,1.5,1040,3500,1.5,1040,0,1904
9129100040,1e+006,4,3.25,3320,8587,3,2950,370,2008
3331500940,342000,2,1,740,6180,1,740,0,1948
0524069101,850000,4,2,3380,90968,1,1690,1690,1979
6021502310,582000,2,1.75,1210,4141,1,910,300,1942
4022901316,475000,3,2.5,2480,6031,2,2480,0,2001
0023500180,570000,3,2.25,2010,6000,1,1330,680,1975
9191200490,826600,4,3.25,3230,5000,1.5,1750,1480,1916
1189000207,387000,2,2.5,1170,1394,2,1170,0,2001
1771110720,330000,3,1,1250,9126,1,1250,0,1969
0224069010,653450,3,2.5,2070,49658,1,1540,530,1980
3630060040,285000,2,1,1050,3088,1,1050,0,2005
3211100450,217000,3,1,1400,7800,1,1400,0,1962
1245003255,615000,3,1,1120,12500,1,1120,0,1977
1438000110,580135,4,2.5,3150,5886,2,3150,0,2014
8089500180,1.15e+006,4,3.5,4540,19767,2,4200,340,1998
6802200110,231200,3,2,1400,8821,1,1400,0,1991
7203100120,680000,4,2.75,2500,4950,2,2500,0,2010
3445400120,267500,3,1.5,1390,2153,2,1390,0,2001
1454100650,942000,4,2.75,3160,37200,2,2310,850,1939
0106000015,435000,3,1.75,1310,8065,1,1310,0,1948
9459200110,315000,2,1,1740,3622,1,950,790,1924
3448000410,354901,3,2.5,1490,1709,3,1490,0,2004
8682281220,439888,2,2,1300,6515,1,1300,0,2005
2114700530,360000,4,1,1460,3840,1.5,1340,120,1928
8093600065,205000,4,1,1030,6621,1,1030,0,1955
4137030040,299995,3,2.5,1970,7500,2,1970,0,1988
5126900100,150000,2,1,790,7275,1,790,0,1944
5469501530,575000,3,2.25,3800,33825,1,3330,470,1976
7784000180,625000,3,2,2168,12616,2,2168,0,1950
7135520610,950000,4,3.5,4140,13392,2,4140,0,2000
8856500120,278800,4,2.5,2440,7797,1,1560,880,1965
5015000180,713500,3,2,1720,4200,2,1720,0,1908
3024059014,1.9e+006,4,2.25,3020,11489,1.5,2110,910,1916
9268200348,439000,5,2,2610,5009,1,1710,900,1988
9195700040,425000,3,2,1500,8086,1,1060,440,1981
8798000100,252500,4,2.5,2600,11280,1.5,1570,1030,1961
0304000530,185000,3,1.5,1370,8470,1,1370,0,1961
3575304895,406550,5,2.75,2400,15781,1,1200,1200,1974
9406500540,243000,2,1.5,1068,1758,2,1068,0,1990
6071800410,500000,3,1.5,2220,8994,1,1110,1110,1962
2122049013,204750,2,1,880,7575,1,880,0,1942
5470100220,222000,3,1.5,1310,9273,1,1310,0,1968
6623400246,200000,4,1,1350,11507,1,1350,0,1966
3918400028,367000,3,2.25,1400,1320,3,1400,0,2006
1422700040,183000,3,1,1170,7320,1,1170,0,1962
7660100336,300000,3,2.5,1020,1570,2,720,300,2004
6145602240,369000,3,1.75,1300,3844,1,1300,0,1985
7287100035,380000,3,2,2010,16736,2,2010,0,1929
5101405465,463000,3,2,1590,5009,2,1590,0,1985
3756500180,475000,3,1,1470,9750,1,1470,0,1963
3750605620,225000,3,1.75,1580,14400,1,1580,0,1981
2473350790,371000,3,1.75,1970,9512,1,1970,0,1968
3389900965,625000,3,2.5,2330,3141,2,2330,0,2003
1068000375,3.2e+006,6,5,7100,18200,2.5,5240,1860,1933
9407100730,329000,3,1.75,1230,10725,1,1230,0,1980
7618700112,634000,3,1.75,2570,13000,2,2570,0,1962
5104540360,616000,4,2.5,3440,6915,2,3440,0,2006
1051000040,1.8241e+006,3,2.25,3330,20053,2,3330,0,1968
2896400300,435000,4,2.25,1780,2684,2,1780,0,2002
5003600120,320000,4,2.5,2110,6295,2,2110,0,2000
6352600490,820000,4,3.5,2770,8049,2,2770,0,2002
3820350120,310000,3,2.5,1590,3359,2,1590,0,2000
4235400097,443750,3,2.25,1460,968,2,1140,320,2003
2757000040,795000,4,2.25,2070,13084,1,1700,370,1967
0537000325,475000,3,2.5,2420,36862,1,1530,890,1957
9522100485,585000,5,1.75,2000,3750,2,2000,0,1921
0345700040,315000,2,1,1010,7338,2,1010,0,1981
3904960910,635000,4,2.5,3050,7238,2,3050,0,1989
1771000690,305000,3,1,1160,11776,1,1160,0,1968
1931300035,785000,3,2,2180,5440,1,1100,1080,1904
2770601800,525000,3,1.75,1560,6000,1,780,780,1944
5309100515,537000,4,1.75,1580,3635,1,790,790,1910
0984210850,279950,3,1.75,1660,8303,1,1380,280,1974
0924059233,659000,4,2,2350,9329,2,2350,0,1977
5029451080,203000,2,1,1440,6650,1,970,470,1980
4379400220,782500,4,2.5,2930,7806,2,2930,0,2005
5419800220,250000,3,1.75,1590,7560,1,1130,460,1984
1839500065,279000,3,1,1400,9450,1,1060,340,1955
2525059172,664000,6,2.5,3190,12196,2,3190,0,1979
7159200040,2.9e+006,4,3.25,4580,4838,2,3080,1500,1991
3812400107,378500,4,2,1830,6000,1,1070,760,1953
2726079061,535000,3,1.75,2720,149410,1.5,2720,0,1988
1270000040,520000,2,1,1360,22508,1,1360,0,1932
2113700115,369950,3,2,1520,4000,1,800,720,1943
0824069113,545000,3,2.25,2290,14585,2,2290,0,1981
8856920110,360000,3,2.5,2150,14092,2,2150,0,1991
8146100410,760000,3,1.5,1170,7645,1,1170,0,1955
5101400838,450000,3,1.75,1830,5488,1,1010,820,1939
1088800850,612500,4,2.5,2730,12261,2,2730,0,1991
1061400360,280000,3,1,1090,10710,1,1090,0,1962
9545250110,750000,3,2.5,2560,9182,2,2560,0,1993
0425400115,237000,3,1,1160,6132,1,1160,0,1958
2436700315,441500,2,1.75,1010,4000,1.5,1010,0,1919
1545803520,251000,3,2,1650,7930,1,1650,0,1989
0257000037,200000,3,1,2120,31564,1,1220,900,1942
5016000315,332000,1,1,960,2640,1,760,200,1908
6300500477,401500,3,2.5,1509,1114,3,1509,0,2014
4022905172,585000,4,1.75,2270,27122,1,1300,970,1957
7300000650,340000,4,2.5,1954,4805,2,1954,0,2005
8682282070,920000,3,3.5,2800,7694,1,2800,0,2005
7812801115,153000,3,1,1270,6405,1.5,1270,0,1944
9269750690,299950,4,2.25,1810,7601,1,1080,730,1986
1402620120,440000,4,2.5,2410,7517,2,2410,0,1983
3793501390,293000,3,2.5,1690,17383,2,1690,0,2003
9282800065,203000,3,1.75,1190,6000,1,1190,0,1952
1921059310,193000,2,1.75,1280,6774,1,1280,0,1991
0109000040,305000,3,1.75,1460,7862,1,1460,0,1965
5101405331,495000,4,1.75,1600,6380,1,1130,470,1959
2044500142,420000,3,1.75,1770,6000,1,1130,640,1952
1837010040,569500,4,2.5,2800,8190,1,1700,1100,1971
3905000540,620000,4,2.5,2680,9185,2,2680,0,1989
6071200375,466000,3,1.75,1680,9460,1,1680,0,1959
3756500610,355500,3,1,1120,10032,1,1120,0,1962
3885805035,687500,2,1,1040,7200,1,1040,0,1955
7525100530,432100,3,2.25,1790,2240,2,1790,0,1975
1324059048,500000,3,2.5,2410,34848,1.5,2410,0,1976
3904921250,690000,5,3.25,3370,7313,2,2140,1230,1988
3331500485,350000,2,1,800,5150,1,800,0,1949
7338401759,268000,2,1,1380,5000,1,870,510,1943
3122069029,120000,2,1,990,39964,1,990,0,1945
3797310150,285000,4,2.5,1800,9229,2,1800,0,1994
2205500540,365000,4,1.5,1820,12327,1,1380,440,1955
7202310040,635000,3,2.5,2620,6842,2,2620,0,2002
3630120330,630000,2,2.5,2290,3507,2,2290,0,2005
4310700665,450000,4,3,2200,4466,2,2200,0,1968
7504001080,590000,4,2.5,2940,12600,1,1850,1090,1974
2021200770,895000,2,1.75,1700,3618,1,1260,440,1950
2005600090,160000,3,1,860,11900,1,860,0,1963
0123000110,520000,2,1,910,5000,1,910,0,1924
2473372170,432000,4,3.25,2820,13059,2,2820,0,1976
7227500865,141800,2,1,930,4743,1,930,0,1942
0510001280,980000,4,2,2190,4560,2.5,2190,0,1910
3886903615,1.29e+006,4,2.5,3430,7200,2,3430,0,2014
0439200035,740000,4,2.75,2560,6900,1,1480,1080,1959
4303200184,230000,2,1,770,6450,1,770,0,1948
9362000040,3.4e+006,3,4.5,5230,17826,2,3740,1490,2005
4039701280,954500,3,2.25,2440,9689,1,1830,610,1974
9828201202,622000,3,1.5,1650,3150,1.5,1650,0,1929
2734100835,90000,1,1,780,4000,1,780,0,1905
6749700110,342000,3,3,1260,1634,3,1260,0,1998
3832060940,305000,4,2.5,2320,4683,2,2320,0,2007
2214800110,259900,4,2.75,1560,8820,1,1060,500,1979
1909600115,420000,3,2,2330,6346,1.5,1600,730,1934
0040000553,250000,2,1,1400,19570,1.5,1100,300,1929
7686203195,249950,3,1.5,1450,6875,1,1450,0,1961
2923059064,199000,2,1,1140,15120,1,990,150,1932
2895600090,355200,3,1,1120,7320,1,1120,0,1954
4019301386,425000,3,1.5,1970,13709,1,1680,290,1955
7199360100,379500,3,1,1110,7128,1,1110,0,1980
1241500032,860000,4,2.5,3070,6923,2,3070,0,2009
9558020610,335000,3,2.5,1940,4927,2,1940,0,2004
2050100450,865000,3,2.5,3050,12558,2,3050,0,1997
1250200600,390000,3,1,1240,3600,1.5,1240,0,1902
9325200110,569950,5,4.25,3380,7805,2,3380,0,2014
0293850040,495500,3,2.5,3190,7828,2,3190,0,2006
3723800097,476500,4,1.75,1670,10200,1,1390,280,1953
7788400180,261000,3,1,1660,11200,1,1660,0,1957
2206700215,375000,4,2,2070,9822,1,2070,0,1955
2206700215,550000,4,2,2070,9822,1,2070,0,1955
0603001050,230000,2,1,1430,4000,1,930,500,1949
3583400120,526750,5,2.5,2270,10700,1,1570,700,1963
3886903155,606000,3,2,1980,7680,1.5,1070,910,1911
9485910100,368500,4,2.75,2500,26400,1,1780,720,1977
3223039089,275000,3,1,1230,171190,1,1230,0,1973
2596300035,342000,4,1,1390,9023,1.5,1390,0,1955
9542801120,278100,4,1.75,2120,8520,1,1600,520,1978
8150600195,450000,4,2.75,1540,4840,1,850,690,1929
6806100040,349950,4,2.5,2000,5006,2,2000,0,2005
8857640040,425000,4,2.5,2400,6053,2,2400,0,2001
2138000120,435000,4,2.75,2110,8751,1,1510,600,1962
4022902260,460000,4,2.5,2550,19017,1,1300,1250,1961
2225300149,323000,4,1.75,1440,8114,1,1440,0,1963
3438500880,325000,2,1,810,6827,1,810,0,1944
1646502165,480000,2,1.75,1170,4635,1,690,480,1924
9541600110,1.325e+006,3,2.5,3590,8400,1,2950,640,1958
3348401095,210000,4,1.75,2090,6485,1,1280,810,1956
7579200915,920000,5,4.5,3820,5750,2,2830,990,2000
2126049096,399000,3,1,1460,8290,1,1460,0,1959
6021500025,631750,3,1.75,2360,4063,1,1180,1180,1940
8945000910,184000,3,1,1100,8680,1,1100,0,1962
2473411130,333000,4,2.5,2100,7208,2,2100,0,1974
2781250900,218000,2,2,1310,2841,2,1310,0,2004
3330500925,258305,2,1.5,750,2964,1,750,0,1919
9522100375,775000,5,1.5,1720,5000,1.5,1720,0,1915
1826049362,515000,3,2.5,3370,19585,2,3200,170,1951
1250200495,455000,2,1.5,1200,1259,2,1000,200,2015
5662100110,440000,3,2.5,1830,6807,2.5,1830,0,1954
2025049111,1.44e+006,3,3.5,3870,3819,2,2760,1110,2002
7576700131,850000,3,2.25,2220,3707,2,1620,600,1919
4027701265,480000,3,1.75,2920,21375,1,1850,1070,1961
3423059177,420000,5,2.75,2540,27007,1,1520,1020,1980
3876312840,408000,3,1.75,1970,7100,1,1590,380,1976
6928600330,278000,5,1.75,2170,9752,1,1100,1070,1962
5316100820,1.195e+006,3,3,2350,1620,2,1560,790,2001
1022059161,454000,4,2.25,2630,39000,2,2630,0,1979
4134300175,1.851e+006,4,2.5,4120,14866,1,2070,2050,1965
7853301130,499000,4,2.25,2440,5000,2,2440,0,2007
6928000620,590000,5,3,3480,6625,2,3480,0,2012
5680000750,385000,3,3.5,1900,4805,2,1560,340,1999
0333100265,1.25e+006,4,3.25,3160,10043,2,3160,0,2011
3530490031,202200,2,1.75,1330,2159,1,1330,0,1979
6400700230,450000,3,2.25,1420,13468,1,960,460,1976
0322069010,435000,3,2,2570,233481,1.5,2570,0,1986
2722059013,550000,2,1,1270,43560,1,1270,0,1908
3878900815,361000,3,2.25,2470,5650,1,1550,920,1973
2600010330,760000,4,2.25,2590,12600,2,2590,0,1979
3889100027,902000,4,2.5,3030,8507,2,3030,0,2003
3505100297,505000,3,1.75,1240,4550,1.5,1240,0,1951
5560001130,200000,3,1,1040,8925,1,1040,0,1961
1311910300,260000,5,2.25,2320,6375,1,1270,1050,1967
7518505160,417000,2,1,1190,5100,1.5,1190,0,1928
2115510330,287500,3,2.25,2030,8690,1,1360,670,1986
3955500100,450000,3,1.5,1390,10530,1,1390,0,1961
2771104965,825000,2,1.75,2050,4000,1.5,2050,0,1979
5317100530,1.475e+006,4,3,3050,6179,2,2330,720,1926
3336002215,319950,2,1,1240,5500,1.5,1240,0,1921
9408300180,682000,4,2.5,3030,30000,2,3030,0,1981
2770604575,560000,3,1.75,1930,6000,1,1130,800,1956
7305900082,350000,3,1.75,1490,10344,1,1490,0,1985
8661000148,270000,3,2,1510,10215,1,1510,0,1995
7968460230,284000,3,1.75,1320,35100,1,1320,0,1990
0827000110,308000,4,2.5,2330,4606,2,2330,0,2004
3390600025,450000,4,2,2240,7725,1,1120,1120,1956
1026069172,540000,4,2.5,2050,34222,2,2050,0,1989
1226039103,380000,4,1.5,1680,11123,1,1130,550,1959
2125079054,522500,4,2.75,2200,122403,1.5,2200,0,1971
1545807810,118000,1,1,670,7957,1,670,0,1978
7205500120,280400,4,1.75,1730,7210,1,1010,720,1968
0924069176,710000,4,2.75,2710,41811,1.5,1690,1020,1995
4045500620,720000,3,3.25,3410,25741,2,3410,0,1993
8146100325,787000,3,1.75,1330,7500,1,1330,0,1961
8663240180,537000,4,2.5,1990,2660,2,1990,0,2012
2087700115,650000,2,1.5,1900,4450,1,1500,400,1916
7973202225,154200,4,1,1310,8640,1,910,400,1948
2557000090,238000,4,2.5,1690,7260,1,1080,610,1979
3500100209,285650,3,1,1040,8199,1,1040,0,1953
7234601166,485500,2,1.5,1340,1286,2,1190,150,2006
3972900215,315000,2,1,1120,7350,1,1120,0,1942
1924059029,4.668e+006,5,6.75,9640,13068,1,4820,4820,1983
3900500110,627000,3,2,2310,10525,2,2310,0,1965
5561000600,525000,3,2.5,2190,34528,2,2190,0,1994
3589500315,526000,3,3.25,1220,1281,2,930,290,2014
3658700690,480000,3,1.5,1200,3060,1,1060,140,1910
4054560120,970000,3,3.5,3840,53696,2,3840,0,1996
3918400123,640000,4,2.5,2460,9973,1,1560,900,1965
2592300450,279000,3,2.5,1630,7950,1,1320,310,1985
0123039424,303000,2,2,970,9750,1,970,0,1940
8068000730,315000,4,2,1780,5336,1.5,930,850,1918
7461420230,336500,4,1.75,1760,7268,1,1080,680,1979
1443501020,163250,2,1,770,8150,1,770,0,1951
3798000165,444950,3,1,1760,6927,1,1050,710,1962
0730000085,285000,2,1,990,2446,2,990,0,1998
2061100265,370000,2,1,1250,4960,1,940,310,1938
1683900040,330000,3,2.25,1440,5150,2,1440,0,1997
3959401880,395000,2,2,1960,4018,1,980,980,1950
2124049160,440000,6,3,2510,5310,1,1460,1050,1944
7708180040,625000,4,2.75,2920,6605,2,2920,0,2012
1422300100,435000,3,2.5,1730,46638,2,1730,0,1991
0255550230,299950,3,2.5,1570,2577,2,1570,0,2005
1370804480,560000,2,1.75,970,4233,1,970,0,1944
5104511590,380000,4,3,2800,9764,2,2800,0,2002
1498302783,333000,4,2,1580,7800,2,1580,0,1906
1623800300,499000,2,1,1220,3000,1,920,300,1926
5649600266,386000,3,1.5,1550,8000,1,1330,220,1980
2968801075,320600,3,2,1220,7620,1,720,500,1947
1923039089,285000,2,2,1651,18200,1,1651,0,1946
4006000183,450000,7,4,3150,7800,2,3150,0,2013
9183700845,175000,2,1,800,7150,1,800,0,1933
9558050360,544800,5,2.75,3190,5857,2,3190,0,2004
1683600120,220000,3,1.75,1720,7587,1,1140,580,1981
1604601570,374000,2,2.25,1100,1695,2,1100,0,2009
2787460720,200000,3,2,1010,7896,1,1010,0,1984
2787460720,259950,3,2,1010,7896,1,1010,0,1984
6386700300,255000,4,2.75,1760,9222,1,1140,620,1971
2297400090,447000,3,1.75,1400,6750,1,1040,360,1975
2420069278,287000,3,2.5,1820,8722,1.5,1820,0,1926
7276100145,344950,3,2,1470,6950,1,1470,0,1932
2475900850,212000,2,1,770,7000,1,770,0,1921
3760100100,425000,5,2.75,1340,11583,1,1190,150,1962
7849202585,170000,1,1,480,4560,1,480,0,1922
6430500291,565000,3,1,1260,4080,1.5,1260,0,1928
8151600701,234000,2,1,870,11100,1,870,0,1940
2597450620,1.51125e+006,3,2.5,4010,12105,1,2600,1410,1983
1099900120,345000,3,2.5,2340,8414,1,1280,1060,1993
7853340450,415000,3,2.75,1770,3172,2,1770,0,2009
5652600065,760000,5,1.75,2660,10637,1.5,1670,990,1922
6114400142,484000,5,2.5,3600,20001,2,3600,0,1976
3630050180,360000,2,1.75,1230,1107,2,1230,0,2006
1853000300,875000,3,2.75,3270,39586,1.5,3270,0,1988
3585900785,930000,3,2.5,3100,20553,1,3100,0,1954
1545801970,250000,3,2,1900,6660,1,950,950,1966
7853340610,394000,2,2,1750,2731,2,1750,0,2012
8562900590,865000,4,3.5,3380,11270,2,2160,1220,2007
9422400035,477500,2,2,2090,6000,2,2090,0,1918
9273200115,1.25e+006,4,2.75,4120,12500,1,2060,2060,1947
3971700937,270000,3,1.75,1260,7500,1,840,420,1947
1508210230,567000,3,2.25,1800,6875,1,1230,570,1974
5249803550,635000,3,2.5,1960,7200,1,980,980,1940
4218400100,1.865e+006,6,2.75,4460,6952,2.5,3460,1000,1930
1424100100,183000,3,1.75,1330,9200,1,1330,0,1973
7861000021,309933,3,1.75,1820,78408,1,1220,600,1950
7856601110,945800,4,2.75,3360,9100,1,1760,1600,1973
1121039059,503000,2,1.75,2860,59612,1,1510,1350,1948
0522059172,220000,3,1,1460,10200,1,1460,0,1957
8594400110,335000,3,1.75,1900,36769,1,1900,0,1987
9201000120,650000,3,2.25,1790,9927,1,1240,550,1969
1822059440,511000,4,3.5,3100,7600,2,3100,0,2005
1623089039,275000,2,1,900,57063,1,900,0,1938
0452001570,576250,2,1.75,1530,5000,2,1260,270,1989
1724069079,1.452e+006,2,3.25,2070,3128,2,1760,310,1988
3141600210,186000,3,2,1340,4320,1,920,420,1912
1797500530,655100,1,1,1220,4160,1,1220,0,1922
7300400580,328000,4,2.5,2370,6500,2,2370,0,1998
1826049442,441000,3,2.5,1890,11036,1,1460,430,1973
2525000220,370000,3,1.75,1480,7725,1.5,1480,0,1981
0191100665,630000,2,1,1050,8382,1,1050,0,1959
5634500201,470500,4,2.25,2070,14000,1,1720,350,1958
0795000405,285950,2,1,1170,6000,1,1170,0,1948
1300300730,698000,3,1.5,1090,7200,1,1090,0,1958
1862900040,268000,3,2.5,1650,6684,2,1650,0,1991
9279700150,1.625e+006,4,3.75,4410,8112,3,3570,840,2003
0322059311,355000,4,2.5,1780,15000,2,1780,0,1993
3333002710,299000,3,1,1550,8778,1,1250,300,1952
1257200115,1.003e+006,4,2.75,2290,6120,2,2170,120,1926
9183703045,275000,4,2,2220,8229,1.5,2220,0,1958
7899800905,475000,3,1.75,1150,10240,1,1030,120,1918
7215400770,260000,4,2.5,2000,37045,2,2000,0,1989
1139000215,416000,2,1.75,1270,7560,1.5,1270,0,1932
9218400088,495000,5,1,1810,11205,1.5,1810,0,1915
9455200596,357500,3,1,1450,8100,1,1450,0,1952
0510002506,459500,2,1.5,1170,1079,3,1170,0,2003
7212680850,258000,3,2.5,1730,6930,2,1730,0,1994
5229300085,600000,3,2.25,2680,98445,1,2680,0,1962
7436000205,665000,3,1,1260,24550,1.5,1260,0,1937
0425200205,165000,3,1.5,1020,10152,1,1020,0,1959
7138200150,297000,5,2.5,1970,8605,2,1970,0,1994
1782000180,350000,2,1,830,5100,1,830,0,1942
3623500205,2.45e+006,4,4.5,5030,11023,2,3250,1780,2008
1423200110,180000,2,1,800,9450,1,800,0,1958
0797000256,339950,3,1.75,1330,12092,1,720,610,1981
9357000215,365000,3,1,1030,4700,1,1030,0,1952
2526069095,955000,4,4.25,5660,193593,2,4100,1560,2001
6908200650,732000,3,2.5,2330,1987,2,1410,920,2004
5021900175,500000,3,1.75,1540,10800,1,770,770,1947
4038700220,610000,6,2.75,2040,8560,1,1100,940,1961
9455200205,525000,3,2,1540,7800,1,1540,0,2004
5379804470,170000,4,1,1920,13787,1,1220,700,1966
2517000150,300000,3,2.5,1870,3439,2,1870,0,2005
9264930770,389500,5,3.5,2960,12527,2,1940,1020,1986
4197400043,330000,3,1.5,1690,10250,1,1690,0,1955
2329800330,269950,3,2.25,1610,7187,2,1610,0,1988
7899800450,107000,2,1,670,4720,1,670,0,1948
2895110062,249000,3,1,1752,14626,2,1752,0,2005
3448001285,442500,4,2,1540,5920,1.5,1540,0,1935
0521079025,579000,3,2.5,3160,286181,2,3160,0,2002
0624069098,621500,3,1.75,2570,39634,2,2570,0,1984
2946003580,203000,3,1.5,1370,7500,1,1080,290,1958
7227500450,222900,2,1,860,5800,1,860,0,1942
2322069100,453000,2,1.5,1680,17400,1.5,1680,0,1991
2144800615,190000,1,0.75,930,29258,1,930,0,1941
1432900150,320000,4,1.75,1820,7381,1,1150,670,1962
7942601810,733500,3,1.5,2120,4370,1.5,2120,0,1904
7302900090,555000,4,2.25,3330,21785,2,3330,0,1994
2310050110,364950,3,2.25,2520,6170,2,1850,670,2003
6743700090,490000,3,1.75,1560,9247,1,1160,400,1989
3935900093,688000,5,1.75,2250,13526,1,1350,900,1957
0123039279,165000,2,1,640,7768,1,640,0,1942
4307350730,506000,5,3.75,3880,8370,2,3880,0,2004
1954700610,2.193e+006,3,2.25,3360,7108,2,2770,590,1905
8155500110,754000,5,1.75,2350,7800,1,1510,840,1968
7129303045,949950,5,2.5,2340,1989,2,2340,0,1959
6021503451,443600,3,2.5,1430,1056,3,1430,0,2003
3793400360,380600,3,2.5,1920,12244,2,1920,0,1998
7504101280,722800,3,3.25,4330,14600,2,3630,700,1985
3331500121,342888,2,1,790,5150,1,790,0,1948
0438000015,555000,4,1.75,2350,5946,1,1350,1000,1957
5366200205,613000,3,2.5,1350,3068,2,1350,0,1991
2026049067,480000,3,2,1470,10052,1,1470,0,1956
3885808035,619500,6,1.5,1680,5202,1.5,1680,0,1911
1494300040,437000,4,2.5,1890,8505,1,1290,600,1980
6071200195,621000,4,2.5,2030,9905,1,2030,0,1959
1257202215,810000,4,1.75,1760,4080,1.5,1760,0,1906
5589300145,415000,3,2.25,1950,8868,1,1350,600,1964
0293000145,250000,4,1,1440,7404,1,1080,360,1918
4315701163,585000,3,1.5,2230,6000,1,1260,970,1968
6163900981,220000,3,1,1180,5002,1.5,1180,0,1946
4157600120,580000,5,2.5,2500,11900,1,1400,1100,1963
3262301355,1.32e+006,3,2.75,2680,20104,1,1820,860,1964
4376700330,675000,4,2.5,2040,9225,1,1610,430,1968
8691370330,695000,4,2.75,2660,7389,2,2660,0,2002
5078400090,915000,5,2.75,2580,7630,1,1730,850,1954
5272200040,375000,3,1,1000,6947,1,1000,0,1947
2997800015,500000,3,1.5,1330,1265,2,1140,190,2008
2780900220,335000,2,2,1420,5185,1,1420,0,2004
4463400195,170000,2,1,1280,21750,1.5,1280,0,1912
0844001485,320900,5,2.5,2200,8500,1,1400,800,1971
8123450300,508000,3,1.75,1800,8462,1,1440,360,1978
7137800300,228950,3,1.75,1200,9085,1,1200,0,1968
7972600910,433000,4,2,1840,4760,1.5,1080,760,1929
7452500770,267500,2,1,960,5150,1,960,0,1951
5250300035,910000,4,1.5,2890,9000,2,2090,800,1939
9517200610,370000,3,1.75,1290,10117,1,1290,0,1984
0952004570,320000,2,1,1140,3834,1.5,1140,0,1911
0579002600,660000,3,1.75,1750,5200,1,1750,0,1956
4351300978,787888,4,2.25,2580,21115,2,2580,0,1977
1152700090,329000,4,2.5,2650,5880,2,2650,0,2005
3179100720,602000,2,1,1470,6398,1,970,500,1941
5628300015,375000,3,2,1640,9750,1,1640,0,1959
1900000035,212000,1,1,620,7620,1,620,0,1926
1105000432,224000,3,1.5,1440,8370,1,1440,0,1977
1402810150,315500,3,2,1160,10079,1,1160,0,1986
2163900028,350000,2,1,1070,2880,1,1070,0,1902
5409000110,389000,6,4.5,3560,14010,2,3560,0,1989
8687800100,285000,3,1.75,1720,13104,1,1720,0,1962
8563300085,425000,3,1.75,1530,9800,1,1530,0,1958
7140200330,190000,3,1.75,1270,7875,1,1270,0,1980
2124069103,374000,3,1.75,1510,18439,1,1510,0,1971
1703401110,292000,2,1,880,5500,1,880,0,1904
6046400755,475000,5,1.75,2020,5100,1.5,1320,700,1911
5309100450,546500,3,2.5,1410,2675,1,820,590,1985
3883800011,82000,3,1,860,10426,1,860,0,1954
3883800011,219900,3,1,860,10426,1,860,0,1954
4315700175,440000,3,1,1210,5750,1.5,1210,0,1910
0221029019,400000,3,2.5,2090,32718,2,1550,540,1919
4035900085,453000,3,1.75,1430,20193,1,1430,0,1955
3438500781,330000,6,3.25,2120,6893,1,1060,1060,1983
8097000330,359950,3,2.75,2540,8604,2,2540,0,1991
8677300720,616000,4,2.5,2490,12929,2,2490,0,1983
3644100072,245000,2,1,670,2356,1,670,0,1960
1453602284,296000,2,2,1320,2040,3,1320,0,1997
4365700450,193000,2,1,950,9000,1,950,0,1924
9268200315,456000,3,2,1870,8442,1.5,1060,810,1927
4358700141,480000,4,1.75,1840,9250,1,980,860,1956
4310701577,382000,3,3.25,1410,1253,3,1410,0,2005
9828200762,650000,2,1,1050,2542,1,880,170,1904
2026049097,431750,2,2,1400,10052,1,1400,0,1957
6639900219,419900,3,2.5,1630,1755,2,1320,310,1997
2521039066,315000,3,2,1900,9513,1,1900,0,1995
5649300120,597500,4,3,1890,35280,1,1510,380,1979
1774230300,615000,3,2.5,2980,43301,1,1930,1050,1978
7313200120,605000,4,3.25,2885,33671,2,2885,0,1984
4137010540,220000,3,2.5,1980,11900,2,1980,0,1990
7844200120,340000,4,2.5,3020,8750,1,1710,1310,1960
1923099058,620000,4,2.5,2980,210395,2,2980,0,2001
7922710690,602000,5,1.75,3290,11900,1.5,3290,0,1973
2624049165,575000,3,1.75,1580,11750,1,1180,400,1951
7575600100,285000,3,2.5,2090,10834,1,1360,730,1987
3450400330,306500,3,1.5,1100,8140,1,1100,0,1965
4307300930,325000,3,2.5,1870,3480,2,1870,0,2002
3288301030,623000,3,2.75,2390,21804,1,1450,940,1973
5466350120,256500,3,2,1320,8568,1,1320,0,1993
3791410210,473000,5,3.5,3430,6872,2,2830,600,2002
1795900120,549000,3,2.5,2250,9235,2,2250,0,1985
8656300385,305000,3,1,1710,19115,1,1710,0,1986
6649250410,317000,4,2.5,2160,8049,2,2160,0,1988
1426049054,450000,3,1.75,1400,13775,1,1400,0,1963
7841300535,225000,2,2.5,1560,5333,1,780,780,1947
2867700035,500000,5,2,2300,7897,2.5,2300,0,1956
2658000215,207000,2,1,820,4860,1,820,0,1955
7100000120,474900,3,1,1630,8308,1.5,1630,0,1948
0200300210,515000,3,2.5,2010,7200,2,2010,0,1994
1868903130,542000,4,1,1540,5000,1.5,1090,450,1922
7385310040,725000,4,2.75,2420,10962,1,1530,890,1977
5104510210,314950,3,2.5,1690,4533,2,1690,0,2003
9517200180,375000,3,2,1410,10078,1,1410,0,1983
1725079061,500000,3,1.75,1640,47044,1,1640,0,1989
2141310820,689000,3,1.75,2200,9840,1,1500,700,1978
2902200234,525000,3,2.25,1290,1182,2,1000,290,2006
1443500395,360000,3,1.5,1060,6232,1,1060,0,1968
2391601010,425000,3,1,1240,5750,1,1240,0,1948
7129303970,239950,2,1,1280,5500,1,1280,0,1949
0567000025,577500,2,2.5,2330,3000,2,2330,0,1915
2493200195,615000,3,1.75,2360,7291,1,1360,1000,1948
8562901250,516000,4,2.75,2210,10800,1,1170,1040,1997
2600020330,1.218e+006,4,2.75,3670,15400,2,3670,0,1986
1370801520,1.655e+006,4,3.5,3080,4815,2,2300,780,1937
5589900761,315000,2,1,770,6731,1,770,0,1943
3601800580,250000,4,2,2600,9000,1,1410,1190,1959
3336000296,250000,4,1.5,1220,4900,1,1220,0,1942
1525059020,925000,4,2.5,2910,48351,1,1910,1000,1967
6150200330,358000,3,1,1150,4681,1,1150,0,1955
4136950180,262000,3,2.5,1700,6200,2,1700,0,1997
0259600790,500000,3,1.75,1220,7370,1,1220,0,1964
2770604925,1.3e+006,5,1,1670,6400,1.5,1670,0,1919
6902000100,500000,3,1.75,2420,65501,2,2420,0,1984
3275850180,675000,3,2.25,2610,9002,2,2610,0,1988
4154300296,235000,3,1,960,5030,1,960,0,1955
4154300296,545000,3,1,960,5030,1,960,0,1955
3888100043,350000,3,1,1010,9360,1,1010,0,1981
8165501510,320000,2,2.25,1550,1827,2,1550,0,2008
5152700120,452000,5,2.5,5067,13315,1,3154,1913,1968
1962200475,875000,3,2,2350,6000,1.5,1990,360,1922
0272000355,325000,3,1.5,1310,2998,2,1310,0,1998
5113400113,756000,4,2.25,2160,5600,1,1080,1080,1947
6669010120,319000,4,2.5,2510,7992,1,1610,900,1978
7170200110,455000,3,1.75,890,3800,1.5,750,140,1926
2113700025,330000,2,1,1129,3840,1,1129,0,1953
7197000100,510000,4,3.25,1980,9988,1,1340,640,1980
7577700061,532000,3,1,2360,5012,1,1560,800,1964
1862400215,775000,3,2.5,2480,5007,2,1960,520,2014
3726800201,410000,3,1.75,2160,4000,1,1080,1080,1953
0013002460,205000,2,1.75,1740,5100,1,580,1160,1915
5151200215,585000,4,2.5,2430,6766,2,2430,0,1999
8731983200,255000,2,1.75,1950,8200,1,1950,0,1975
5309101395,415000,2,1,910,3750,1,910,0,1904
4364700945,459000,4,2,2360,7080,1,1180,1180,1925
0395300330,354000,3,1,1130,11250,1,1130,0,1965
3295730040,587000,3,2.5,2150,5193,2,2150,0,1995
7937600395,782000,4,3.5,5270,53428,2,3440,1830,2004
1236300146,570000,3,1.5,1300,7287,1,1300,0,1965
8024200625,414500,3,1,1050,6002,1,840,210,1941
7340600845,185000,4,1,1380,6700,1,1190,190,1928
0898000220,262500,3,1.5,1610,10291,1,1610,0,1961
2212600100,370000,4,2.75,3150,67518,1,2250,900,1965
6412100092,362500,3,1,1520,9507,1,1520,0,1954
8835350300,536000,3,2.5,1990,7397,2,1990,0,1993
2586800210,425000,5,2,2500,7804,1.5,1570,930,1921
2044500201,435000,3,2.25,1890,7200,1,1230,660,1973
6450303950,435000,5,2,1840,9240,1,1540,300,1942
3013300409,400000,2,1,1220,6300,1,760,460,1942
1934800087,446000,2,1.5,1370,1221,2,1080,290,2008
1125049140,1.25e+006,3,2.5,2710,13120,1,2710,0,1959
2025700180,300000,3,2.25,1760,5421,2,1760,0,1991
8024201055,404500,2,1,800,5080,1,800,0,1938
2426059097,910000,4,2.5,3530,49222,2,3530,0,1986
9829200855,771000,3,2.25,1780,6120,1.5,1390,390,1927
1864940180,335000,4,2.5,2610,4781,2,2610,0,2009
1023089085,390000,3,1.75,1850,15170,1,1850,0,1965
4399200100,288000,3,2.25,1560,9706,1,1560,0,1963
1087500040,403000,3,1.75,1270,10790,1,1270,0,1956
1972201965,510000,3,2.25,1420,1309,3,1420,0,2006
0272000085,751000,6,3,2880,6800,2,2880,0,1980
7129302806,408000,3,1,1420,8000,1,1420,0,1950
4389201021,1.01425e+006,3,1,1640,12855,1.5,1500,140,1920
6751300385,575000,3,2,1730,9030,1,1730,0,1956
0723049274,330000,3,1.75,1250,8100,1,1250,0,1951
2767602094,565000,3,2.25,1520,1221,3,1520,0,2013
8635760330,456000,3,2.5,1820,2935,2,1820,0,1999
3905010100,652500,4,2.5,2700,9122,2,2700,0,1990
2493200215,582000,3,1.75,1820,3140,2,1820,0,1949
8691390530,700000,4,2.5,2770,5686,2,2770,0,2004
4319200620,235000,2,1,1270,9182,1.5,1270,0,1917
0424069096,460000,3,1.75,1400,12155,1,1400,0,1977
8121200820,475000,3,2.25,1820,8008,1,1240,580,1981
8682231110,579000,2,2,1870,6275,1,1870,0,2003
2767602645,507000,4,2,1360,2746,1.5,1360,0,1945
7131300035,210000,3,2.5,1040,2643,2,720,320,2004
2595650100,359500,4,2.75,2140,10316,2,2140,0,1993
2616700450,248000,3,1.75,1330,9831,1,1330,0,1987
2520900301,239300,3,1,1070,5750,1,1070,0,1952
1473200150,315000,3,2.25,1370,1533,3,1370,0,2009
1726600150,970000,4,3,3510,12410,2,3510,0,1976
9169600110,510000,3,1.5,1730,6240,1,1000,730,1954
4036800580,418000,4,1.5,1550,9176,1,1000,550,1956
2324800110,699000,4,2.5,3280,27441,2,3280,0,1996
7855800910,871000,4,2.5,2150,8536,1,1400,750,1967
3625059140,515000,3,1.75,1580,9147,1,1210,370,1967
0001200021,400000,3,1,1460,43000,1,1460,0,1952
9455200790,445000,3,1.75,1410,5100,1,1110,300,1954
2021200530,1.11e+006,4,2.75,3090,6600,1,1800,1290,1956
7760600110,212000,3,1.5,1690,9600,1,1210,480,1976
9323610110,710000,4,2.5,2870,11304,2,2870,0,1980
1612500090,225800,4,1,1100,7110,1,880,220,1907
4027700594,520000,3,1.75,2310,36665,1,1580,730,1983
1924059254,1.295e+006,5,3.75,3490,15246,1,1940,1550,1968
2172000846,248000,4,2,2080,13510,1,1040,1040,1950
0514500195,556000,4,2.5,2230,7200,1,1220,1010,1957
8151600142,319950,5,1.75,1710,11900,1,1070,640,1958
7950304045,320000,4,2.75,1640,3000,1,1000,640,1984
6700390210,245000,3,2.5,1600,2788,2,1600,0,1992
2195700230,700000,3,2.5,2850,36585,2,2850,0,1987
0558100090,628000,5,2.75,2600,8160,2,2600,0,2015
2749600245,640000,3,2,1380,4800,1,1380,0,1948
1782500065,420000,4,1.75,1320,4978,1,940,380,1942
0263000329,349950,3,2.5,1420,1162,3,1420,0,2002
9432900180,307999,4,2.75,2420,8438,2,2420,0,1996
0142000165,749950,4,2.75,2600,6050,2,1960,640,1949
6145600410,290000,2,1,840,3844,1,840,0,1919
2599001500,235000,3,1.75,1420,7920,1,1420,0,1962
1721801010,225000,3,1,1790,6120,1,1790,0,1937
1721801010,302100,3,1,1790,6120,1,1790,0,1937
5101404491,520000,2,1,1340,6380,1,890,450,1939
0326049111,285000,2,1,1010,7200,1,1010,0,1975
1785400300,525000,3,2,1640,15258,1,1640,0,1981
1310980580,374900,5,2.75,2980,8500,1,1540,1440,1982
6632300230,377500,3,2,1370,7200,1,1130,240,1926
9324800650,587450,3,2.25,2190,8775,1.5,2190,0,1927
2188201010,245000,3,2.25,1530,12000,1,1070,460,1979
7137910360,200000,3,2,1290,5757,1,1290,0,1994
0125069038,2.14e+006,4,3.75,5150,453895,2,4360,790,1997
9465910150,607000,3,2.5,2470,9226,2,2470,0,1991
0724069023,1.247e+006,1,1.25,1810,5070,1.5,1230,580,1967
6600220150,549950,4,2.5,2230,14694,1,1180,1050,1981
7227800025,250000,3,3,2300,7701,1,2300,0,1960
3905040220,525000,3,2.5,2030,6970,2,2030,0,1991
5072300210,440000,3,1.75,2000,9900,1,1480,520,1957
0121039042,425000,3,2.75,3610,107386,1.5,3130,480,1918
6705870120,739900,5,2.5,3290,5029,2,3290,0,2004
1109000040,315000,3,2,1300,3731,1,900,400,1993
9358001590,340000,5,1,1880,3774,1.5,1360,520,1917
0705700580,366000,4,2.75,2170,9743,2,2170,0,1995
4343800100,315000,3,1.75,1680,7250,1,930,750,1952
3343900781,299000,3,1.5,1190,9135,1,1190,0,1959
1062100085,350000,2,1,940,5000,1,940,0,1950
6821101827,340000,2,1.75,1010,1461,1,670,340,2003
3901100015,460000,3,1.75,1290,8580,1,1290,0,1962
9500900110,224000,3,1.5,1480,10588,1,1480,0,1957
4006000401,140000,2,1,900,6400,1,900,0,1940
1218000025,246000,4,2,1400,7632,1.5,1400,0,1930
1875500040,330000,3,2.5,2040,14071,2,2040,0,1995
7955000210,306000,3,1,1450,7200,1,1010,440,1969
7568700175,324950,3,1,1210,7440,1,1210,0,1949
3410600100,345000,2,1.5,1800,26615,1,1240,560,1987
0923049378,207000,3,1,1490,8995,1,1490,0,1954
0420000085,238000,3,1,1240,5700,1.5,1240,0,1953
2817210210,695000,3,2,2632,18743,2,2632,0,2000
2141340040,649950,3,2.5,2150,15304,2,2150,0,1979
0714000315,515000,3,2.75,1710,9448,1,1010,700,1947
0263000040,452000,3,2.5,1530,5032,2,1530,0,1998
1721801161,236000,4,2.5,1630,3060,2,1630,0,2003
4139490210,1.285e+006,4,3.5,4080,14450,2,3210,870,1998
6790900110,563000,3,2.75,2340,16500,1,1500,840,1972
1775800220,410988,3,1.75,1000,14061,1,1000,0,1967
2569500210,339950,0,2.5,2290,8319,2,2290,0,1985
4141000490,1.2e+006,4,2.5,3180,13118,2,3180,0,1986
8078100120,340000,4,2.5,2170,19785,2,2170,0,1992
3034200666,808100,4,3.25,3020,13457,1,3020,0,1956
8892900210,236000,3,1.75,1330,6301,1,1330,0,1998
7399000360,330000,4,1.75,1720,8300,1,1720,0,1965
3491300082,799990,4,3.5,2540,5808,2,1820,720,1910
2310060040,240000,0,2.5,1810,5669,2,1810,0,2003
0323059146,343000,3,1,1410,18600,1,1410,0,1960
1079350090,332000,3,2.5,1530,9406,1,1270,260,1993
0098000740,945000,5,3.5,4380,14925,2,4380,0,2003
5126400150,239950,3,1,1140,8366,1,1140,0,1943
8815400165,674000,5,1.75,2110,5000,1.5,1250,860,1946
0421000555,200000,3,1,1050,5000,1,1050,0,1967
0686300930,453000,3,1.75,1600,7232,1,1600,0,1966
2744600040,330000,3,1.75,1430,8865,1,1430,0,1950
3832070040,285000,4,2.5,1996,4547,2,1996,0,2009
7305300090,338000,4,1.75,1530,8152,1,910,620,1948
7452500730,264950,2,1,1000,6000,1,1000,0,1951
1824059079,880000,4,2,2530,10800,1,1350,1180,1954
3438503426,209500,3,1.5,970,5488,1,970,0,1976
8948500025,380000,4,2.5,2400,9398,1,1310,1090,1958
1722059021,336500,3,2,1830,12891,1,1830,0,1994
8899210090,360000,3,2.25,2130,8466,1,1290,840,1983
4019300155,911100,4,3.25,3330,33826,2,3330,0,1924
4364700165,249900,2,1,560,7560,1,560,0,1944
0796000085,175000,4,1,1210,6250,1,1210,0,1962
7987401095,549950,3,2.5,2380,2500,3,2380,0,1988
1237500540,225000,3,1.75,1370,10866,1,1370,0,1945
1237500540,270000,3,1.75,1370,10866,1,1370,0,1945
3649100304,400000,3,2.25,1740,11040,2,1740,0,1980
0007400062,299800,2,1,790,5240,1,790,0,1925
6388910730,555000,3,2.5,2480,8676,2,2480,0,1989
7882900120,230000,3,2.5,1920,9180,2,1920,0,1988
1865000040,360000,4,2.5,2750,6259,2,2750,0,2002
6821100246,415000,2,1,880,3200,1,880,0,1910
8731981500,355000,4,1.75,2160,8000,1,1660,500,1976
6979910120,635000,4,2.5,2570,27972,2,2570,0,1997
2123700100,353000,5,2.75,2130,5000,1,1100,1030,1978
3425059141,999000,7,4,3150,34830,1,3150,0,1957
3876600120,265000,3,1.5,1780,10196,1,1270,510,1967
4038000040,250000,4,1.75,1910,8250,1,1910,0,1959
6668900155,225000,2,1,1170,7142,1,1170,0,1951
8132700150,553000,2,1,900,5000,1,900,0,1944
4038800580,565000,5,2.5,2650,11455,1,1400,1250,1961
3331001910,312000,2,1,1170,5150,1,980,190,1907
2726079103,475000,3,2.5,2630,185130,2,2630,0,1991
7212651210,320000,4,2.75,2150,9163,1,1340,810,1992
2026059119,453000,3,2,1430,9583,1,1430,0,1964
3330501120,320000,3,1,960,6180,1,960,0,1910
1250202324,610000,4,2.75,2640,8400,1,1440,1200,1947
3815500035,385000,3,1.5,1490,9630,1,1490,0,1959
5706600150,215000,3,1.75,1210,8075,1,1210,0,1983
8005100540,215000,4,1.5,1860,5040,1.5,1860,0,1920
0293720180,415000,3,2.5,1980,4274,2,1980,0,2003
5101405604,350000,1,1,900,6380,1,900,0,1947
5101405604,395000,1,1,900,6380,1,900,0,1947
2387000110,898000,2,1.75,1490,9874,1,1490,0,1963
7238000330,480000,3,2.5,2980,7338,2,2980,0,2006
3879901295,1.24e+006,3,2.5,2660,1973,3,1870,790,2007
0326069131,599000,4,2.5,2790,230868,2,2790,0,1989
0629811340,770000,4,3,2800,9127,2,2800,0,1999
9808700650,1.208e+006,3,2.25,1590,8520,2,1590,0,1980
8964800755,1.59e+006,4,2.25,3240,11131,1,2080,1160,1953
1126059095,880000,3,2,2130,35169,1,2130,0,1989
1899400365,332000,3,2,1510,7884,1,1510,0,1942
0259800410,445000,3,1.75,1750,7200,1,1750,0,1966
3523069047,849000,4,2.75,4010,87555,2,4010,0,2004
6852700476,752000,4,1.5,1650,2970,1.5,1650,0,1903
0424049043,450000,9,7.5,4050,6504,2,4050,0,1996
7646900360,420000,3,1,1320,5500,1,1320,0,1955
2991000220,330000,4,2.5,2310,6320,2,2310,0,1997
3034200366,409000,3,1.75,1440,9065,1,1440,0,1972
5127000410,350000,5,1.75,2330,14322,1,1180,1150,1968
2826079101,570000,4,2.5,2430,44001,1,2430,0,1994
3972900195,315000,3,1,1390,8333,1,1390,0,1982
8018600870,224000,2,1,1150,15000,1,1060,90,1930
0257000038,293550,4,1.75,2120,9706,1,1370,750,1965
7981900110,350000,4,2.75,2300,3175,1.5,1340,960,1966
8965500880,1.108e+006,4,2.5,3320,9380,2,3320,0,1988
5253300437,442500,4,2.5,2400,7092,2,2400,0,1997
2523069172,616500,3,2.5,3580,118047,1,3240,340,1992
6388910360,506400,3,2.5,2100,9040,1,1700,400,1989
7326200110,324000,3,2.25,1550,4411,2,1550,0,2001
3701900085,169000,3,1.5,1570,6450,1.5,1570,0,1931
9376301520,595000,3,2,1480,5000,1,750,730,1928
2111000580,299900,3,2.5,2720,6014,2,2720,0,2002
8645510230,332000,3,2.25,2270,8876,1,1380,890,1977
6204410330,432000,4,1.75,2410,8400,1,1600,810,1978
8159300040,510000,4,2.75,2730,9112,1,1740,990,1996
8091410530,270000,3,2.5,1540,7739,2,1540,0,1986
8653600100,750000,5,2.5,3120,15593,2,3120,0,1986
9550202730,509250,2,1.5,1480,3120,1,930,550,1914
8651410740,189000,3,1,860,5200,1,860,0,1969
0225039177,726500,4,2.5,2180,3893,2,2180,0,1999
6082400191,287000,3,2,1300,11374,1.5,1300,0,1933
3622069095,679000,4,3.5,3420,49223,2,3420,0,2004
6666860210,316000,3,2.25,2130,8721,1,1570,560,1987
8161000230,498000,4,2.5,2300,22445,2,2300,0,1992
7214820610,448000,4,1.75,2560,8270,1,1480,1080,1979
0434000040,535000,2,1,1040,5527,1,1040,0,1951
8914200220,560000,4,3,3080,9601,2,3080,0,1990
6072760210,437850,4,2.25,2670,14255,1,1610,1060,1975
9485950040,435000,4,2.75,3270,50994,2,2720,550,1983
4027700456,510000,4,2.5,2610,8031,2,2610,0,1998
1023059365,520000,3,2.5,2460,54885,2,2460,0,1980
8944600620,509000,2,1.5,1930,3521,2,1930,0,1989
2997800090,575000,3,1,1220,5652,1,1220,0,1905
2787700150,365000,4,2.5,2030,7210,1,1330,700,1969
4055701110,795000,3,2,2420,17859,1,1500,920,1979
2517000790,285000,3,2.5,1870,4060,2,1870,0,2005
2125059124,955000,3,2.25,3020,43560,2,2720,300,1969
7284900405,775000,4,2.5,2880,8400,2,2050,830,1955
3937900120,400000,4,3,1810,5012,2,1810,0,1997
0200520120,570000,4,2.5,2590,8483,2,2590,0,1991
7203220360,955990,5,3.25,3830,6507,2,3830,0,2014
3425059219,1.15e+006,3,2.25,3250,34848,1,2260,990,2006
5469502170,459950,4,2,2760,21465,1,2120,640,1979
6303401395,245000,2,1.75,1220,8382,1,1220,0,1942
8822901301,281000,3,1.5,1280,974,3,1280,0,2003
6730700385,205000,3,0.75,770,7000,1,770,0,1942
4396000530,290000,3,1.75,1520,15090,1,1520,0,1968
4077800590,635000,4,2.5,2080,11176,1,2080,0,1954
2461900845,310000,1,1,570,6000,1,570,0,1918
5366200330,470000,4,2,1500,3659,1,830,670,1906
6899990230,600000,2,2.5,2510,14878,2,2510,0,1990
7950700120,279000,4,2,1980,10051,1,1980,0,1969
7852090180,538500,3,3.5,2500,4270,2,2500,0,2000
3066410850,594950,4,2.5,2720,10006,2,2720,0,1989
2422059015,533050,2,1,910,295772,1,910,0,1953
7436500360,510000,3,1.75,1480,7040,1,1480,0,1974
0984210590,360000,4,2.25,2470,8686,1,1270,1200,1974
8024202350,435000,2,1,1650,5106,1,1090,560,1960
6392002020,559000,3,1.75,1700,6500,1,1700,0,1967
6398000191,645000,2,1.5,1995,115670,1.5,1995,0,1991
3904100065,340000,2,1,1280,9690,1,640,640,1919
5535600150,565000,4,2.5,2980,10459,2,2980,0,2001
8024200820,575700,3,1.75,1730,6130,1,1480,250,1941
9301300215,1.01e+006,3,3.25,2420,1923,2,1840,580,2006
1122069006,540500,3,2,2800,185130,1,2320,480,1996
5379801972,265000,5,4,1400,8580,1,900,500,1954
4077800088,699950,4,2,2070,7830,1,1180,890,1941
1823069059,355000,1,1.75,750,20339,1,550,200,1946
7979900215,381000,3,1.5,1460,11407,1,1460,0,1954
5101404444,564000,5,2.25,2140,8700,1,1220,920,1962
0892000025,114975,2,1,740,6250,1,740,0,1942
6303400395,325000,1,0.75,410,8636,1,410,0,1953
2320069189,299990,2,1,1570,125452,1,1570,0,1953
2568200610,751000,5,2.75,2860,5280,2,2860,0,2006
6073230230,425000,3,2.25,1400,6970,2,1400,0,1984
1024049006,665000,3,1.75,2700,5040,1,1560,1140,1947
0823069044,833450,5,4,4460,269345,2,3330,1130,1996
2926049086,575000,7,1.5,2670,11250,1.5,2320,350,1948
5127001320,190000,3,1.75,1520,9600,1,1520,0,1967
5127001320,314950,3,1.75,1520,9600,1,1520,0,1967
1994200375,601150,2,2,1660,5200,1,1120,540,1906
7100000035,315000,2,1,860,8308,1,860,0,1948
6329000705,545000,2,1.5,2340,13380,1,1280,1060,1954
7524950870,565000,4,2.25,2110,10698,2,2110,0,1979
9564800145,175000,3,1,1010,7034,1,1010,0,1954
2077700042,530000,3,2,2330,26571,2.5,2330,0,1987
3835500195,4.489e+006,4,3,6430,27517,2,6430,0,2001
0259000100,430000,3,1.75,1610,7900,1,1310,300,1960
1796360870,225000,3,1.75,1460,8372,1,1460,0,1981
0923049440,312000,5,4,2900,9779,2,1950,950,1937
9144100298,380000,3,1,1260,7980,1,1260,0,1951
3223049158,222200,2,1,1210,10000,1,1210,0,1953
5456000025,1.43889e+006,5,3.5,3420,8000,2,3420,0,2006
3558000120,329950,4,2.5,2120,4558,2,2120,0,2002
6133100120,995000,3,2.5,2460,10300,1,2460,0,1992
5608000590,929950,3,3.5,3790,10829,2,3790,0,1993
8651480090,692000,4,2.5,2350,9779,1,2350,0,1987
2768301490,402000,2,1,620,2475,1,620,0,1911
3325069060,510000,3,1.75,1920,43560,1,1340,580,1962
8802400411,249000,3,1,1050,8498,1,1050,0,1959
2953000090,244900,3,1.5,1360,9980,1,1360,0,1966
7657600025,289900,3,1,1180,7068,1,1180,0,1944
8118600025,552500,4,1,1560,7980,1,1170,390,1939
0326069118,760000,4,2.5,3300,165528,2,3300,0,1984
2902200838,440000,2,2.75,1100,1088,2,750,350,2006
0798000062,286000,3,1.75,1770,9000,1,1090,680,1954
3298700941,260000,3,1,1200,4592,1,800,400,1950
0114100155,355000,2,2.25,1330,10838,2,1330,0,1985
5151600360,318000,3,1.75,1570,12506,1,1570,0,1959
0523049106,255000,2,1,1610,19965,1,1610,0,1952
3751600025,139000,3,1,1100,17334,1,1100,0,1978
6918730230,485000,4,2.25,1810,7068,2,1810,0,1976
3226079059,549950,3,1.75,2930,266587,2,2440,490,1995
9521100880,588000,3,1.5,1780,4200,1.5,1780,0,1916
0425049146,975000,3,2.5,3050,7410,1.5,1950,1100,1950
3630010040,402000,3,2,1540,1827,2,1540,0,2005
6620400025,245000,3,1,1380,9875,1,1380,0,1959
8886000021,445000,3,1.75,1890,32340,1.5,1890,0,1976
0766800090,195000,3,1.75,1570,8459,1,1570,0,1991
4022900571,385000,5,2,2540,11750,1,1480,1060,1962
2206700165,450000,3,1.5,1520,7903,1,1000,520,1955
4151800530,1.09e+006,4,2.5,2780,6837,2,2780,0,2004
8122600195,396675,2,1,1730,6375,2,1730,0,1945
5379805160,242000,5,2.25,2340,7494,1,1170,1170,1951
0323089095,380000,3,1.75,1300,12378,1,1300,0,1943
0009000025,496000,2,1,1420,4635,2,1420,0,1941
8835200330,399950,3,2.5,1470,4488,2,1470,0,1980
1239400064,895000,4,2.5,2850,8526,2,2850,0,1998
2719100115,690000,3,2,2360,6149,2,1560,800,1926
5589300361,270000,3,1.5,1610,8375,2,1610,0,1927
2523069146,349900,3,2,2420,38781,1,1210,1210,1949
3630020090,454280,3,2.5,1470,1741,2,1170,300,2004
1775700011,390000,3,2.5,1410,26375,1,1410,0,1992
9264921110,275000,3,1.75,1840,14005,1,1840,0,1983
6837820330,300000,4,2.5,2450,8932,2,2450,0,1990
6822100750,700000,3,1.75,1500,6000,1,850,650,1940
6769200040,520000,3,1.75,2080,6609,1,1280,800,1950
1668500090,715000,3,2.5,2770,39529,2,2770,0,1987
5104530220,404000,3,2.5,2370,4324,2,2370,0,2006
0726059048,490500,3,2,3000,21883,2,1970,1030,1998
8835401250,1.485e+006,6,2.75,4430,6440,2,2680,1750,1964
6821100090,557800,4,1.75,1550,6000,1,1550,0,1944
5072400100,571000,4,2.25,2290,9900,1,1550,740,1959
2781200090,410000,4,2.5,2560,4020,2,2560,0,2006
4006000580,225000,3,1.5,1240,5506,1,1240,0,1971
3825310530,700000,4,2.5,2590,4498,2,2590,0,2004
3797000745,500000,3,1,1370,3500,1.5,1370,0,1905
7550801207,536500,2,2,1360,1860,1,680,680,1925
2468800040,330000,3,2.5,2060,25046,1,1600,460,1980
8092700230,249950,3,1.75,1120,15210,1,1120,0,1976
4435000490,249000,4,1.75,1630,8410,1.5,1630,0,1943
3686900025,249000,3,1.75,1590,7535,1.5,1590,0,1909
2450500110,780000,4,1.75,2480,9195,1,1390,1090,1950
1257200315,1.2e+006,4,2.5,2700,4275,2,2700,0,2004
3876312370,434500,3,1.75,1930,7210,1,1110,820,1975
2821079081,590000,4,2,2490,339332,1,2490,0,2002
7550800915,417200,2,1,1000,4000,1,1000,0,1910
7504010750,649990,4,2.25,2130,11900,2,2130,0,1976
1175000110,506000,2,1,1060,3588,1,960,100,1926
9320990090,348000,3,2.5,1730,4004,2,1730,0,1999
3791400100,301000,4,2.5,2810,6146,2,2810,0,1998
6021503885,427550,2,1,880,4000,1,880,0,1940
7979900552,361000,3,1,1040,6720,1.5,1040,0,1951
5101405340,460000,2,2.5,1830,8107,1,930,900,1946
5016003146,958000,4,3.5,1800,6400,2,1800,0,1984
2734100065,445000,5,1.75,2460,6846,1.5,1340,1120,1911
8029650040,373000,3,2.5,1670,3565,2,1670,0,1999
6204410150,525000,4,2.25,2660,7957,1,1750,910,1977
0662310620,364988,3,2.5,2850,12593,2,2850,0,1997
0924000040,324000,2,1,820,8370,1,820,0,1941
3333500096,625000,4,3,2350,5627,1,1490,860,1960
0349400100,237500,3,1.75,1480,7830,1,1480,0,1980
3876000970,429300,6,2.25,2930,15949,1,1730,1200,1965
7883603425,155000,3,1,1250,6250,1,1030,220,1949
0923000580,614000,4,2.75,2760,8160,1.5,1780,980,1940
6635000110,650000,3,2.5,2380,3332,2,2380,0,2014
7000100775,625000,3,2,1730,12219,1,1730,0,1986
6383000690,587100,3,2.25,1670,6414,1,1670,0,1961
9113600210,380000,4,2.5,2150,37647,2,2150,0,1991
5249804760,479500,2,1,930,5760,1,730,200,1917
3364900156,382888,1,1,620,2380,1,620,0,1900
0117000001,540000,4,4.25,1960,3565,2,1960,0,1940
7555200230,691000,4,2.75,2550,8632,1,1700,850,1972
9178600360,760500,3,2,1990,3990,1,1130,860,1912
7853301570,685000,4,2.5,3550,10968,2,3550,0,2006
5066400564,199129,3,1,860,33664,1,860,0,1955
9264950600,335000,3,3,2031,7702,2,2031,0,1988
4010800110,305100,3,2,1590,35988,1,1590,0,1974
1546600120,830000,4,2.25,3010,12202,1,3010,0,1959
4139440100,810000,3,2.5,2610,8481,2,2610,0,1993
1939050110,500000,3,2.25,1440,15661,1,1180,260,1988
6126601445,490000,3,1.75,1920,5405,1,960,960,1947
9274200620,490000,2,1.75,1670,4200,2,1670,0,1912
2868300061,272000,4,1.75,1390,10660,1,1030,360,1960
3831200210,280000,3,2.25,2140,7200,2,2140,0,1979
7301300150,233000,3,1,1250,6180,1.5,1250,0,1955
3368900084,275000,3,1,1080,6000,1,1080,0,1952
8856500220,375000,3,3.25,2760,6420,2,2110,650,1991
9527310110,445000,3,2.75,2180,3703,2,2180,0,2004
2767604712,437500,3,2.5,1260,1125,3,1260,0,2002
3336001515,426250,4,1,1610,6000,1.5,1510,100,1905
5103900015,358000,3,1.5,2450,12497,1,2450,0,1967
1025069255,1.175e+006,4,3.5,4150,49503,2,4150,0,2003
2724069010,305000,2,1,960,8276,1,960,0,1939
8682262170,415000,2,1.75,1340,4664,1,1340,0,2004
1773100755,520000,11,3,3000,4960,2,2400,600,1918
8691390770,733000,4,3.5,3080,5974,2,3080,0,2003
7771300085,411500,3,1,1130,8159,1,1130,0,1954
9194101388,540000,3,1.75,2280,16671,1.5,1760,520,1909
7633400110,270500,3,1.5,1952,8613,1,1652,300,1960
2767704302,422250,2,1.5,1280,1256,2,1200,80,1998
8562970040,655000,5,3.25,3690,12353,2,3690,0,1977
8562720410,1.2e+006,5,3.25,4610,10576,2,3310,1300,2006
0120069059,550000,3,2.5,2920,169448,2.5,2920,0,1990
9828702513,460000,2,2.25,1230,929,2,1020,210,2004
7812800515,159075,4,1.5,1580,6200,1,790,790,1944
3363900155,470000,2,1,1220,4000,1.5,1220,0,1908
9448300061,235000,2,1,1020,7920,1,1020,0,1939
1840300100,309950,2,1.5,1510,9843,1,1510,0,1961
4246000180,433000,4,1.75,1830,9600,1,1010,820,1966
7856000110,895000,3,2.5,2750,10000,1,1650,1100,1967
2422059111,291000,3,1.5,1860,60960,1,1140,720,1967
1925069199,835000,3,2.5,2720,13124,2,2720,0,1988
2771603940,640000,2,1,1360,5000,1,1200,160,1936
6028000090,438000,3,2.25,2340,14279,1,1340,1000,1965
5126310110,540000,4,2.5,2600,9935,2,2600,0,2005
7520000616,325000,4,2.5,2090,7434,1,1090,1000,1993
3343900120,380000,4,1.75,2260,7200,1.5,1360,900,1924
0714000195,510000,2,1,1390,5544,1,930,460,1947
2310100230,380000,4,2.5,2300,7707,2,2300,0,2004
7856600900,825000,4,2.5,2810,9800,1,1710,1100,1973
0926069192,880000,4,3.25,4060,52707,2,4060,0,1996
3343302110,1.8e+006,3,3,2790,13295,2,2370,420,1933
5100403405,790000,3,1,1290,6380,1.5,1290,0,1930
3298700302,287000,2,1.5,720,4346,1,720,0,1942
3333001430,509000,3,3,2130,5000,1.5,1570,560,1913
8849700040,270000,3,2.25,1750,8400,1,1350,400,1965
3256400051,210000,3,2,960,9380,1,960,0,1949
7283900551,415000,3,1,1570,11752,1.5,1570,0,1930
5067400032,550000,3,2.5,3070,14400,1,1720,1350,1985
1370801020,1.25e+006,4,2.5,2920,5500,1,2030,890,1957
3852900026,499950,3,1,1870,4984,1,1120,750,1955
1189000025,659000,3,1.5,1540,5040,2,1540,0,1907
4047200580,265000,2,1.5,1440,22081,2,1440,0,1990
2607720150,492000,4,3.75,2810,10840,2,2070,740,1994
5459300040,715000,4,2.5,2450,7700,1,1250,1200,1958
2613200025,175000,2,1,1330,28270,1.5,1330,0,1925
0686050100,975000,4,3.5,3130,52322,2,2430,700,2011
2117700065,306950,1,1,730,5005,1,730,0,1945
5742600115,630000,4,2,2480,3680,1.5,1470,1010,1916
2064800600,367500,3,1,1270,8792,1,1270,0,1969
0034001765,699950,3,3.25,2230,5460,1,1430,800,1977
1186000065,1e+006,3,3,2880,3750,2,2220,660,1909
1687000220,285000,4,2.5,2434,4400,2,2434,0,2007
7985400133,215000,2,1.5,1120,1312,2,1000,120,2004
3303980090,1.05e+006,4,2.5,4080,11054,2,4080,0,2001
7855200120,1.37e+006,4,2.75,3720,9450,1,1960,1760,1962
0002800031,235000,3,1,1430,7599,1.5,1010,420,1930
2306400040,604000,3,2,1560,2589,1,790,770,1923
5035300834,750000,3,1.75,1700,8400,1,1460,240,1947
9542300530,800000,4,2.25,2510,9963,1,2200,310,1967
9191201250,580000,5,2,2600,3750,1.5,1400,1200,1914
7950300775,350000,1,1,790,4590,1,790,0,1911
2934800025,353750,4,2,1710,7490,2,1320,390,1956
7855400330,1.1e+006,5,2.75,2660,8737,1,1470,1190,1969
0259600330,465000,4,2,1470,10291,1,1470,0,1963
3723800409,568000,3,2,2350,5080,1.5,1780,570,1929
5191100180,1.005e+006,5,2,2440,3080,2,2440,0,1910
0257000057,213500,3,1.5,1150,11571,1,1150,0,1961
1771100330,250000,3,2.5,1510,10384,1,1030,480,1976
1782500035,357000,2,1,870,4600,1,870,0,1942
7104100065,425000,2,2,1280,4095,2,1280,0,1918
0200500610,571000,3,2.5,2600,7465,2,2600,0,1988
7199320600,588000,3,2.25,2030,7350,1,1190,840,1977
3322049201,275000,4,1.5,1930,15531,2,1930,0,1979
5153200100,565000,3,2.75,3210,15939,2,3210,0,1998
0726059349,460000,3,1.75,1970,9135,1,1370,600,1961
8833510230,603500,4,2.5,4060,9734,1,2150,1910,1977
7298000090,490600,3,2.5,3316,11447,2,3316,0,1986
3885804225,1.01e+006,2,2,1460,9052,1,1460,0,1900
2558600100,500000,4,2,2100,12620,1,2100,0,1972
7697920450,249000,4,2.25,1830,6136,2,1830,0,1990
8899200110,235000,3,2,1530,8700,1,1530,0,1970
3992700775,410000,4,2,1490,13736,1,1490,0,1942
6384500035,370000,2,1,860,6050,1,860,0,1952
2787700210,360000,5,2.5,2130,7111,1,1330,800,1968
2524049018,1.40689e+006,5,2.25,3580,16789,2,3580,0,1966
7569450090,298000,4,2.5,2420,3825,2,2420,0,2003
0123039570,485000,4,2.25,1900,7200,1,1370,530,1977
6071300090,400000,3,1.75,1330,9143,1,1330,0,1960
4221250100,580000,3,2.5,2150,4604,2,2150,0,2003
8730000210,355000,2,2.5,1370,1140,2,1080,290,2009
4178600100,650000,3,2.5,2430,12997,2,2430,0,1992
9476200485,261490,4,1,1640,8467,1,1220,420,1943
3205400230,347000,3,1,1010,7200,1,1010,0,1968
9307300100,485000,3,1,1500,4100,1.5,1370,130,1926
2770600930,601000,3,2.5,1740,1251,2,1180,560,2012
2817900180,380000,3,3.25,2090,51212,1,1510,580,1989
7504001340,565000,3,3,1850,12556,2,1850,0,1976
3121500330,750000,3,2.5,2790,21043,2,2790,0,1993
1099760230,291000,3,2.25,1480,7200,1,1190,290,1975
3904920600,560000,3,2.5,2280,12498,2,2280,0,1987
7504100590,725000,4,2.25,3180,9600,2,3180,0,1984
1725079025,539000,3,2,2350,209088,1,2350,0,1993
9406540150,470000,5,3.25,3910,7077,2,2710,1200,2000
6163900032,264950,2,1,770,7434,1,770,0,1947
0844000180,200000,4,1.5,1780,8000,2,1080,700,1900
7229800175,453500,5,2.5,2300,23345,1,1170,1130,1967
0325059086,811000,2,2.5,2510,17986,2,2510,0,1943
4310701565,425000,3,3.25,1410,1350,3,1410,0,2005
2524049257,1.53e+006,4,2.25,4250,16940,1,2380,1870,1974
1226059161,562000,4,2.75,2560,83200,1,1860,700,1980
7212660900,281000,3,2.5,1760,7601,2,1760,0,1992
6147650300,270000,3,2.25,2100,14027,2,2100,0,1979
8945300090,205950,3,1,1490,8239,1,1490,0,1963
7452500365,310000,2,1,870,5400,1,870,0,1950
3629960600,350000,3,1.75,1260,1111,2,1260,0,2003
0540100056,843500,4,2,2630,16475,2,2630,0,1953
1109000175,370000,4,2,1950,3757,1,1160,790,1908
8645500900,279000,4,2,2200,7700,1,1100,1100,1979
0722069057,408000,3,1.75,1600,313672,1,1600,0,1960
2660500365,392000,3,1,1230,9600,1,1230,0,1952
2516000475,455000,2,1,1030,5000,1,1030,0,1917
0522039103,310000,2,1.5,1040,83199,1,870,170,1965
7689600650,323500,3,3,2240,11536,2,2240,0,1943
9285800801,364500,3,1,1600,4489,1,800,800,1944
3750607974,280000,4,2,2190,14439,1,1180,1010,1977
1622049154,289900,3,1.75,1899,11325,2,1899,0,1943
9530100555,585000,3,1,1870,2807,1.5,1580,290,1927
4178500300,269000,3,2.5,1730,6653,1,1360,370,1990
8856960720,280000,3,2.25,1860,9210,2,1860,0,1994
9117000230,287000,3,1.75,1940,9000,1,1290,650,1965
8122100835,183000,2,1,670,5140,1,670,0,1926
2788500090,309000,3,1,1820,8142,1,1040,780,1961
0324059161,920000,4,2.5,3810,13579,2,3810,0,2003
4217400540,815241,5,2.25,2060,4800,2.5,2060,0,1907
3876312290,405000,3,1.75,1520,7252,1,1140,380,1975
8556800090,525000,5,3.5,3450,19080,2,3450,0,2001
2113701095,150000,2,1,830,4045,1,830,0,1943
3750603940,240000,4,1.75,1880,9600,1,1020,860,1946
1245003160,698000,4,2.25,2200,11250,1.5,1300,900,1920
2600010360,440000,3,2,1800,10950,1,1800,0,1982
7893200900,204000,3,1,1200,12500,1.5,1200,0,1936
0269000615,875000,3,2,2220,6641,1,1220,1000,1947
2174503441,650000,3,1.5,1380,4500,1,1380,0,1960
4025300371,392500,3,1,1660,8839,1,1660,0,1947
3101500090,400000,4,1,2320,4000,1.5,1310,1010,1921
3447000090,653000,3,2.25,2800,17300,1,1420,1380,1971
0917000300,452000,4,1,1210,3760,1.5,1210,0,1900
9510400100,345000,4,2.5,2331,3826,2,2331,0,2007
4058801225,350000,4,1.75,1820,6930,1,1320,500,1952
3578600201,650000,4,2.5,2860,5576,2,2860,0,2004
5282200015,525000,5,3,2750,3800,1.5,1750,1000,1926
5282200015,840000,5,3,2750,3800,1.5,1750,1000,1926
4219400555,1.325e+006,3,2.5,2280,5000,2,2280,0,1926
0104550540,259950,4,2,1610,6650,1,1610,0,1989
3317500100,998000,5,3.5,3760,10207,2,3150,610,1969
2436200395,1.07e+006,3,3,2940,4622,2,2230,710,1988
1118001560,1.91e+006,4,3,4460,6833,2,3140,1320,1955
8728100775,190500,3,1.5,1110,1150,2,940,170,2007
2223069112,465000,3,2.25,2560,117176,1,1280,1280,1977
7278100665,370000,3,1,1060,7419,1,1060,0,1906
0822059038,290000,6,4.5,2810,11214,1,2010,800,1958
7977201065,350000,3,1.75,1380,4590,1,930,450,1950
7977201065,740000,3,1.75,1380,4590,1,930,450,1950
5255000110,460000,3,1.75,2560,8400,1,1970,590,1959
9407001790,290000,3,1,1010,10800,1,1010,0,1972
1120069059,475000,3,1.5,1790,229125,2,1790,0,1987
2048000330,214000,3,2.5,1600,2231,2,1600,0,2003
8820903080,455000,2,1,910,5759,1,910,0,1951
1687000210,275000,3,2.5,2497,4400,2,2497,0,2007
0621049103,305000,3,1.5,1800,12196,1,1800,0,1966
1321059052,449000,5,2.5,2570,61855,1,1470,1100,1981
2114700540,366000,3,2.5,1320,4320,1,660,660,1918
4307330180,348000,3,2.5,1670,5090,2,1670,0,2003
0114100304,515000,4,2.5,2800,21370,2,2800,0,2003
7501000220,950000,4,2.5,3360,11548,2,3360,0,1988
8562901910,815000,3,2.5,2590,21494,2,2590,0,1991
1442800150,199950,3,3,1530,2132,2,1530,0,1993
3715500220,386000,3,2,1330,8100,1,1330,0,1969
8647800150,273000,3,2.25,2160,7964,2,2160,0,1991
2508800220,284000,4,2.5,1830,6360,2,1830,0,1994
0106000044,399950,3,1,1470,7930,1,1070,400,1950
5652601035,285000,3,1.75,1150,6423,1,590,560,1927
4142450490,315000,3,2.5,1790,6452,2,1790,0,2004
2788400090,250000,3,1,1700,7700,1,1120,580,1960
7524200330,290000,4,2,1630,7618,1.5,1630,0,1967
9359300220,725000,4,2.5,3420,30410,2,3420,0,1988
3840700455,410000,3,2,1650,9641,1.5,1650,0,1983
6790950150,855000,4,2.5,2810,52062,1.5,2810,0,1988
3303950760,399900,4,2.5,2710,8127,2,2710,0,1994
2600000210,852600,4,2.5,3320,11901,2,2650,670,1977
2341300115,235000,2,1,720,6321,1,720,0,1940
8655900100,230950,2,1,930,12724,1,930,0,1912
4345000210,230000,3,2.25,1490,8722,2,1490,0,1997
8929000330,404763,3,2.5,1690,1609,2,1150,540,2014
6700390150,245000,3,2.5,1720,3407,2,1720,0,1992
1645000100,188000,3,1.5,1140,8500,1,1140,0,1964
8078350100,626100,4,2.5,2280,7219,2,2280,0,1987
6430500008,428750,3,1,1100,4080,1,900,200,1929
3902300100,522000,4,2.25,1800,8623,1,1360,440,1980
2193330090,684000,4,2.5,2500,8434,2,2500,0,1988
3524039202,1.0655e+006,3,2.25,2950,7232,1,1520,1430,1983
0059000201,611206,1,1,1940,6300,1,1940,0,1963
1782000085,350000,2,1,1280,5250,1,1140,140,1942
3121500150,894000,4,2.5,3800,22029,2,3800,0,1993
5207200360,420000,2,1,930,5368,1,930,0,1953
2570500230,400000,5,2,1930,9747,1,1020,910,1962
2481600110,675000,3,3,2980,28000,1,1820,1160,1981
5104520150,426000,4,2.5,2800,8494,2,2800,0,2004
7504110760,750000,4,2.25,3190,11597,2,2300,890,1984
3649100276,368000,3,1.75,1710,10800,1,1710,0,1958
4302700559,342000,3,1,1980,6450,1,1120,860,1950
2883200961,700000,3,1.75,1910,4800,1,1080,830,1959
2767601280,848750,6,3.75,3160,5000,2,3160,0,1989
0625049274,720000,3,2,1590,5200,1,1320,270,1939
0686400210,525000,4,2.25,1890,8549,1,1890,0,1967
0121059038,397900,3,2.75,2500,35245,1,1580,920,2000
3649100264,405000,3,2,1740,18000,1,1230,510,1989
6743700015,392800,3,2,1080,11856,1,1080,0,1986
0217500015,394999,3,1.5,1730,7800,1,1330,400,1958
8691500410,340000,3,2.5,2480,6112,2,2480,0,2004
9828702667,482500,3,2.25,1450,1445,2,980,470,2005
2597531110,812500,4,2.5,2750,10159,2,2750,0,1991
1126049095,450000,3,2.5,2820,10208,1,1410,1410,1954
0126049100,398000,3,1.75,1830,27468,1,1830,0,1954
1724069060,1.075e+006,2,3.25,1550,1767,3,1550,0,2006
9530101385,540000,2,2,1640,3021,1,840,800,1959
7243500015,275000,4,2,1720,5472,1,860,860,1923
1498303700,780000,5,2,2880,12000,2,2880,0,1921
3352400325,225000,3,1.5,1220,8345,1.5,1220,0,1931
8021700495,503045,3,3,1560,2250,2,1560,0,2009
9406500530,249000,2,2,1090,1357,2,1090,0,1990
9468200100,569950,4,1,1140,5940,1,1140,0,1916
3179100482,450000,2,2.25,1040,1377,2,1040,0,2003
5035300650,1.0995e+006,4,2,2580,6000,1,1300,1280,1950
6431000015,700000,4,2.5,2310,3570,1.5,1490,820,1927
5366200210,454000,3,2.5,1590,4094,2,1590,0,1991
9512501450,555000,3,1.75,1270,9170,1,1270,0,1969
8651411460,214000,3,1.5,1240,5200,1,1240,0,1970
8078380230,590000,3,2.5,2210,8622,2,2210,0,1988
1523069096,459900,3,1.75,2340,51836,1.5,1510,830,1978
7893203480,205000,3,1.5,1420,5000,1,920,500,1987
7795810110,390000,3,1.75,1430,9857,1,1140,290,1980
0191100410,970500,3,2.75,2470,10125,2,2470,0,1960
6151800330,790000,3,2.5,2390,15084,2,2390,0,2000
1771100360,320000,3,1,1120,10576,1,1120,0,1969
1556200265,552500,3,2.25,2700,4025,2,1760,940,1907
6742700210,1.05e+006,3,3,3490,4500,2.5,3170,320,1924
1423800210,230000,3,1,1640,7187,1,1640,0,1966
2125049131,680000,3,1.75,1620,5500,1,1110,510,1950
5318101765,985000,3,1.75,1670,5400,2,1670,0,1912
6624300110,375000,4,2.5,1870,7471,2,1870,0,1990
5160700035,431000,2,1.5,1300,4000,1.5,1300,0,1900
1472800220,463000,3,2.5,2190,17108,2,2190,0,1991
3755000090,350000,3,1.75,1320,10500,1,1320,0,1966
0259601010,485000,3,1,1250,7200,1,1250,0,1964
7939000090,355000,4,1.75,2040,15000,1,1360,680,1967
2675600025,603500,3,1.75,2140,7280,1,1070,1070,1910
5700000975,860000,5,1.75,2510,6000,1.5,2010,500,1920
9407150360,259875,5,2.5,2200,6250,2,2200,0,1996
8146300015,685000,4,2.5,2170,8680,1,1220,950,1959
9406570300,382500,4,2.5,2980,8786,2,2980,0,2003
7518500301,490000,3,1,1180,2250,1.5,1180,0,1902
3739500096,229000,3,2,1540,6000,1,1540,0,1953
3739500096,430000,3,2,1540,6000,1,1540,0,1953
0267020090,580000,5,2.5,3110,15783,1,1720,1390,1974
0534000195,510000,3,1.75,1370,6700,1,1370,0,1940
5469502700,489990,5,2.25,2440,20828,1.5,2440,0,1975
7010700110,440000,3,2.25,1760,1800,2,1330,430,1983
8106300090,479950,3,2.5,2810,4984,1,1750,1060,2006
0225069013,806000,4,2.5,2500,206474,1,2500,0,1997
1685800100,875000,4,2.5,3220,22588,2,3220,0,1996
0293800870,710800,3,2.5,2880,36820,2,2880,0,1992
7852190580,565000,3,2.5,2700,6037,2,2700,0,2004
5636000210,359999,5,3,2680,9624,2,1870,810,1995
1623301185,625000,3,1.75,1780,4500,1,920,860,1922
3260810590,349950,3,2.5,2240,7565,2,2240,0,1999
8589100090,415000,4,2,1610,9600,1,1610,0,1967
7579200767,435000,2,2,1440,1170,2,960,480,2004
0623049273,225000,3,1.75,1550,9060,2,1550,0,1948
1186000035,770000,3,1.75,1720,5000,1,1720,0,1954
2228900191,340000,3,1.75,1740,10800,1,1740,0,1959
2597450120,965000,5,2.75,3280,12673,1,2050,1230,1981
3339400515,667000,3,2.75,2216,31215,1,2216,0,1968
1221000395,250000,1,1,1100,4373,1,820,280,1947
1526300015,397990,3,1,1180,11862,1,1180,0,1948
6163901772,535000,3,1.75,2020,10031,1,1370,650,1952
1180007005,265950,3,1.5,1150,8450,1,1150,0,1951
5420300210,258000,3,1.75,2090,7461,1,1200,890,1986
0476000331,505500,3,2.5,1300,1187,3,1300,0,2005
2558700090,455000,5,2.5,2240,7770,1,1340,900,1978
4151800410,1.348e+006,5,3.25,3540,5971,1,2000,1540,2005
3586501075,600000,4,2.25,2840,31720,1,1780,1060,1958
4136870110,329800,4,2.5,2080,7047,2,2080,0,1996
6623400090,222000,2,1,1550,38449,1,1550,0,1947
1560800150,450000,4,2.5,1900,9240,1,1900,0,1962
2770605548,952000,3,3.5,2760,4500,2,2120,640,2004
2023700040,625000,4,2,1410,4480,1.5,1410,0,1927
1164000040,226800,2,1,1240,11393,1,1240,0,1960
7135520650,1.205e+006,5,4.25,4420,13497,2,3510,910,2000
3528400180,350000,4,2.75,3390,16153,1,1970,1420,1961
7820000015,395000,3,1.75,1400,8640,1,1400,0,1962
1105000229,285000,5,3,2110,5260,2,1670,440,2002
3625059166,553000,3,1,1310,18135,1,1310,0,1948
8108600442,254000,3,1,1270,16800,1,1270,0,1957
8143600015,348140,2,1.5,2060,10880,1,1190,870,1924
8731900790,354950,4,2.75,2530,7350,1,1280,1250,1977
6079500230,706000,3,2.75,1900,6400,1,1410,490,1942
7853302370,499000,4,2.5,2910,6479,2,2910,0,2006
0122069107,427500,3,1.5,1900,43186,1.5,1300,600,1971
4204400175,439000,5,3.5,2880,10000,2,1980,900,1991
2896310120,545000,4,2.5,2820,25995,2,2820,0,1998
4083301380,842000,3,1,1620,4774,1.5,1620,0,1920
1332000100,685000,4,2.5,3320,38043,2,3320,0,1997
3622069122,665000,4,3.5,3770,47480,2,3770,0,2003
6052401215,255000,2,1,1200,9000,1,1200,0,1917
7010700245,565000,5,2.25,2130,4360,1,1240,890,1959
1311100490,274000,5,1.75,1950,8720,1,1050,900,1962
9510900360,260000,3,2,1920,8075,1,1510,410,1969
8679600150,581000,4,2,2510,13695,1,1280,1230,1961
7203600040,625000,3,1.5,1990,5978,1.5,1990,0,1926
2212900180,220000,3,1,1230,9720,1,1230,0,1969
2124079010,765000,3,2.25,3190,324086,2,3190,0,1982
2424059052,1.325e+006,6,4.25,5720,10213,2,4170,1550,2004
6746700615,700000,8,2.5,2280,3000,1.5,1210,1070,1911
3298300530,351000,4,1,1550,7260,1,1550,0,1959
8929000360,413565,3,2.5,1690,1613,2,1150,540,2014
2291400236,363000,3,3.25,1651,1779,2,1341,310,2008
6445800120,679000,4,1.75,2260,41236,1,1690,570,1962
8682261010,473000,2,1.75,1510,4555,1,1510,0,2005
8045000180,585888,3,2,1490,7431,1,1490,0,1966
9475700220,405000,4,2.5,2220,4652,2,2220,0,2001
3222049055,650000,3,1.75,2800,19386,1,1400,1400,1965
1222069133,415000,4,2.5,2210,213008,1,1210,1000,1975
9165100230,575000,3,2,2150,3880,1,1080,1070,1951
8091411120,220000,3,2.25,1400,7205,1,1140,260,1985
1777600230,610000,4,3,2450,10117,1,1580,870,1967
5101400862,499950,3,1,980,6380,1,760,220,1941
5317100325,883000,4,2.5,2800,6874,2,2170,630,1990
9324800455,436000,2,1,1240,8100,1.5,1240,0,1925
0880000208,320000,3,2.5,1610,1356,2,1240,370,2007
1223089081,425000,3,1.75,1510,44000,1,1240,270,1989
5556800150,204700,4,2,1670,9987,1,1670,0,1967
4174600331,384000,6,3,2320,4502,1,1200,1120,1987
5419801120,314000,3,2.75,1900,8200,2,1900,0,1984
3649100674,535000,3,2.5,2390,6263,2,2390,0,2003
1525069058,568000,4,1.75,2110,265716,1,2110,0,1979
7202000220,426000,4,1.5,1470,5850,1,810,660,1973
7129301001,675000,4,2.75,2670,6780,2,1630,1040,1908
8860500150,380000,4,2.5,2540,6365,2,1870,670,2000
7384500110,685000,3,2.5,3450,8000,3,2970,480,1927
0622069123,429000,3,2,1700,52826,1,1700,0,1991
0164000361,799000,4,1.5,1810,6583,1,1500,310,1968
3438500790,318500,5,1.75,1550,6986,1,1030,520,1978
2024059110,925000,3,3.25,4110,20900,2,2630,1480,2002
7338400945,420000,3,1.5,2080,5000,1,1300,780,1963
0809003160,570000,2,1,1100,4000,1,1100,0,1906
8650700090,1.0525e+006,4,2.75,3950,12840,2,3950,0,1960
8151600663,333000,3,1,1250,8450,1,1250,0,1954
7352200100,1.36e+006,2,1.75,2620,14138,2,2120,500,1931
1952200220,660000,3,2.5,2290,2798,3,2290,0,1953
1568100300,350000,6,4.5,3500,8504,2,3500,0,1980
1568100300,682500,6,4.5,3500,8504,2,3500,0,1980
2113700485,399990,5,2.75,1690,4000,1,970,720,1943
1454600156,860000,5,3.25,4500,9648,2,3000,1500,1968
4204400201,216180,2,1,1120,7797,1,1120,0,1948
8856890330,300000,4,2.25,1740,9613,2,1740,0,1989
1922059278,145000,3,1,1010,11880,1,1010,0,1960
1922059278,255000,3,1,1010,11880,1,1010,0,1960
6623400356,250000,3,1.75,1200,24805,1,1200,0,1984
9407111250,245000,3,1,1020,8625,1,1020,0,1978
5422570760,445000,3,1.75,1850,7056,2.5,1850,0,1979
4036800910,562000,3,1.5,1830,8000,1,1830,0,1957
0259600530,501000,4,1,2070,7519,1,1160,910,1963
6303400981,190000,3,1.75,1160,5850,1,1160,0,1918
7701990300,862500,4,2.75,3280,24440,2,3280,0,1996
5700002510,1.085e+006,5,2.5,2340,6000,2,2340,0,1922
2011400230,575000,5,3,3690,49709,1,2690,1000,1960
1921069059,250000,1,1,720,123710,1,720,0,1935
1471700410,310000,7,1.5,2660,15111,1.5,2660,0,1962
2102700025,1.4e+006,5,3.25,4300,9270,2,2910,1390,1957
4222300040,284850,3,1.5,1590,8256,1,1090,500,1969
3649100676,570000,4,2.5,2590,7910,2,2590,0,2003
0372000040,304000,3,1.75,1720,6000,1,1000,720,1954
7312200040,560000,4,2.5,1790,9787,1,1240,550,1983
6052400975,325000,3,1,1590,8160,1,1090,500,1954
0826000495,557510,4,2,1580,4800,1.5,1580,0,1912
8731900880,305000,4,2.25,2580,8820,1,1620,960,1967
1523059100,320000,5,1,1740,27350,1,1740,0,1958
2597550090,455000,5,2.25,3470,28212,1.5,2790,680,1978
3581000210,383001,3,1,1180,7210,1,1180,0,1963
4048400191,545000,3,1.75,1700,51649,1.5,1700,0,1931
7578200025,487500,2,1,1190,5000,1,1190,0,1925
2379300330,345000,5,2.5,2450,6994,2,2450,0,2002
8917100180,583000,6,2.75,2630,16411,1,1650,980,1974
3395300180,534950,3,2.25,2130,12286,2,2130,0,1977
0369000690,403504,4,1,1060,5750,1,950,110,1904
7977200720,500000,3,1.75,1480,6120,1.5,1480,0,1946
2322069175,319502,3,1.75,1610,38707,1,1610,0,1990
2324039100,525000,4,2.75,2440,5080,2,1750,690,1960
5631500866,563000,4,3,3100,15480,2,2400,700,1996
2877101745,898500,4,2.75,2890,5000,1.5,1990,900,1911
0721069087,651000,3,2.5,3240,108366,2,3240,0,1991
7934000145,450000,4,2.75,2900,6400,2,2040,860,1911
6072760360,665000,4,2.25,2650,8149,1,1610,1040,1975
6021501635,825000,4,2.5,2560,4000,2,1610,950,1929
1821059067,200000,3,1,1150,4800,1.5,1150,0,1938
3295750610,295000,3,2,1760,6092,1,1760,0,1998
2926059146,748000,4,2.5,3220,8379,2,3220,0,2004
9429500146,580000,3,2.5,3200,18750,1,2660,540,1967
7893207490,275000,3,1,1250,10744,1,1250,0,1942
8945300110,196000,3,1,1000,8470,1,1000,0,1963
8151600610,235750,2,1,740,11250,1,740,0,1938
2923049399,315000,3,2.25,2170,8480,1,2170,0,1965
3260810110,338000,4,2.5,2370,10631,2,2370,0,1999
5104530770,353000,4,2.5,2300,4249,2,2300,0,2006
8661000033,235000,3,1.75,1400,6300,1,1400,0,1998
4017050820,569999,3,2.5,3080,13880,2,3080,0,1990
0226039279,505000,4,2.25,2350,12540,2,2350,0,1968
1338800785,1.234e+006,4,3,2660,4600,1.5,1820,840,1906
2921049079,299000,2,1.75,1250,34395,1,1250,0,1950
5113260040,240000,3,2,1100,6360,1,1100,0,1991
3124059023,1.955e+006,3,1.75,3330,12566,1,1940,1390,1960
5351200265,1.265e+006,4,3.25,3640,3604,2,1960,1680,1913
2591010150,405000,2,1.75,1350,2653,2,1350,0,1986
6163900821,304000,4,2,1310,8454,1,1310,0,1953
2310060230,272000,4,2.25,1800,5555,2,1800,0,2003
4449800315,412000,2,1,1260,3960,1,690,570,1925
3299600120,698000,4,2.5,2990,7231,2,2990,0,2001
2490200615,400000,2,1,1140,5100,1,1140,0,1942
1565950230,305000,3,2.5,2100,6825,2,2100,0,1994
6402700110,585000,4,2,2400,12753,1,2400,0,1962
5029450100,190000,2,1.5,1400,9031,1,960,440,1982
7525530590,760000,4,2.5,2990,12788,2,2990,0,1988
0226059103,570000,3,1.75,1930,36210,1,1930,0,1977
6197200021,144000,3,1,980,6800,1,980,0,1946
7227500910,139000,2,1,690,5280,1,690,0,1942
5100402644,525000,4,1.5,1430,6380,1.5,1130,300,1945
0748000205,293000,1,1,1110,5421,1,1110,0,1935
7899800476,267100,2,2.5,1250,1580,2,1030,220,2005
3885804390,1.5e+006,4,3.25,3470,5222,2,2830,640,2005
1796370150,240000,3,2.25,1500,15334,2,1500,0,1992
7935000625,975000,3,2.5,2530,7000,2.5,2530,0,1915
1761300100,279950,5,1.75,2150,7171,1,1460,690,1970
1112700150,405000,3,1.75,1260,7373,1,1260,0,1979
2622049052,400000,3,2.5,2740,83199,2,2740,0,1973
0423000035,225000,3,1,960,6500,1,960,0,1954
1555300490,250000,3,1,1520,7800,1,1120,400,1967
6802210450,272950,3,2.25,1570,9096,1,1180,390,1991
7853310150,625000,5,1,3240,5324,2,3240,0,2007
4086300065,670000,3,1.75,1280,2147,1.5,1280,0,1910
0809003085,1.065e+006,3,2.5,2130,3545,3,2130,0,1990
0259100110,540000,3,1.75,1970,8200,1,1420,550,1963
2316800100,525000,3,2.5,2990,6725,2,2990,0,2003
6414600051,425000,2,1,1160,17700,1,1160,0,1947
1704900206,465500,3,1.75,1890,7004,1,1290,600,1965
7853301240,443500,3,2.5,2170,5866,2,2170,0,2006
3420069055,350000,4,2.25,1570,499571,1,1570,0,1972
1726069198,850000,3,2.5,3260,91911,2,3260,0,1984
4468400211,205000,3,2.25,1250,952,3,1250,0,2008
1864900230,315000,4,2.5,1940,10200,1,1140,800,1977
8079040490,470000,3,2.5,2150,8221,2,2150,0,1992
7856400410,1.1e+006,4,2.25,3310,8540,1,1660,1650,1973
1825079018,340000,3,1.75,3400,46382,1,2050,1350,1979
5151600120,310000,4,2.5,2660,12672,1,1740,920,1960
4024101050,305000,3,1,950,13475,1,950,0,1950
2854800090,307150,3,1.5,1480,6752,1,1480,0,1959
1726600120,729032,4,2.5,2840,12866,1,1780,1060,1977
0627300195,750000,5,2.5,3240,9960,1,2020,1220,1958
2140900100,289000,4,2.5,1961,3207,2,1961,0,2006
0446000150,480000,3,1,1100,5700,1,1100,0,1950
7436500120,529000,3,1.75,1500,7367,1,1500,0,1974
6917700195,585000,3,1.75,1480,4800,2,1140,340,1944
4377000100,704000,4,2.75,2510,12500,1,2050,460,1976
0925049278,607000,4,2,1490,4054,1.5,1490,0,1926
7558750120,580000,3,2.25,2190,8188,2,1810,380,1978
7856610490,875000,5,2.5,2530,8564,2,2530,0,1976
9346930100,610000,4,2.5,2440,9350,1,1560,880,1976
0114100763,230000,3,0.75,1040,15000,1,1040,0,1941
7214700580,510000,4,2.25,2450,62290,2,2450,0,1976
4237901075,733000,4,2.5,2210,5002,1,1370,840,1977
0302000375,169100,3,2,1050,18304,1,1050,0,1953
0302000375,250000,3,2,1050,18304,1,1050,0,1953
6843300090,500000,4,2.25,2730,35100,2,2730,0,1977
3524039144,700000,2,1,1620,9855,1,1320,300,1948
1787250210,379000,4,2.75,2410,5225,2,2410,0,2001
3022079080,650000,4,2.5,3420,222156,2,3420,0,2002
2402100205,412133,2,1,920,4400,1,920,0,1948
1973800150,480000,4,2.25,2330,14190,1,1740,590,1962
5315100805,650000,3,1.75,1940,10245,1,1940,0,1957
8682262240,505000,2,2.5,1900,5065,2,1900,0,2005
9541600490,931088,4,2.5,3510,17400,1,1930,1580,1957
0686200490,570000,4,1.75,1860,7700,1,1860,0,1964
8121101380,475000,3,1,1380,4635,1,1380,0,1919
9198600035,240000,6,1.75,2210,8594,1,1310,900,1959
0322069141,462000,4,2.5,2640,47480,1,1590,1050,1979
2523039054,1.115e+006,3,2.5,4530,22873,2,3220,1310,1912
1446401540,243000,3,1,1500,6600,1,1500,0,1970
9541600015,660000,4,2.25,2010,15375,1,2010,0,1957
7352200025,1.19e+006,2,1.75,2080,8112,1,1040,1040,1939
0853600150,1.68e+006,4,4.25,5584,68257,2,5584,0,1998
9208900037,6.885e+006,6,7.75,9890,31374,2,8860,1030,2001
7853230720,368000,3,2.5,2080,4307,2,2080,0,2004
8562750220,811500,5,4.25,3970,4500,2,2860,1110,2004
3995700325,275000,2,1,770,8149,1,770,0,1948
2387400120,650000,4,2.5,2500,6005,2,2500,0,2001
0822039146,485000,3,2,2410,50654,1.5,2410,0,1995
1925069183,425000,3,2.5,1340,10018,1,1340,0,1976
6205500580,530000,3,2.5,2640,13775,1,1550,1090,1978
8835400805,657000,4,1.75,2740,8520,1,1370,1370,1954
1518000230,315000,4,2.75,1580,3770,1,1080,500,2002
4053200410,273000,4,1.5,2180,22870,1,1280,900,1954
2141300620,550000,3,2.75,1960,13252,1,1240,720,1975
3278602170,347000,2,2.25,1560,1705,2,1270,290,2006
3876310300,525000,5,2.75,2440,8000,1,1240,1200,1972
8141200027,490000,3,1.5,990,1343,2,840,150,2007
3034200543,500000,3,2.25,2210,7916,2,2210,0,1978
7787050180,585000,3,2.75,3080,7282,2,3080,0,2008
3760500475,926500,4,2.75,2900,17802,1,1750,1150,1981
9301301145,465000,1,1,1020,3200,1,1020,0,1927
5615100330,200000,4,2,1900,8160,1,1900,0,1975
4139500410,1.68e+006,6,4.75,5770,16747,2,4500,1270,1998
0722039087,220500,2,1,990,57499,1,990,0,1949
0722039087,329000,2,1,990,57499,1,990,0,1949
8129700644,715000,3,4,2080,2250,3,2080,0,1997
8129700644,780000,3,4,2080,2250,3,2080,0,1997
4443800385,410000,2,1,1480,4080,1,1050,430,1949
4443800385,778100,2,1,1480,4080,1,1050,430,1949
7405700015,406000,3,1,1090,11292,1,1090,0,1952
2780400035,665000,4,2.5,2800,5900,1,1660,1140,1963
5562100325,305000,2,1,1000,8212,1,1000,0,1947
7437101030,265000,3,2.5,1640,7668,2,1640,0,1991
3856904610,485000,4,1,1620,4080,1.5,1620,0,1923
1423069095,600000,3,2.5,2460,108900,1,1860,600,1977
2523400205,510000,2,1.5,1860,5100,1,1060,800,1940
3530420110,195000,2,1,1080,3899,1,1080,0,1972
6046401030,432500,3,1.75,1980,5100,1,1270,710,1965
8563000770,490000,3,1.75,1510,8433,1,1220,290,1967
2215900180,270000,3,2.5,1690,7165,2,1690,0,1992
2771602450,370000,2,1.5,1010,2102,2,1010,0,1984
0722059233,327500,3,2.5,2090,12027,2,2090,0,1991
1257201095,826000,2,1,1060,6120,1,1060,0,1908
4391600035,510000,3,1.75,1750,7020,2,1750,0,1934
0625049310,587750,2,1,890,4730,1,890,0,1941
0424059100,449228,5,2.5,3020,24750,1,1650,1370,1965
1422029138,565000,3,2.5,2030,217805,1,2030,0,1999
2723069146,660000,4,2.5,3170,186436,2,3170,0,2000
5112800042,400000,5,2.75,2470,19200,1,1250,1220,1977
0579002870,612500,4,2,2060,5000,1,1030,1030,1949
2461900790,560000,4,1.75,2120,6250,1,1060,1060,1917
6788200360,727000,3,2.25,2180,4200,1.5,1520,660,1939
1018000110,224000,4,3,2300,7609,2,2300,0,1976
7701960720,1.08e+006,4,2.5,4200,35267,2,4200,0,1990
9477201530,439000,3,2.25,1480,7565,1,1220,260,1977
1821069072,335000,3,1.5,2240,87625,1.5,1480,760,1980
5035300572,779000,4,1.5,2740,4912,1,1370,1370,1937
1023089019,452000,5,1.75,1830,47916,1.5,1830,0,1948
2710600015,775000,4,3,2000,5304,1.5,2000,0,1947
1502400300,235000,3,1.75,1380,8362,1,1380,0,1967
4045700115,370000,3,1.75,1620,37913,2,1620,0,1953
7504010590,790000,4,3,3180,12070,2,3180,0,1976
4389200610,903000,2,1.5,1140,7800,1,1140,0,1947
1321039076,209950,3,1,970,9583,1,970,0,1967
4123800180,309000,3,2.5,1780,7859,2,1780,0,1988
6415100410,440000,3,1.75,2240,8153,1,1120,1120,1948
4420600015,571500,4,2.25,2810,25990,2,1860,950,1959
3856901880,514000,2,1,920,4000,1,920,0,1906
3878900395,323000,3,1.75,1830,12500,1,1200,630,1947
9183701345,290000,2,1.75,1560,7575,1,1560,0,2002
7768700300,2.575e+006,4,4.25,5540,15408,2,4280,1260,2006
3536900110,1.3625e+006,3,2,2310,21318,1,2310,0,1979
7518503830,551000,4,1.5,1470,5100,1.5,1470,0,1946
2125059161,960000,4,2.5,3430,43560,1.5,3430,0,1979
2597520720,720000,5,2.5,2900,9525,2,2900,0,1989
0109200730,218000,3,1.75,1850,7684,1,1320,530,1979
2621750110,334950,4,2.5,2190,7000,2,2190,0,1997
8644400040,605000,4,2.25,2510,31584,2,2510,0,1979
4237901345,825000,4,3.25,3200,4477,2,2390,810,2006
8731982250,268500,4,1.75,1670,8000,1,1670,0,1974
7942100180,230000,3,1.75,1010,9600,1,1010,0,1969
3324079089,1.335e+006,4,4,5050,202554,2,3260,1790,2000
7147800015,245500,2,1.5,1430,9782,1,1430,0,1955
2826049023,440000,3,2.25,1880,7989,1,1280,600,1982
3905081530,571500,4,2.75,2180,5799,2,2180,0,1993
9543000945,182500,3,2.25,1830,4744,2,1830,0,1997
0402000145,217000,2,1,970,5600,1,970,0,1951
4364200015,335000,2,1.5,1170,5248,1,1170,0,1941
2979800845,501000,2,1,1010,4320,1,1010,0,1924
7230900120,339950,3,2.5,2140,7641,1,1290,850,1979
5018200155,340000,3,1.75,2230,10403,1,1630,600,1968
6743700317,582500,2,1,1140,23779,1.5,1140,0,1966
3738900035,298800,2,1,860,8189,1,860,0,1948
1328300040,317500,6,1.75,2540,8400,1,1340,1200,1977
0952000495,598000,4,2.5,2420,5118,1.5,1550,870,1926
7996700220,375000,2,2.25,1640,2240,2,1640,0,1980
7972601445,465000,4,2.25,2550,7650,2,2550,0,1996
3751601785,551870,3,2.5,2507,18400,2,2507,0,2006
7212650650,295000,3,2.5,1920,7229,2,1920,0,1993
2413300730,263500,4,1.75,2210,6375,1,1640,570,1977
8127700735,1.095e+006,4,4,3530,8400,2,2630,900,1958
2113701080,300000,2,1,1100,4010,1.5,1100,0,1920
5700000120,780000,4,1,3390,4500,1.5,2190,1200,1924
3172600031,325000,3,1.5,1590,7936,1,1590,0,1956
0066000265,370000,2,1,820,6550,1,820,0,1949
4045800040,715000,4,2.5,2370,10000,1,1660,710,1974
1430800100,356000,4,2,1600,12500,1,1600,0,1938
2473411240,329950,4,1.75,1740,7208,1.5,1740,0,1976
2877100985,490000,3,2.25,1470,2500,2,1080,390,1984
4310701575,429000,3,3.25,1410,1246,3,1410,0,2005
7715801030,510000,4,2.5,1620,8125,2,1620,0,1983
7202331050,550000,3,2.5,2360,4080,2,2360,0,2003
8820903555,467500,3,1,1830,6453,1,1830,0,1956
5708500315,615000,5,2,2130,4180,1.5,1270,860,1926
0526059103,325000,2,1,990,15120,1,990,0,1953
1352300315,219950,2,1,1010,4120,2,1010,0,1907
3307700150,950000,3,1,1720,9830,1,1720,0,1946
0809001400,925000,3,1,1630,3200,1.5,1630,0,1912
6123600090,251200,4,1.5,1310,8250,1,1060,250,1953
8651401720,215000,3,1.5,1610,5304,1,1610,0,1968
6386700110,245000,3,2,1850,8208,1,1180,670,1970
8100900115,259000,3,1.75,1270,4815,1.5,980,290,1922
7549801395,349950,4,1.5,1420,6720,1.5,1420,0,1925
0226059096,1.565e+006,5,4.5,5220,67319,2,5220,0,2001
6021502070,600000,2,1,1410,4500,1,1020,390,1939
2767603608,405000,2,1.5,1170,1274,3,1170,0,2001
0425059103,625000,3,2.5,1860,10027,2,1860,0,1993
1624079057,430000,4,1,1620,37075,1.5,1620,0,1943
1931300688,533000,3,3,1280,1085,3,1280,0,2004
7732650120,1.05e+006,4,2.5,2750,9949,2,2750,0,1999
0179001425,230000,3,1.75,1420,3000,1,710,710,1931
5469300330,275000,4,1.75,2000,8700,1,1010,990,1975
3678900110,403000,2,1,1100,3598,1,1100,0,1926
3388300730,550388,3,3,1720,70567,1,1720,0,1966
4037600115,415500,3,1.5,1240,12400,1,1240,0,1958
4083302485,913000,3,1.75,2170,4000,1,1110,1060,1925
7857000716,334998,2,1,1800,5182,1,900,900,1942
8857600490,201500,3,1,1160,8320,1,1160,0,1959
0925069100,820000,3,2.5,3030,46538,2,3030,0,1997
4077800518,371000,3,1,890,7200,1,890,0,1951
2212200100,229950,4,2.5,2150,7670,1,1240,910,1976
2212200100,344900,4,2.5,2150,7670,1,1240,910,1976
5100403876,840000,3,2.5,2060,9715,2,2060,0,1924
0821049191,285000,3,1.5,1380,12196,1,1380,0,1967
0126039599,475000,4,2.25,1800,7200,1,1230,570,1979
1218000195,420000,2,1,1460,7832,1,1460,0,1924
9287800375,685000,3,2,2210,5000,1.5,1710,500,1909
0926069140,879000,4,3,3590,89640,2,3590,0,2005
2407000145,197200,3,1,1140,8775,1,990,150,1942
0452001280,529950,3,1,1240,5000,1.5,1240,0,1909
0425069020,1.09e+006,4,2.5,4340,141570,2.5,4340,0,1992
4232901120,792000,3,1.5,1570,1050,2,1570,0,1915
4233400490,262000,3,2.5,1680,10300,2,1680,0,1994
4302201005,353900,3,1.75,1560,5760,1,780,780,1927
2026079055,380000,1,1.5,1200,44866,1.5,1200,0,1983
5104510120,305000,3,2.5,1690,5175,2,1690,0,2002
7857003851,440000,4,2,2310,5004,1,1430,880,1994
1257202430,1.008e+006,4,3.5,2650,3060,2,2060,590,2001
5104511530,549900,5,3,3610,7555,2,3610,0,2003
0522069111,678500,4,3,2620,214750,2,2620,0,1992
5379804537,270000,3,2.25,1760,8287,1,1160,600,1986
3034200410,430000,3,1,940,12521,1.5,940,0,1949
5700003630,1.925e+006,5,4.25,4830,8050,2.5,3710,1120,1914
7203220410,790500,4,2.75,3350,5416,2,3350,0,2014
2426049168,447450,3,2.25,1570,7200,2,1570,0,1991
9828701565,375000,3,2,2240,5200,1,1630,610,1954
0259600620,565000,4,2,1950,9940,1,1950,0,1963
5312100040,400000,2,1,1010,3916,1,810,200,1918
1938400040,246000,3,1.5,1630,10200,1,1300,330,1976
6632900405,329922,3,1.75,1420,6289,1,1100,320,1967
2125059123,1.249e+006,5,3.25,3950,44431,1,2100,1850,1969
6411600113,375000,3,1,1210,7425,1,1210,0,1910
6381500035,385000,3,1.75,1890,9920,1,1230,660,1944
7518500985,591500,4,2.5,1690,4080,1.5,1140,550,1912
5149800040,255000,4,2,2560,12155,1,1350,1210,1960
3211000930,275000,3,1.5,1350,7800,1,1350,0,1959
1853081250,800000,4,2.75,3120,5000,2,3120,0,2010
6632300040,327000,2,1,1140,7435,1,1140,0,1952
6117501755,355000,4,1.5,2230,11536,1,1220,1010,1954
6163900411,310000,2,1,1050,8220,1,780,270,1947
1924069039,869000,5,3.25,4180,49222,2,2880,1300,1979
4058801065,272000,3,2,1200,5700,1,1200,0,1942
1223089038,665000,5,2.25,3320,60984,2,3320,0,2000
5420800090,225000,3,2.5,1590,8449,2,1590,0,1989
2591720360,375000,3,2.5,2750,37096,2,2750,0,1989
9286750100,375500,3,1.5,1530,7200,1,1530,0,1975
2392100090,550000,3,1.75,1570,6500,1,920,650,1948
4302201085,248000,3,1,1470,7680,1,1220,250,1946
4302201085,546940,3,1,1470,7680,1,1220,250,1946
7215730580,680000,4,3,3150,6175,2,3150,0,2001
2095500120,350000,4,2.5,2380,6124,2,2380,0,1997
0136000220,593000,2,2.5,2000,2500,3,1810,190,1994
3834000720,390000,2,1,1140,8147,1,1140,0,1958
3523029077,297000,3,1,1340,18000,1,1340,0,1924
0042000065,355000,2,1,1450,9150,1,1450,0,1965
3275330120,309900,3,2.5,2020,26670,2,2020,0,1987
2312400230,257000,3,2.25,1810,12000,2,1810,0,1992
3472800065,1.698e+006,4,3,3600,9687,2,3600,0,1959
7518501140,300000,3,2,1260,2550,2,1260,0,1987
9126100815,500000,3,2,1560,1156,3,1560,0,2014
2769600590,900000,8,4,4020,7500,1,2010,2010,1968
7215730040,695000,4,3,3150,9130,2,3150,0,2001
8155760040,213400,4,2.5,1680,6655,2,1680,0,2001
1376800220,425000,2,1,1320,8830,1,1020,300,1939
3623059101,420000,3,3,2700,47050,2,1570,1130,1986
7010701016,411000,1,1,1080,5000,1.5,1080,0,1948
1025069210,762500,4,2.25,3130,41382,2,3130,0,1986
0721049096,569950,5,4.5,4850,40902,2,4850,0,2001
7347600210,258000,4,1,1220,8500,1.5,1220,0,1916
3630030180,499000,3,2.25,1780,3665,2,1780,0,2004
9353300820,310000,3,1,1250,10723,1,1250,0,1961
4310702876,398500,2,2.5,1780,1311,3,1350,430,2005
5647900120,250600,4,2.5,1930,8660,1,1120,810,1981
4123800580,352000,4,2.5,2470,6116,1,1420,1050,1985
6169901006,600000,2,1,1180,2160,1,940,240,1909
3735901080,645000,3,1,2270,4182,1,1170,1100,1946
5104520620,291500,4,2.5,1770,5000,2,1770,0,2004
2422049107,350000,4,1.75,2250,13515,1,2150,100,1940
3260700360,279000,3,2.5,1540,7280,1,1080,460,1974
1862400057,320000,2,1,820,5400,1,820,0,1940
8682262720,495000,2,2,1580,5203,1,1580,0,2004
3183110180,490000,4,2.5,2430,42646,1,1450,980,1989
7986400360,770000,5,1.5,2160,5000,1.5,2160,0,1926
1789900065,215000,3,1.75,1770,29004,1,1770,0,1959
0222069057,665000,3,3.5,3580,95832,1.5,3580,0,2005
3822200164,423500,3,2.25,1890,7498,1,1190,700,1987
1931300665,850000,3,3,1910,4800,1.5,1910,0,1900
1443500385,155000,2,1,910,6232,1,910,0,1943
0259600410,505000,3,2.25,1460,7210,1,1460,0,1963
3630120880,780000,3,3.5,3310,5558,2,3310,0,2005
2822049210,165000,3,1.5,1630,22764,1,1630,0,1970
6821100015,707000,2,2.5,2130,5001,1,1330,800,1972
2267000458,497000,3,2.5,1220,1475,3,1220,0,2000
2976800115,349170,4,1.75,1670,8856,1,1070,600,1955
7436600090,287000,4,1.5,1300,10050,1.5,1300,0,1963
6072800205,2.375e+006,4,2.5,3220,20251,1,3220,0,1969
3296000110,645000,4,2.5,2430,14400,1,1670,760,1963
5054800110,238000,5,2.25,2240,9652,2,2240,0,1990
5054800110,328000,5,2.25,2240,9652,2,2240,0,1990
7443000652,365000,2,1.5,790,1123,2,700,90,2003
3995700220,380000,3,1,1380,8147,1,1380,0,1948
4191400090,525000,4,1.5,1680,10500,2,1680,0,1962
7518505070,402000,4,2.25,2000,3672,2,1650,350,1926
9144300110,308000,2,1,1680,9250,1,860,820,1969
7853301930,405000,3,2.5,1960,6997,2,1960,0,2006
3586500770,808000,3,1.75,2590,32380,1,2590,0,1951
7203100730,875000,4,3.5,3790,6874,2.5,3790,0,2010
8644400180,860000,3,2.5,2370,55321,3,2370,0,1982
2071500011,367500,4,2.25,1930,7925,1,1300,630,1960
5423600100,604000,6,3.5,2580,13572,1,1290,1290,1987
3734900110,230000,2,0.75,890,19703,1,890,0,1934
2126049154,435000,4,2.75,2160,8148,1,1410,750,1978
1864700300,347500,4,2.5,1970,7098,2,1970,0,2007
1310930100,525000,4,1.75,1570,16697,1,1030,540,1981
8103000110,280000,2,1.5,1480,15641,1,1480,0,1940
8103000110,490000,2,1.5,1480,15641,1,1480,0,1940
7227501765,265000,4,1.75,1430,5490,1,1430,0,1942
0824069188,645000,4,2.25,2720,18295,1,2000,720,1979
1402000210,390000,3,2.25,2420,31497,1,1750,670,1964
5412400180,267500,3,2.5,1400,7629,1,1120,280,1988
8894200150,1.275e+006,4,3.5,5844,10766,2,5844,0,2007
4037500110,404000,4,1.75,1840,10720,1,960,880,1958
1843100540,380000,3,2.25,2530,12042,2,2530,0,1989
7856620210,812500,4,2.75,2810,10300,1,1810,1000,1978
0425200145,265000,3,1,1020,8610,1,1020,0,1959
6073300750,480000,5,2.75,2550,7725,1,1390,1160,1967
6450301220,264000,1,1,710,4725,1,710,0,1939
3401700150,1.35e+006,5,3,5530,38816,1.5,5530,0,1969
7200001254,550000,4,1.75,2150,9000,1,1110,1040,1966
9828201745,615000,2,1.5,880,2400,1.5,880,0,1929
9238500410,464000,3,1.75,1630,28600,1,1630,0,1967
2587910180,365000,3,1,1380,30940,2,1380,0,1976
8663200450,490000,4,2.25,2800,10800,1,1680,1120,1977
1310960220,280927,4,2.25,2070,7350,2,2070,0,1977
0396100110,282613,2,1,830,6017,1,830,0,1954
7785350490,675000,3,2.25,2770,15886,2,2770,0,1982
1795900210,575550,4,2.5,2060,7475,1,1440,620,1985
1796370730,259900,3,2,1490,7770,1,1490,0,1990
7787100210,450000,4,2.25,2120,8267,2,2120,0,1996
1137450120,487500,4,2.5,2810,6296,2,2810,0,2013
1921059303,275000,4,2.25,2400,17842,2,2400,0,1973
6699000610,305000,3,2.5,2460,5027,2,2460,0,2002
3621059048,395000,3,1.75,2030,217800,1,2030,0,1977
2620069077,215000,3,1,880,7648,1,880,0,1940
3083000910,410000,3,2,1320,6000,1.5,1320,0,1920
0192600100,440000,4,2.5,2160,7826,1,1390,770,1976
5608010750,1.16e+006,4,3.5,4190,15724,2,4190,0,1994
6140100150,500000,4,2,2280,7200,1,2280,0,1956
9550203690,961000,5,2.75,2590,6120,2,2590,0,1909
5423010180,825000,4,2.25,2770,9340,2,2770,0,1979
2919200665,734000,3,1.75,2145,3840,1.5,2145,0,1910
2122059199,490000,4,4.25,4480,5715,2,3680,800,2003
3601200017,175000,4,2.5,1780,6000,2,1780,0,1991
2658000115,190000,1,1,720,4800,1,720,0,1914
7349400610,305000,4,2.25,2050,12581,2,2050,0,1978
0868001790,1.3e+006,3,1,2040,7936,1,1680,360,1940
1105000015,417000,2,1,920,6600,1,920,0,1919
2919201385,275000,2,1,680,4190,1,680,0,1906
7202470100,661000,3,2.5,1940,8196,2,1940,0,1991
2832100910,435000,4,2.75,2230,9640,1,1320,910,1998
4100000040,788000,5,2.25,2910,9454,1,1910,1000,1972
9320100090,1.795e+006,5,3.25,5270,17232,2,4010,1260,1977
2589300180,408000,5,3.25,2820,6589,1.5,2320,500,1906
0357000025,570000,2,1,1790,3760,1.5,1490,300,1912
3179100180,1.54e+006,5,3.25,2920,6960,2,2120,800,1953
2487700065,400000,2,1,840,5510,1,840,0,1955
8732040820,247000,3,1.75,1820,8740,1,1820,0,1987
1160000300,453000,3,1.75,1550,7200,1,1100,450,1949
3904100035,235000,2,1,1270,3008,1,650,620,1923
5288200230,675000,4,1.75,2460,5750,1.5,1620,840,1919
3331500820,516200,3,2,2110,5150,1,1080,1030,1919
3023039231,650000,1,1,920,91476,1.5,920,0,1996
5595900355,257100,3,1.5,1500,10227,1,1000,500,1945
8682290360,457000,2,2,1440,9985,1,1440,0,2006
5200100115,540000,3,1.75,1610,3478,1.5,1060,550,1929
1310700210,268000,3,1.75,1970,10270,1,1970,0,1966
3298500690,300000,3,1,1150,7314,1,1150,0,1960
0722059002,380000,2,2.5,2110,114127,1,1590,520,1975
1022069183,725000,3,2.5,3580,54450,1.5,3580,0,1990
4053200933,249000,3,1,1000,19204,1,1000,0,1968
5589300205,274000,5,1,1680,9383,1,1400,280,1929
0644000040,1.78e+006,4,3.25,3950,10912,2,3950,0,2003
1787600165,396500,3,1.75,2390,7149,1,1350,1040,1955
0405100165,460000,2,1.5,1820,7800,1,1240,580,1956
0223049087,277000,3,1,1100,8536,1,1100,0,1957
2742100085,449500,6,4,2280,5275,1,1270,1010,1998
3204300625,785950,4,3,2530,4560,1.5,1540,990,1925
6619910230,545000,3,2.5,1940,9775,1,1440,500,1975
3275310220,244000,3,2,1360,9688,1,1360,0,1983
5466310730,165000,3,2.5,1660,2415,2,1660,0,1983
2767704055,435000,2,1,800,5000,1,800,0,1906
7504100110,642000,3,2.5,2670,10082,1,2670,0,1987
9320990110,340000,3,2.5,1720,4120,2,1720,0,1999
1400700150,730000,4,2.5,3550,35689,2,3550,0,1991
1186000150,563250,3,1.75,1370,2800,1,800,570,1982
1024069009,675000,5,2.5,2820,67518,2,2820,0,1979
0464001115,620000,3,1.5,1620,6630,1,1280,340,1954
0886000015,275000,2,2,1290,9041,1,950,340,1956
3578600062,270000,3,1,1830,8209,1,1830,0,1942
1402950450,325000,4,2.5,2040,5472,2,2040,0,2003
3629970620,476100,4,2.5,1850,1836,2,1600,250,2005
3537900180,700000,2,1,1300,12000,1,1300,0,1959
8651442510,220000,4,2,1620,5200,1.5,1620,0,1978
0114700150,236000,3,1.75,1560,10919,1,1560,0,1975
0472000620,790000,3,2.5,2600,4750,1,1700,900,1951
5491200210,350000,3,1,2010,6000,1,1210,800,1967
7973202712,130000,2,1,780,5300,1,780,0,1941
7970800100,283200,4,2.5,1982,6406,2,1982,0,2004
8122600165,273000,3,1,1500,6250,1,890,610,1945
0686530110,599000,5,2.25,2460,8710,1,1330,1130,1976
5151600530,460000,4,2.5,2680,11998,1,1510,1170,1960
1926069192,1.1572e+006,4,4.25,5860,52889,2,4910,950,1996
5649000150,385000,4,1.75,1720,8750,1,860,860,1971
7812800775,264250,3,1,1420,7420,1.5,1420,0,1944
2770604410,608000,3,2.5,1760,1472,3,1640,120,2006
9485951510,450000,3,2.5,2790,48994,2,2790,0,1984
1337800805,1.755e+006,3,2,2360,4800,2,2360,0,1909
4059400265,339950,5,2,1890,6050,2,1890,0,1944
0993000100,760000,6,3.75,3810,6150,2,3810,0,1977
2917200085,350000,2,1,1160,5395,1,860,300,1940
3914000090,541500,3,1.75,2320,55847,1,2320,0,1960
4157600150,730000,6,2.75,3280,16449,1,1910,1370,1963
3624039111,215000,3,1,980,5600,1,980,0,1949
8099900490,420000,3,2,1640,9972,1,1640,0,1977
1687910100,655000,4,2.25,2060,8470,1,1440,620,1983
5419800330,240000,3,2.5,1500,10652,2,1500,0,1981
5035300085,730000,4,2,2360,6000,1,1260,1100,1939
0325059131,390000,4,1.5,1940,12100,1,1940,0,1962
2201500450,473000,3,1,1280,10000,1,1280,0,1954
3342101270,698000,4,3.5,3630,5670,2,3630,0,1970
3574750150,511000,3,2.5,1820,4883,2,1820,0,2005
9828702055,358000,2,1.5,960,1808,2,960,0,1993
2207100650,499990,3,1.75,1630,8400,1,1060,570,1955
0240000031,322000,4,2.25,1940,10200,1,1360,580,1960
2953000300,201000,3,1,980,9682,1,980,0,1969
6119700150,765000,4,2.5,3140,16200,1,2570,570,1988
9274200365,920000,4,2.75,2880,5750,1.5,1710,1170,1928
6187700501,360000,4,2,1650,7552,1,860,790,1977
4137020910,297300,3,1.75,1980,9220,2,1980,0,1987
1233100720,399000,3,1,860,9403,1,860,0,1942
3034200530,400000,3,1,1430,10005,1.5,1430,0,1950
1463400081,230000,3,1.75,1260,10164,1,1260,0,1964
1773101050,290000,3,1,960,4560,1,960,0,1968
1895450090,323800,3,2.5,2060,7658,2,2060,0,2003
5101406384,574500,4,1.5,1430,6380,1.5,1430,0,1930
6821102346,505000,3,2.25,1670,1596,2,1220,450,2002
1926049210,372500,2,1,880,10950,1,880,0,1944
1842200040,425000,3,1.5,1300,19163,1,1300,0,1964
2623089002,446250,3,2.5,2380,214315,1.5,2380,0,2000
4391600065,330000,2,0.75,520,6862,1,520,0,1924
3760500602,608095,3,2.5,2680,17707,2,2680,0,1983
6071000265,550000,3,2.5,2140,10136,1,1320,820,1958
3222059206,265000,4,2.5,1820,16103,2,1820,0,2004
3034200933,399888,4,2.25,1820,8255,1.5,1320,500,1930
2028701165,430000,2,1,1050,2570,1,850,200,1927
5634500234,554990,3,2.5,2100,6092,2,2100,0,2013
2310100180,359950,3,2.5,2210,6280,2,2210,0,2003
2767600921,405000,2,1,860,2599,1,860,0,1901
8835200790,280000,2,1,870,4025,1,870,0,1981
2473000410,479950,4,2.25,2570,11070,2,2570,0,1966
3286800110,575000,5,1.75,2980,53578,1,2230,750,1976
1402600110,392000,4,2.25,2360,7733,2,2360,0,1983
1126059170,760500,4,2.25,2310,36136,2,2310,0,1977
8035350090,435000,3,2.5,2300,9521,2,2300,0,2003
4389200753,1.565e+006,4,2.75,2810,8570,2,2810,0,1993
6818400110,261000,4,1.5,2040,10488,1,1190,850,1961
4217401035,1.4825e+006,3,2.25,3290,5000,2,2730,560,1939
1683400165,853800,7,4,2960,2665,2,1950,1010,1927
1939120450,657500,3,2.5,2670,10496,2,2670,0,1989
4137010530,331950,4,2.5,2530,9933,2,2010,520,1990
2624039133,514000,3,1.75,1720,5899,1,1220,500,1986
2794700120,496000,3,3.5,3090,27598,2,2020,1070,1995
2944010210,1.093e+006,4,2.5,3930,21894,2,3930,0,1987
8651443360,195700,3,1,1120,5200,1,1120,0,1976
1338300180,1.39571e+006,4,2.25,3960,8640,2,2630,1330,1925
0624110540,1.175e+006,4,3.25,4060,20822,2,4060,0,1991
4039700090,643403,3,2.5,2350,9648,1,2350,0,1966
6752601110,357000,4,2.5,2380,7066,2,2380,0,1997
8861000210,865000,3,1.75,1480,8163,1,1040,440,1953
1088700100,905000,3,2.5,2930,9280,2,2930,0,1988
7893207925,265000,3,1.5,1290,7100,1,1290,0,1954
3449820100,535000,2,2.5,2730,7246,2,2730,0,1998
1588600110,450000,3,1,1290,5440,1,790,500,1929
8079040300,460500,4,2.5,2170,7533,2,2170,0,1991
7390400026,315000,4,1.75,1850,8580,1,1140,710,1960
2425059144,607500,4,2.5,2110,13939,1,1270,840,1978
7821200375,432000,2,1,960,3235,1,960,0,1916
1370800700,1.695e+006,3,4,3910,5350,2,2610,1300,1933
8857640710,479000,4,2.5,2590,6139,2,2590,0,2001
9558020240,475000,5,2.75,3080,6600,2,3080,0,2002
3834000400,415000,3,1,1630,8146,1,1630,0,1952
0461002050,450000,2,1,910,5000,1,910,0,1914
0724069065,1.14e+006,3,2.5,2780,33503,1.5,2110,670,1969
4307351180,430000,5,3,3880,8432,2,3880,0,2004
0984100340,296000,3,1.75,1360,10742,1,960,400,1971
8159620260,303000,4,2.25,2560,8927,1,1790,770,1976
7559600200,641000,4,2.5,2600,6015,2,2600,0,2004
1995200320,280000,3,2.25,1220,5739,1,790,430,1984
4223000140,260750,3,2,1560,9635,1,1260,300,1966
7215730200,601000,4,2.5,2080,5191,2,2080,0,2001
1900600105,255000,3,1.5,1490,6604,1,1490,0,1918
8644300200,555000,4,2.75,2020,10720,1,1420,600,1976
3262301610,865000,3,1.5,1530,10827,1,1530,0,1955
0524059250,1.388e+006,4,2.5,3450,17400,1.5,2180,1270,1964
8594400350,315000,3,2.25,1400,31626,1,1140,260,1987
4031000260,200000,2,1,1730,9610,1,1380,350,1962
1454100260,357000,3,1,1370,6450,1,1370,0,1948
1934800138,390000,2,1.5,1050,934,2,960,90,2007
9508500075,462000,5,1.75,2840,10220,1,2210,630,1954
2946003415,174500,2,1,1010,5200,1,1010,0,1955
1926049326,305000,2,1,1210,7140,1.5,1210,0,1921
7655900187,449000,5,1.75,1720,14040,1,1150,570,1956
7452500565,260000,3,2,2710,5000,2,2710,0,1951
2871000400,751000,4,2.5,3110,6142,2,3110,0,2004
6150200060,370037,2,1,1250,9270,1,1250,0,1948
3668000830,229950,3,1.75,1900,8910,2,1900,0,1988
2473460060,349000,3,1.75,1740,7682,1,1330,410,1978
9558021000,348000,4,2.5,2070,3808,2,2070,0,2003
1250201610,1.22e+006,3,3.25,3030,5600,2,2220,810,1905
1321720160,510000,4,3,3610,18948,2,3610,0,1993
5029450200,265000,3,1.5,1520,6805,1,1040,480,1981
0723000226,1.25e+006,3,2.75,2780,4815,3,2780,0,1974
0225079036,937500,4,4,5545,871200,2,3605,1940,2003
5255700160,485000,3,1.75,2590,8384,1,1590,1000,1971
5683500030,489000,4,1,1150,5217,1.5,1150,0,1951
0312000295,400000,2,1,920,5120,1,920,0,1952
9510970520,638000,3,2.5,2110,3600,2,2110,0,2005
0193600200,440000,3,1.75,1170,8740,1,1170,0,1968
2568300045,305000,6,2,1900,8240,1,1200,700,1964
2568300045,649950,6,2,1900,8240,1,1200,700,1964
8691410310,680000,4,2.5,3290,6012,2,3290,0,2005
1656600310,629000,4,2.5,2660,22050,2,2660,0,1996
3904940160,555000,3,2.5,2160,7584,2,2160,0,1988
1774200060,669000,4,2.75,2700,35362,2,2700,0,1976
4137070030,272000,3,2.5,1980,6608,2,1980,0,1994
2144800117,270000,4,2.25,2600,9900,1,1600,1000,1965
3392100140,215000,3,1,1280,9775,1,1280,0,1964
2581900060,690000,3,1.5,1710,17707,1,1180,530,1947
4058801230,256000,4,1.75,1270,6825,1,1270,0,1950
2787320140,255000,3,2.25,1890,7314,1,1100,790,1981
0263000324,550000,7,4,3440,8100,2,3440,0,1970
0254000695,410000,3,1,1190,5280,1,1190,0,1957
3013300830,410000,2,1,1030,4366,1,1030,0,1912
2475201070,259000,3,1.75,1240,4000,1,1240,0,1986
0798000421,292000,3,1,1730,21183,1,1030,700,1955
4104500181,1.648e+006,4,3.5,4610,12500,2,4610,0,2003
8701600030,518000,5,1,1590,5000,1.5,1190,400,1929
8944360390,485000,3,2.5,1760,3097,2,1760,0,1992
7968460270,259500,3,2,1330,35060,1,1330,0,1989
9406570350,354000,4,2.5,2340,5420,2,2340,0,2003
0686900030,999950,3,2.25,3740,22464,2,2330,1410,1966
6071300030,464500,3,1.75,1150,10466,1,1150,0,1959
5416500520,300000,3,2.5,1750,4200,2,1750,0,2005
1102000270,1.08e+006,3,2.75,3890,7216,2,3260,630,1967
5422430320,309950,4,2.5,1770,6666,2,1770,0,1989
3157600340,315000,3,1,1160,3700,1.5,1160,0,1909
2061100435,499950,3,1,1440,5580,1.5,1440,0,1908
7011201550,780000,4,2,2600,4800,1,1400,1200,1953
2581300055,885000,3,3.25,2640,16090,1,1960,680,1976
1344300045,500000,2,1,1010,3885,1.5,1010,0,1906
7575620640,329000,3,2,1840,6755,1,1840,0,1989
8645500270,246000,4,1.75,1720,7455,1,1020,700,1963
1246700136,405000,3,1.5,1280,9600,1,1280,0,1960
3211100240,349000,4,1.75,1700,7800,1,1120,580,1981
8078100140,374950,4,2.5,1980,12062,2,1980,0,1992
6675500105,306000,3,2,1160,7217,1,1160,0,1969
4040700310,416000,4,1.75,1980,7840,1,990,990,1961
6388910160,560000,3,2.5,1960,12476,2,1960,0,1989
4023500990,260000,3,1.5,1270,20700,1,1150,120,1948
2921049121,306500,3,2.25,2060,38377,1,1560,500,1978
7229210060,299950,3,1.75,1980,11274,1,1480,500,1968
4137040060,265500,3,2.5,1450,8977,1,1450,0,1990
7982600030,219000,3,1.5,1200,12000,1,1200,0,1986
1775930140,365000,3,1.75,1830,17349,1,1230,600,1977
3222079083,499000,3,2,2090,42689,1.5,2090,0,1959
3585210200,366000,3,1.75,1510,8301,1,1510,0,1967
2705600069,514950,3,2.25,1310,1264,3,1310,0,2014
8691360200,875000,4,2.75,3790,10669,2,3790,0,1999
9541600350,831000,3,2.25,2240,8800,1,2240,0,1957
8562740400,689900,4,3.25,2740,7266,2,2060,680,2003
0705700960,315000,3,2.5,1660,10763,2,1660,0,1994
3374500520,355000,0,0,2460,8049,2,2460,0,1990
2645500013,336500,3,1,1480,7284,1,970,510,1963
5318100200,1.1e+006,3,2.75,2640,4050,1.5,1750,890,1926
2224700045,375000,6,2,1900,8057,1,1170,730,1959
4047200135,289275,3,2,2860,24046,1,1700,1160,1985
2009000830,455000,4,3.5,3440,6000,2,3440,0,2002
6619910240,505000,3,1.75,1640,10695,1,1640,0,1975
5288200070,450000,3,1,1450,3350,1.5,1450,0,1919
7852110070,567500,3,2.5,2300,7398,2,2300,0,2001
0740500070,265000,3,1.5,1460,8505,1,1460,0,1955
4046601420,340000,3,2,1570,14992,1,1570,0,2001
2130700860,375000,3,2,1540,8885,1.5,1540,0,1939
3975400045,920000,6,3,3300,4218,2,2200,1100,1970
5451200520,850000,4,2.25,2130,11843,2,2130,0,1972
6600400270,202000,3,1,1010,9750,1,1010,0,1969
0624100990,725000,4,3,2420,12000,1,2420,0,1984
2424059139,900000,3,3.25,3870,33980,2,3150,720,1991
2883200875,680200,2,1.5,1960,6000,1,1210,750,1951
1917300105,216500,3,1,1170,9000,1,1170,0,1918
7203000200,325000,3,1.5,1890,7650,1,1890,0,1966
9510971070,675000,3,2.5,2250,4134,2,2250,0,2004
3760500240,435000,2,0.75,750,16321,1,750,0,1936
4068300160,263500,3,1.75,1610,14000,1,1050,560,1977
1774220070,550000,4,2.25,2590,36256,2,2590,0,1978
1563102685,875000,3,2.5,2520,3750,2,2520,0,1995
0395800370,246600,4,1,1340,8400,1,1340,0,1966
3918400013,337000,3,2.25,1460,941,3,1460,0,2006
1545804820,240000,3,1.75,1380,7500,1,1380,0,1988
7811220070,490000,3,1.75,1510,11120,1,1510,0,1984
5561100431,510000,5,2.5,2510,83231,1,1260,1250,1975
5145100310,305000,3,1,910,8008,1,910,0,1971
0255550270,350000,3,2.5,1970,3655,2,1970,0,2003
1123049129,284200,3,1.75,1540,6632,1,1070,470,1959
9407150310,357000,4,2.5,1980,9757,2,1980,0,1995
7732501000,854000,4,2.75,3150,38865,1,2480,670,1986
1024069205,1.175e+006,4,2.5,4700,49658,2,4700,0,1999
5426300060,1e+006,3,2.25,2300,15952,1,1150,1150,1963
3797000400,616500,4,2.25,1880,3000,2,1760,120,1909
2877102196,750000,4,2.75,2640,3750,2,1840,800,1911
9265200060,650000,6,4.5,3900,9100,2,2870,1030,1979
2894700270,275000,4,2.25,2670,10050,1,1420,1250,1962
2862100260,540000,4,1.75,1840,4280,1,920,920,1918
2730000070,225000,3,1,1120,10665,1,1120,0,1961
4139400060,845000,4,2.5,2970,9072,2,2970,0,1991
4365200520,490000,3,2.25,1410,7740,1,1410,0,1923
3629980350,753000,4,2.5,3060,8167,2,3060,0,2005
3211600140,475000,3,1.75,2490,7210,1,1290,1200,1972
3598600049,124000,1,0.75,840,7203,1.5,840,0,1949
3598600049,224000,1,0.75,840,7203,1.5,840,0,1949
1232001070,485000,2,1,1130,3800,1,1130,0,1916
7812801925,230000,4,1.75,1850,6000,1,1270,580,1944
0522059062,372000,4,2.75,2330,14175,1,1800,530,1980
4178500640,306000,4,2.5,1880,9426,2,1880,0,1990
9528104660,905000,4,3.5,2980,3000,2,2340,640,2008
5013500400,440000,4,1,1440,6678,1,1040,400,1950
2550820060,280000,3,1.75,1630,10001,1,1100,530,1977
0425079046,435000,3,2.5,1778,147823,2,1778,0,1999
3905050240,425000,3,2.5,1930,4500,2,1930,0,1990
5381000070,204950,2,0.75,1130,11429,1,1130,0,1956
1245002445,670000,2,1.75,1650,7500,1,1000,650,1959
6865200831,475000,2,1,820,2723,1,820,0,1921
1446801000,352000,5,2.5,2900,6650,1,1450,1450,1964
4038700830,575000,4,1.75,2330,8800,1,1260,1070,1961
4094800260,1.73e+006,4,3.5,4440,20668,2,3240,1200,1965
2742100152,491000,3,2,1660,5070,2,1660,0,1950
8691410060,750000,4,2.5,3020,7465,2,3020,0,2004
1325059083,830000,4,2.5,1850,50662,1,1430,420,1978
7852011070,1.14e+006,6,3.75,5960,20197,2,3900,2060,2005
2323059074,137124,3,1,960,27442,1,960,0,1970
7950304075,225000,4,1,1150,6000,1.5,1150,0,1907
3260000340,732600,4,2.5,2130,7300,1,1230,900,1963
9552701000,818000,4,2.25,2460,8001,2,2460,0,1984
5469501200,431000,3,2.25,2360,14950,1,2360,0,1978
6300500105,304000,2,2.25,1320,1034,3,1320,0,1996
4400200060,650000,5,2,1910,4667,1,1010,900,1908
5422560860,450000,2,2,1610,6160,2,1610,0,1977
7789000260,269000,4,1,1610,8401,1,1610,0,1958
8861000060,875000,3,1,1160,10732,1,1160,0,1953
9350900550,890000,4,2.25,2870,8393,1,1480,1390,1977
9560800310,565000,4,2.5,2280,9725,2,2280,0,1986
9187200228,448175,2,2,1370,1339,2,1150,220,2006
7849202190,235000,0,0,1470,4800,2,1470,0,1996
7215730070,680000,5,3,2970,6500,2,2970,0,2000
0121039083,629000,3,1.75,1460,12367,2,1120,340,1970
2770601677,494000,3,3.5,1570,1486,2.5,1330,240,2000
3720800070,1.1e+006,4,3,2880,5500,2,1920,960,1926
3558910570,450000,5,2.5,1900,9460,1,1190,710,1969
1081300390,330000,3,1.75,2020,11050,1,1320,700,1969
7805450560,960000,4,2.5,3110,11397,2,3110,0,1984
6648770240,360000,4,2.5,2390,7056,2,2390,0,1990
5104520810,378000,3,2.5,2150,11672,2,2150,0,2004
2719100400,499950,3,1.75,1340,6250,1,1090,250,1941
0255000320,450000,3,2.5,1990,12866,2,1990,0,1986
5398600075,523500,2,2,1600,5969,1,800,800,1950
7695470200,600000,3,2.5,2680,43995,2,2680,0,1986
6892510200,290000,3,2.5,2080,4828,2,2080,0,2002
4123800320,176000,3,3.25,1340,5434,2,1340,0,1986
0809001505,885000,3,2,2590,3750,1.5,1790,800,1904
3856905185,483000,2,1.75,1240,3000,1.5,1240,0,1906
4051100390,240000,3,1,1310,7125,1,1310,0,1978
0579003240,720000,4,2.25,2530,5200,1,1530,1000,1957
2333230060,311000,4,2.5,1780,5822,2,1780,0,2001
7129303240,332500,3,2,1600,7995,1,1600,0,1950
1219000473,164950,3,1.75,1570,15330,1,1080,490,1956
1219000473,371000,3,1.75,1570,15330,1,1080,490,1956
5469700060,264500,3,1.75,1650,16200,1,1650,0,1976
1118000935,1.738e+006,4,2.25,2920,6513,2,2260,660,1937
8819900055,503000,2,1,870,4280,1,870,0,1921
1995200338,738000,4,2.5,2830,5010,2,2170,660,2000
0091000320,393000,2,1,980,3350,1,980,0,1925
8887001600,280000,2,1,990,45528,1,990,0,1992
7183000060,260000,4,2.5,2360,9647,1,1530,830,1964
0194000565,505000,2,1,1000,4640,1,1000,0,1915
3830610320,241000,3,1.5,1660,8000,1,1120,540,1976
7922710320,530000,3,1.75,1520,9605,1,1520,0,1975
1231000310,713000,1,1,1180,4000,1.5,840,340,1910
0173000140,487000,3,1.75,1770,10125,2,1770,0,1944
8651411260,128000,2,1,980,5393,1,980,0,1969
7272000260,210500,3,1,1840,10178,1,1040,800,1960
2787700060,420000,3,2.5,1810,7210,1,1210,600,1968
5499700045,679000,3,2.5,1780,4320,2,1780,0,1930
9433000390,784950,4,2.75,2840,4227,3,2840,0,2014
7300400200,352000,4,2.5,2650,6366,2,2650,0,1998
2771101963,386000,3,1.5,1270,1318,2,1080,190,2004
0123039346,335000,3,1.75,1260,17000,1,1260,0,1994
0524069116,472500,3,2,1750,15500,1,1490,260,1982
3583300075,599950,5,2.25,2680,13292,1,1340,1340,1976
7203220030,963990,4,3.25,3830,6765,2,3830,0,2014
1250201550,735000,3,2,1610,3600,2,1610,0,1925
8651611260,858450,3,4.25,3840,9751,2,3840,0,1998
1797501275,665000,5,2.75,2670,4000,2,1800,870,1914
2215900800,290000,3,2.5,2000,7414,2,2000,0,1993
7883602650,250000,2,1,860,4320,1,860,0,1925
3546000340,192500,3,1.75,1420,7205,1,1420,0,1986
6118600045,350000,4,2,2060,13400,1,2060,0,1957
1123059116,518000,4,2.5,2790,9910,2,2790,0,2003
0124000160,563000,4,1,1410,3376,1.5,1410,0,1911
8733000045,375000,4,3,2420,9566,2,2420,0,2003
0263000327,400000,3,2.5,1460,1319,3,1460,0,2002
5153200358,240000,5,1.75,2460,16000,1,1230,1230,1957
2258500045,317500,2,1,1000,5120,1,1000,0,1902
6137500310,1.315e+006,5,4,4420,36342,2,2740,1680,1982
3323069045,234000,3,1,1240,239144,1,1240,0,1921
8563070030,645000,3,2.5,1740,13750,2,1740,0,1975
0425049036,649000,2,1,1280,4840,1,1200,80,1908
8562750550,605000,4,2.5,2520,3980,2,2520,0,2004
0767000159,337900,3,3.5,1500,1471,3,1500,0,1999
5366200030,535000,3,2.75,2490,3600,2,2290,200,1906
7857000861,325000,4,1,1530,5684,1,1130,400,1957
1094000030,429950,4,2.25,1740,10875,1,1740,0,1967
1853000030,775000,3,2.5,3550,32807,2,3550,0,1989
5318101040,650000,2,1,1280,6000,1,1280,0,1965
3623500049,1.2e+006,4,2.25,2320,13114,2,2320,0,1967
1026049036,275000,2,1,1140,10404,1,1140,0,1935
8568030030,575000,4,3.5,3930,16970,2,3930,0,1997
4022906531,540000,3,2.5,2370,16455,1,1640,730,1959
5700002325,640000,3,1.75,2340,4206,1,1170,1170,1917
2473100510,275000,3,1.5,1240,9125,1,1240,0,1967
0629811600,672800,4,2.5,2740,10533,2,2740,0,1997
7923300310,495000,4,2.25,1940,9144,1,1430,510,1956
4054560140,820000,3,2.5,2950,35108,1.5,2950,0,1995
4027700632,475000,4,2.75,1980,11443,1,1980,0,1952
2818100060,1.275e+006,4,2,2850,7861,1,1450,1400,1970
1771000960,380000,3,1,1160,9375,1,1160,0,1967
2591830350,397500,3,2,2130,8225,1,2130,0,1987
8842400071,352000,5,2.5,2420,8560,1,1620,800,1978
7856700060,893880,6,2.5,2820,8600,1,1430,1390,1967
9186300060,635000,5,3.25,3710,34200,2,2510,1200,1986
3275740030,420000,3,2.25,1770,8165,2,1770,0,1977
0452001860,503000,3,2,1260,2500,1,750,510,1987
7779200075,689000,2,1.75,2330,10143,1,1220,1110,1953
3975400260,749500,4,2.75,2490,3840,1.5,1610,880,1922
2225059336,1.15e+006,6,3.75,4090,49542,2,3100,990,1984
8567450060,563500,4,2.5,2800,12831,2,2800,0,2001
6178930340,480000,4,3,2440,9664,2,1890,550,1981
8731990370,374950,4,3,2540,8800,1,1620,920,1977
9407150350,308950,3,2.5,1600,6250,2,1600,0,1995
3438502200,445000,4,2.75,2680,16934,1,1340,1340,1958
1274500700,237200,3,1.5,1220,9000,1,1220,0,1968
5667100045,453500,3,1.75,1550,7270,1.5,1550,0,1953
2887700560,616500,3,2,2080,4549,1,1040,1040,1954
7215720070,1.25e+006,5,5,5000,32909,2,5000,0,2000
6638900550,396000,1,1,630,5150,1,630,0,1954
0723049307,210000,3,1,1070,8179,1,1070,0,1949
7577700521,539000,2,1.75,1900,5175,1,1200,700,1919
7888700030,605000,3,2.5,2960,18600,2,2960,0,1979
3501600135,437500,3,2,1490,4800,2,1490,0,1948
1822059331,215000,3,1.5,1500,15000,1,1500,0,1952
7852030310,440000,4,2.5,2410,4780,2,2410,0,2000
8901001090,525000,3,1,2000,22500,1,1680,320,1939
0192450200,319900,3,1.5,1140,20383,1,840,300,1985
1771100030,335000,3,1,1120,9075,1,1120,0,1977
1560920370,485000,3,2.25,2900,35273,2,2900,0,1986
8731981360,359999,4,2.25,3220,7700,2,3220,0,1976
9541600060,799000,5,2.75,2500,19783,1,2500,0,1959
2923049468,280000,3,2.25,1610,10454,1,1610,0,1977
8722100810,1.05e+006,4,2.75,2250,3433,1.5,1500,750,1927
7840800135,290000,1,2,1240,4800,2,1240,0,1910
8083350070,235000,2,2.25,1660,2748,2,1660,0,1995
1923800135,495000,3,1.75,2080,3000,1,1040,1040,1925
1310980070,290000,3,2.25,1880,7488,2,1880,0,1980
3110800030,230000,4,1.5,1050,9516,1,1050,0,1969
8731801260,234000,3,1.75,1480,8475,1,1480,0,1968
7202270700,597400,4,2.5,2420,4500,2,2420,0,2001
7230300060,370000,4,2.5,2190,17600,1,1110,1080,1966
0011510700,755000,4,2.5,2660,10452,2,2660,0,1993
0586470350,342000,3,2.5,2430,5715,2,2430,0,1999
6840700036,497000,2,1,770,3325,1,770,0,1918
1824069083,835000,3,1,3060,30166,1,3060,0,1959
1836980240,730000,4,2.75,2920,4500,2,2920,0,1999
3528900160,655000,3,1,1370,5250,1,1070,300,1939
1442800060,205000,3,2.5,1870,3118,2,1870,0,1993
8722100030,632750,4,2,1800,4800,1.5,1800,0,1918
1723049624,330000,5,3,2100,7715,1,1250,850,2013
4040400200,527500,5,2.25,2530,8250,2,2530,0,1961
8691391090,716500,4,2.5,3290,6465,2,3290,0,2002
7853302190,388500,4,2.5,1890,5395,2,1890,0,2006
3260000700,530000,3,1.75,1680,7770,1,1680,0,1967
5126300510,419000,3,2.5,2170,4517,2,2170,0,2002
7199330370,385000,3,1.75,1200,7360,1,1200,0,1978
1854900240,655000,4,2.5,2990,5669,2,2990,0,2003
6738700335,1.695e+006,4,2.75,3770,10900,2,3070,700,1924
0322059264,279000,2,1,1020,47044,1,1020,0,1904
5557500270,262000,3,1.5,1700,9579,1,1100,600,1962
9164100125,533000,4,1,1550,4750,1.5,1550,0,1919
7370600045,640000,3,1.75,1680,8100,1,1680,0,1950
8594400060,285000,3,2.25,1680,35127,2,1680,0,1987
7818900060,458400,4,2.5,1910,10300,1,1910,0,1921
2126059139,620000,5,3.25,3160,10587,1,2190,970,1960
1759701600,465000,3,1.5,2020,11358,1,1190,830,1956
1795920310,690000,4,3.75,3210,7054,2,3210,0,1985
1626069139,462500,3,2.25,2350,51400,1,1390,960,1977
3303951600,369950,4,2.5,1910,10221,2,1910,0,1994
3353402400,124500,2,1,840,6480,1,840,0,1954
2332700060,950000,4,2.25,2620,10920,1,2620,0,1965
4040800260,418000,4,1.5,1220,10580,1,1220,0,1965
1202000140,160000,3,1,1060,8000,1,1060,0,1927
4022902050,457000,4,2.5,2200,10800,1,1500,700,1964
4364200125,530000,2,1.75,2120,7680,1,1130,990,1948
4036801245,385000,3,1,1250,7300,1,1250,0,1956
7375100070,491000,3,1.75,1440,7800,1,1440,0,1958
0686400060,521000,4,2.25,1890,8034,1,1890,0,1967
1645000710,255000,3,1,1140,8528,1,1140,0,1967
5476800069,292050,5,3,2840,7199,1,1710,1130,2003
0823059185,326000,6,3,1880,7200,1,1880,0,1966
4364200075,300000,2,1,750,5120,1,750,0,1941
2473420070,291600,3,1.75,1630,7480,1,1330,300,1979
5706201360,435000,5,1.5,1720,12551,1,1720,0,1967
4442800012,465000,3,2.5,1600,1311,3,1600,0,2005
3339900640,200000,3,2.25,1230,7420,1.5,1230,0,1913
0425400070,238000,3,1.5,1610,6132,1,1090,520,1959
4036800370,455000,4,2.5,1320,7000,1,1320,0,1956
2412600070,230000,6,3,2180,7220,2,2180,0,1980
8805900570,808000,4,2.25,2190,4104,2,1410,780,1928
9178600810,578500,3,1,1490,5700,1.5,1490,0,1916
2979800764,390000,3,2,1463,868,3,1463,0,2003
3904980270,517500,3,2.5,1800,3933,2,1800,0,1989
6738700075,755000,4,2.75,2880,4000,1.5,2100,780,1912
1646501920,579500,3,1.75,1250,4120,1,980,270,1925
2997800075,649950,3,2.75,1670,1350,3,1350,320,2014
4440400125,228000,4,1.75,2000,6120,1,1100,900,1965
3423600060,665000,4,1.75,2280,3680,1.5,1470,810,1926
1523560030,689000,4,2.5,2110,6069,2,2110,0,1999
2896000710,560000,4,2.5,2520,11240,1,1440,1080,1977
9238900060,529000,3,1,1590,6420,1,1590,0,1944
1081310060,375000,5,2.5,2100,14858,1,2100,0,1970
3256400060,325000,4,2.75,2090,9240,1,2090,0,1949
8914200060,583000,4,2.5,3390,10519,2,3390,0,1990
0732000160,330000,2,1,790,9784,1,790,0,1932
1592080060,262000,3,2.5,1970,8727,2,1970,0,1995
7852190320,555000,4,2.5,2870,6776,2,2870,0,2004
7950303270,585000,2,1,1110,6000,1,1010,100,1951
7853340960,425590,3,2.75,1940,3088,2,1770,170,2008
7312900060,235000,2,1,720,4840,1,720,0,1947
1231001090,362362,2,1,710,4000,1,710,0,1909
1545805460,252000,3,2,1370,7500,1,1370,0,1997
1473120390,439000,4,2.5,2690,9551,2,2690,0,1992
1657300070,465000,4,2.25,3360,10810,2,3360,0,1988
0104501040,249900,4,2,1500,7854,1.5,1500,0,1983
9345400350,665000,2,2.5,2600,5000,1,1300,1300,1926
2592400400,370000,3,1.75,1160,8774,1,1160,0,1972
6788200295,620000,2,1,1430,3000,1.5,1300,130,1929
7308900445,375000,3,1,1870,7671,1,1720,150,1937
3034200435,552625,4,2,2560,9390,1,1280,1280,1957
3755000060,315500,3,1,1160,10500,1,1160,0,1966
7524950710,620000,2,1.75,1680,8187,1,1680,0,1983
6071200400,510000,4,2.5,2010,9075,1,1310,700,1959
1939000030,652500,4,2.5,2540,38677,2,2540,0,1987
6979900370,574000,4,2.5,3240,22795,2,3240,0,1998
3303860160,430000,3,2.5,2670,12806,2,2670,0,2010
6413100311,390000,3,2,1080,7236,1,1080,0,1947
1232002015,466500,3,1,1430,3840,1,950,480,1945
5116060030,315000,2,2.25,1290,2436,2,1290,0,1984
1898700310,220000,4,1.5,1240,9600,1,1240,0,1971
1079600270,325000,3,1.75,1840,17286,1,1440,400,1978
1073100030,365000,3,1,1120,8443,1,1120,0,1953
1157200189,356000,3,3.5,2100,12384,2,2100,0,1980
3822200105,380000,4,1.75,2030,12518,1,1610,420,1950
8121200700,579000,4,2.25,2030,8764,2,2030,0,1983
4221900030,682000,2,1,890,5000,1,890,0,1943
9475200030,499000,3,1.75,1750,12325,1,1470,280,1968
3585220070,333760,3,1,1300,5880,1,1300,0,1968
8644220070,745000,4,2.5,2650,18903,2,2650,0,1994
9225900055,380000,3,1.75,1750,10870,1,1750,0,1968
1972202010,435000,3,3,1440,1350,3.5,1440,0,2005
9547200340,520000,3,2.75,1700,3264,1,1060,640,1919
2481630030,965000,4,2.5,3920,41206,2,3920,0,1988
3092000030,270000,3,2.25,1470,16728,1,1350,120,1959
3592500340,1.1e+006,5,2.75,2520,4643,1.5,2120,400,1916
3447000060,577500,3,1.75,2140,13286,1,1220,920,1964
2767704860,650000,3,1.75,1550,5000,1,1250,300,1911
4141000060,1.2275e+006,4,2.5,3180,10319,2,3180,0,1986
7767000060,1.9e+006,5,4.25,6510,16471,2,3250,3260,1980
2061100390,475000,2,2,1440,3720,1.5,1440,0,1983
4388000260,200000,3,1,1150,10132,1,1150,0,1970
7787110510,397000,4,2.5,2320,11717,2,2320,0,1997
4024100982,383610,3,2,1230,8450,1,1230,0,1989
2621420060,275000,4,2.5,2060,5742,2,2060,0,1999
4319200060,840000,3,2,2783,11177,2,2783,0,1910
2473480310,365000,4,2.5,2140,7350,2,2140,0,1985
3629960060,362000,3,2.75,1420,955,2,1160,260,2004
7857000732,350000,3,1.75,2090,6258,1,1390,700,1956
7805600070,200000,2,1.75,1320,13052,1.5,1320,0,1980
0109200140,299000,4,2.5,2300,8100,1,1360,940,1979
3224059033,555000,4,1.5,3050,82764,1,1650,1400,1966
0868002015,1.326e+006,3,2.25,2960,8330,1,2260,700,1953
0321100260,896000,5,2.75,2520,16100,1,1570,950,1960
2325039084,550000,2,1.75,1740,7290,1,1280,460,1950
2126049083,324500,2,1,1300,6617,1,1300,0,1986
3298400350,312500,3,1,1170,7350,1,1170,0,1960
7558800240,485000,4,3.25,1946,17786,2,1946,0,1990
5100402782,511000,2,1,1250,5413,1,1250,0,1923
5466310060,139500,2,1.5,1230,1561,2,1230,0,1983
8079010310,464000,4,2.5,2180,7203,2,2180,0,1989
8581200240,255000,3,1.75,1740,8800,1,1140,600,1978
7853250070,679975,4,2.5,3830,4644,2,2900,930,2004
7785000260,624800,3,2,2250,14274,1,1500,750,1964
3525069037,920000,3,2.75,2590,223027,2,2590,0,1983
4217401180,1.365e+006,3,2.5,2090,6000,1.5,2090,0,1928
8861700030,510000,3,1.5,2400,10275,1,1540,860,1964
2287400030,289659,4,2.25,2260,7200,2,2260,0,1984
7852010510,585000,4,2.5,2910,6250,2,2910,0,1999
5104512180,555000,5,3,3640,6930,2,3640,0,2004
9201000030,940000,4,2.75,3770,24897,2,2550,1220,1964
7199340560,460000,3,2,1600,7350,1,1600,0,1979
5561700340,319000,3,2.5,2110,7434,2,2110,0,1978
1657530350,280000,3,2.5,1720,1916,2,1720,0,2005
9423800030,250000,3,1,1100,7470,1,1100,0,1917
1939100560,749950,4,2.5,2620,8312,2,2620,0,1990
0626059276,458000,5,2.5,3090,23265,1,2990,100,1957
7852020800,465000,3,2.5,1890,4808,2,1890,0,2000
1994200012,580000,3,1.75,1850,2797,1,1150,700,1977
6626100260,700000,4,2.5,3100,36562,2,3100,0,1994
4166800320,350000,4,2.5,2506,7206,2,2506,0,2007
5490210200,456000,4,1,1700,7689,1,1080,620,1977
5067400162,290000,3,2,1550,18958,1.5,1550,0,1983
4306500070,475000,4,2.75,2200,16288,1,1290,910,1980
5416500260,285000,3,2.5,1890,3629,2,1890,0,2005
1446800710,309000,3,1,1140,6400,1,1140,0,1962
2324800350,860000,4,2,3740,32417,2,3740,0,2000
6648500390,219000,3,2.25,1940,6500,1,1440,500,1979
8078440140,546500,3,2.5,2130,7199,2,2130,0,1990
2624049050,338000,2,1,1470,5566,1,770,700,1919
1862400226,505000,2,1,1070,8130,1,1070,0,1942
4046700140,340000,4,1.75,1680,15084,1,840,840,1979
3066410810,678000,3,2.25,2730,10675,2,2730,0,1990
5453700140,800000,3,1.75,1890,10292,1,1890,0,1969
2648500030,112000,1,1,1080,3230,1,1080,0,1963
4167100240,252000,3,1.75,1440,16819,1.5,1440,0,1925
2460700030,335000,4,2.75,2540,7210,1,1600,940,1979
0682000030,610000,3,2,2300,13418,1,1430,870,1955
9211500560,245000,3,2,1690,6790,1,1360,330,1979
3211800140,493500,3,1.75,1800,16026,1,1390,410,1972
2193340260,596500,4,2.25,1770,8505,2,1770,0,1986
3419600125,245000,3,2,1190,4072,1.5,1190,0,1907
1357300240,333500,3,1.75,1320,7200,1,1320,0,1977
3876820140,373000,3,1,1290,8974,1,1290,0,1976
9526600710,759900,4,2.5,3000,5639,2,3000,0,2008
2291400350,317000,3,2.25,1358,1204,3,1358,0,2007
9834200390,670000,3,1.5,1220,4080,1.5,1220,0,1914
7631200310,985000,2,2.5,2720,26761,2,2720,0,1990
3438500796,310000,3,1.5,1060,6954,1,1060,0,1983
0011520200,750000,4,2.5,3020,13122,2,2540,480,1997
0339600070,408000,3,2,1640,3440,2,1640,0,1987
0629810800,900000,5,3.75,3870,8225,2,3870,0,1998
8665900070,460000,4,2.25,2860,15054,1,1460,1400,1957
9282800075,339000,4,2.5,1740,6000,1,1740,0,1952
0809002675,660000,3,2,1140,6000,1,1140,0,1909
6305900350,449950,4,3,3290,10783,2,3290,0,1990
1180002075,235000,3,1,1210,6000,1,1210,0,1930
8832900135,769000,5,2.25,3320,13138,1,1900,1420,1964
8682230400,428000,2,2,1350,3900,1,1350,0,2003
9560800390,445000,3,2.25,1990,7340,2,1990,0,1984
2558630350,462000,4,2.5,2060,6958,1,1220,840,1974
7517500310,775000,3,1,1460,6198,1.5,1460,0,1916
4141400030,605000,4,1.75,2250,10108,1,2250,0,1967
8570900162,193500,2,1,950,15996,1,950,0,1946
6837820030,389950,4,2.5,3140,8060,2,3140,0,1991
0098030400,790000,4,3.5,3560,6098,2,3560,0,2006
7312400030,442000,2,1,1410,5000,1,940,470,1918
5452800800,890000,4,2.25,2770,13500,2,2770,0,1974
7889000125,235000,3,1,1864,6978,1,1864,0,1958
5101402276,495000,4,1.75,1930,6720,1,1130,800,1959
1621069045,600000,4,2.5,3870,50965,2,3870,0,2007
1370800935,1.4e+006,3,2,2020,5500,1.5,1790,230,1937
7522600030,251000,3,2,1300,8400,1,1300,0,1967
0123059046,471000,4,2.25,3410,57063,2,2410,1000,1978
5201000030,597000,4,2.5,2370,41338,2,2370,0,1995
8965500030,804000,5,3.5,2770,9305,2,2770,0,1985
4019300030,357000,3,1.75,1250,17493,1,1250,0,1972
8929000030,419990,3,2.5,1690,1689,2,1150,540,2014
7880020030,725000,4,2.5,3040,35201,2,3040,0,1987
0806800400,275000,3,2.5,2710,5733,2,2710,0,2003
7327500270,445000,3,2.25,1190,13630,1,1190,0,1984
8568010310,510000,3,2.5,2300,27566,2,2300,0,1995
1126049105,330000,4,1,1360,13372,1,1360,0,1955
3438501662,270000,3,1,1500,5605,1,750,750,1942
0293000036,495000,4,2,1610,4770,1,1230,380,1941
2648000071,225000,4,1.75,1420,10300,2,1420,0,1950
5273200060,716528,3,1.5,1750,5400,1,1050,700,1952
2025701360,260000,3,2.5,1510,6095,2,1510,0,1991
7787120260,471000,4,2.5,2330,9928,2,2330,0,1998
4154305085,690000,5,3.5,2690,4800,2,1930,760,1919
0967000400,548000,5,1.5,1700,7200,1.5,1700,0,1937
5101401816,505000,3,1,1020,5410,1,880,140,1928
3755000310,325000,3,1,1160,11799,1,1160,0,1966
7300200400,682000,4,2.25,2450,34092,2,2450,0,1980
1795920350,605000,3,2.25,2010,10760,2,2010,0,1985
3530440140,276200,2,1.75,1370,4495,1,1370,0,1975
6690500060,530000,3,1,1370,4040,1.5,1370,0,1906
3568200060,245000,3,3,1990,9600,1,1440,550,1988
3530200160,654950,4,2.5,2790,45902,2,2790,0,1987
0040000228,221900,2,1,780,6727,1,780,0,1939
3878900270,466000,4,2,2240,4508,1,1340,900,1926
8029600400,383150,3,2,2210,6387,1,2210,0,2003
4083300510,657100,4,1,1390,4240,1,1050,340,1924
1026069155,539000,3,2,1800,43995,2,1800,0,1988
3298600340,400000,6,3,3320,15600,1,1660,1660,1977
1921059235,215000,4,2.5,1960,11600,1,980,980,1931
2887701420,489000,2,1,850,2850,1,850,0,1927
2553300270,649000,4,2.5,2980,12764,2,2980,0,1994
6206100075,700000,4,1.75,1980,10800,1,1320,660,1953
1397300055,268500,2,1,790,8424,1,790,0,1953
1357900060,515000,3,2.5,1800,5001,2,1800,0,1996
9346700030,685000,4,2,2260,10800,1,2260,0,1978
0730000139,305000,2,1.5,800,2142,2,800,0,2006
4219400465,950000,4,2,2490,4600,1.5,2090,400,1926
8947250060,292500,4,2.5,1610,4568,2,1610,0,2006
3293700496,270000,4,1.75,1850,7730,1,1100,750,1956
3293700496,450000,4,1.75,1850,7730,1,1100,750,1956
2921700060,535000,4,1,1920,6480,1.5,1920,0,1920
3629870200,550000,3,2.5,1740,3082,2,1740,0,2000
6909200335,457500,3,2.25,1430,2003,2,980,450,1996
8945100320,136500,3,1.5,1420,8580,1,1420,0,1962
8945100320,224097,3,1.5,1420,8580,1,1420,0,1962
6792200282,254000,3,2.5,1560,10608,2,1560,0,1994
1471701170,335000,4,2.25,2030,13500,1,1230,800,1963
8564850200,594950,5,2.5,3280,6553,2,3280,0,2012
1471610070,350000,3,1.75,1360,18123,1,1360,0,1983
3384300160,169950,3,1,1180,9832,1,1180,0,1970
6139800390,432500,3,2.5,1940,10800,1,1340,600,1979
8819900270,440000,2,1.75,1300,4000,2,1300,0,1948
8944290200,233703,3,2.25,1650,3788,2,1650,0,1985
4057300030,310000,3,1.5,1140,3292,2,1140,0,1988
1277000240,735000,3,2.5,2540,6762,2,2540,0,1998
3345100002,730000,4,2.75,3440,8150,2,3440,0,2014
0179000505,257000,3,1.75,1800,9000,1,1200,600,1961
1972200751,485000,2,2.25,1260,1240,3,1260,0,2004
0868002080,899000,4,2.25,2370,6000,1,1440,930,1959
4426600125,279000,3,1,1520,8055,1.5,1520,0,1952
1683500140,225000,4,2,1750,7245,1,1050,700,1974
1689401230,1.355e+006,3,1.5,2680,4775,2,1880,800,1913
7852060370,355000,3,2.5,1590,4242,2,1590,0,2000
3876200060,382500,4,1.75,1560,8700,1,1560,0,1967
2571910260,324360,3,2.5,2000,9669,2,2000,0,1992
8731900640,315000,3,1.75,2380,10450,1.5,2380,0,1966
1826049094,426000,2,1,2230,11472,2,2230,0,1951
2345700260,395000,5,2.5,2820,6305,2,2820,0,2003
3622069050,212644,3,1,1570,9650,1.5,1570,0,1922
3342100160,510000,3,3,1845,5100,2,1845,0,1947
2422049104,85000,2,1,830,9000,1,830,0,1939
2422049104,235000,2,1,830,9000,1,830,0,1939
6600350140,295000,4,2.5,2030,5754,2,2030,0,2001
0510003230,720001,3,2.5,1430,2200,1.5,1430,0,1910
1995200200,313950,3,1,1510,6083,1,860,650,1940
1995200200,415000,3,1,1510,6083,1,860,650,1940
2473480350,305000,3,1.75,1610,12247,1,1610,0,1981
1189000700,625000,3,1.5,1600,4128,1.5,1250,350,1906
7923700030,490000,3,1,1420,11040,1,1420,0,1961
1796360340,269950,3,2,1660,8641,2,1660,0,1987
0625059036,2.7e+006,5,4,4230,27295,2,3230,1000,1949
5694500200,829000,4,3,3310,4500,2.5,2910,400,1900
0224069114,635000,4,2.5,2470,77550,1,2470,0,1987
5379802871,217500,3,1,1040,9750,1,1040,0,1959
1311600030,270000,4,1.75,1850,7350,1,1050,800,1965
0669000350,1.245e+006,3,3,4610,8400,2,2790,1820,1947
2494000070,480000,4,2.5,2480,5100,2,2480,0,2007
2771600350,575000,3,1.75,2130,6500,1,1170,960,1954
1091310140,426950,4,2.75,2350,5589,2,2350,0,2001
1450100390,125000,3,1,920,7314,1,920,0,1960
1450100390,208000,3,1,920,7314,1,920,0,1960
2473250400,325000,4,2,1780,10622,1,900,880,1976
1420700030,597157,7,4,2690,10880,1,2690,0,1960
3630110340,728725,4,2.5,3010,3120,2.5,3010,0,2006
1313000240,708000,5,2,3180,10800,1,1910,1270,1968
1441600160,1.3e+006,4,3,4120,14021,2,4120,0,2005
8807600140,405000,3,1,1280,11625,1,1280,0,1977
8928100125,550000,4,2.75,1690,6090,1.5,1400,290,1945
7853302180,451000,4,2.5,2320,5375,2,2320,0,2006
9325200160,540500,5,3.75,3090,7415,2,3090,0,2014
0098001000,1.025e+006,5,3.5,5050,16500,2,5050,0,2001
3306200240,218000,4,1,1640,10455,1,950,690,1963
7436500060,562000,4,2.25,2170,7007,1,1540,630,1974
1022059032,401500,4,2.5,3140,94525,2,2280,860,1977
1523049083,196700,2,1,1090,9994,1,1090,0,1954
9346920070,583000,3,1.75,1930,10183,1,1480,450,1975
5709200030,309900,5,2.5,2100,17825,1,1400,700,1974
5104470070,485000,4,3,3110,18843,2,3110,0,1995
3330500075,465000,3,1,930,3348,1,930,0,1926
0200800200,595000,4,2.25,2050,8372,2,2050,0,1984
1432400570,254000,3,1,1160,7560,1,1160,0,1958
1552510160,488500,3,2.75,1820,9490,2,1820,0,1994
2473460860,260000,4,2.5,2110,8990,2,2110,0,1977
7812800681,166000,2,1,870,8487,1,870,0,1944
0579000550,440000,2,1.5,1080,6760,1,1080,0,1923
2916200138,375000,3,2,1260,7560,2,1260,0,1943
6821100125,529500,2,1,900,4800,1,780,120,1944
1529300135,338000,2,1,750,6439,1,750,0,1934
4124000320,335620,3,2.25,1800,15903,1,1340,460,1986
1775910370,464000,4,2.25,2220,15232,1,1690,530,1978
4365200505,354000,2,1,1390,7740,1,1390,0,1925
7960100030,601000,4,3.5,2160,3600,2,1660,500,1998
9264900350,285000,3,2.25,1840,9040,1,1370,470,1979
0955000060,462500,2,2,1690,4200,2,1690,0,1906
5205000160,350000,4,2.5,2650,10459,2,2650,0,1989
6145600955,329000,4,1,1120,3844,1,1120,0,1972
2472950350,312500,4,2.5,2500,11983,1,1320,1180,1984
9475710060,370000,4,2.5,2220,5338,2,2220,0,2001
1112700060,399900,3,1.75,1260,12750,1,1260,0,1979
0066000140,398000,3,1,1480,6550,1.5,1480,0,1925
1021000060,550500,2,1.5,930,7400,1,830,100,1909
4154304740,709000,3,2.75,2780,7200,1.5,1870,910,1913
7972604215,402000,5,2.75,2770,7620,1,1700,1070,1965
7979900126,450000,3,1.5,1530,23660,1,1530,0,1952
2821100125,524000,3,2.25,2140,6720,1,1440,700,1961
2323089065,800000,4,2.75,4600,322188,1,2400,2200,1989
6623400187,185000,4,1,1760,8906,1,1230,530,1966
6623400187,365000,4,1,1760,8906,1,1230,530,1966
0325049234,925000,4,2.5,3110,11422,2,3110,0,1989
8016300240,714000,3,1.75,2260,11781,1,1520,740,1968
7955040160,495000,3,2,1460,9759,1,1460,0,1972
6414600232,535000,3,2.25,2050,6648,1,1230,820,1990
1824059070,880000,4,2.5,2340,10800,1,2340,0,1953
6031400013,150000,3,1.5,1230,8056,1,1230,0,1949
9557300570,554500,3,2.25,1880,6565,1,1420,460,1972
4443800960,520000,3,1.75,1280,3880,1.5,1280,0,1916
7203220310,839990,4,2.75,3660,5637,2,3660,0,2014
7202330030,500000,3,2.5,1650,5683,2,1650,0,2003
3353404510,305000,2,1,1960,186872,1.5,1960,0,1936
6064800550,247800,3,2.5,1580,2170,2,1580,0,2003
1786630160,344200,4,2.5,2490,5812,2,2490,0,2000
3709500140,459950,4,2.5,2000,6107,2,2000,0,2003
7942300070,229900,4,1.75,1550,9899,1,1550,0,1967
7525300240,750000,4,2.25,2820,9602,1,1950,870,1974
3579000800,509000,4,2.5,2600,9355,1,1840,760,1983
3577000116,680000,4,1,2200,12137,1,1640,560,1956
5490210320,661500,5,2.5,2500,7200,1,1490,1010,1977
3259400030,370000,2,1,1270,1399,3,1270,0,2000
3134100162,785000,4,2.75,2900,17400,1,2410,490,1978
9277700075,355000,2,1,840,6720,1,840,0,1952
1172000135,446000,4,2,1940,6350,1,970,970,1951
1025059094,830000,5,3.5,3490,21780,2,3490,0,1996
6705900070,324000,3,2.5,1940,8347,2,1940,0,1990
9522400350,500000,4,2.25,2490,23478,2,2490,0,1981
0650000030,745000,3,1,1390,9112,1,1390,0,1951
8712100435,1.197e+006,4,2.5,3940,4407,2,2620,1320,1921
1530900560,385000,2,2.5,1760,3710,1,1130,630,1988
6868200060,565000,3,2.25,2560,8040,1,1510,1050,1958
7767400060,465000,4,2.5,2300,7314,1,1420,880,1979
0820000012,401000,3,3.25,1770,1977,3,1770,0,2001
3308030060,385000,3,1.75,2310,11200,1,1630,680,1978
9485750240,395000,3,2.5,2310,4930,2,2310,0,1989
3826000550,245000,5,1.5,2000,8100,1.5,2000,0,1946
7960100075,500000,3,2,1540,3600,1,890,650,1994
7461400400,334000,5,1.75,2590,6720,1,1750,840,1979
6206100030,550000,3,1,980,10960,1,980,0,1953
7888300340,216000,3,1,1730,7950,1,1180,550,1961
1180000885,340500,3,2.5,3070,5871,3,2510,560,1928
1081330060,375000,4,2.25,2100,12738,2,2100,0,1975
9536600105,600000,3,2.75,2080,16740,1,1580,500,1966
2783100160,375000,4,1.75,1890,8000,1,1250,640,1960
9297301505,536500,4,1.75,2000,4000,1.5,1450,550,1926
5561300340,599900,3,3,3030,35123,2,1760,1270,1984
1794500695,750000,2,1.5,1110,3600,1,1110,0,1904
2797500030,355000,3,1,1650,10075,1,1170,480,1955
9214400125,590000,3,2,1410,6413,1,910,500,1947
6821101895,680000,2,1,2140,6000,1,1070,1070,1946
8079040140,429000,3,2.5,1860,11122,2,1860,0,1994
7518507580,581000,2,1,1170,4080,1,1170,0,1909
3863800030,463800,3,1.5,980,7770,1,980,0,1968
3303850390,2.983e+006,5,5.5,7400,18898,2,6290,1110,2001
7128300060,443000,5,1.75,1650,3000,1.5,1650,0,1902
0104510340,276200,3,2.5,1480,7210,1,1180,300,1986
0114101505,630000,5,3.5,4060,8309,2,2960,1100,2001
1928300350,570000,3,1.75,1370,3300,2,1370,0,1927
1370800560,979700,4,2.25,2480,6000,2,2380,100,1929
8825900310,730000,4,2.5,2030,4080,1.5,1730,300,1921
4167700240,268450,5,2.25,2200,9600,1,1100,1100,1963
2138800060,490000,3,1.75,1770,7508,1,1270,500,1962
0579002220,808000,3,2.5,2550,6240,1,1750,800,1957
9144300060,350000,3,1,1250,9786,1,1250,0,1969
4441300416,695000,4,1.75,2390,5880,1,1390,1000,1957
3225069301,1.228e+006,4,2.5,5730,44947,2,4280,1450,1991
6620400400,309950,1,1,1120,11800,1.5,1120,0,1950
3361402041,134000,3,1,1270,8508,1,650,620,1942
1150000340,645500,4,2.5,2390,9638,2,2390,0,1988
7015200800,750000,3,2,1760,5488,1.5,1540,220,1927
5316100106,1.399e+006,3,2.5,2560,3600,2,2110,450,1967
3102700160,344900,4,1.75,1820,7700,1,1100,720,1955
8129700565,601450,2,3.25,1840,1500,3,1840,0,2001
9839300125,575000,4,2,1810,4400,2,1700,110,1909
2011400710,405000,3,1.75,2470,9620,1,1570,900,1962
1522700060,518000,4,2.75,2520,14021,2,2520,0,1999
7568700135,265000,2,1,1600,7936,1,1600,0,1947
8651411070,180000,3,1,1280,4875,1,1280,0,1969
2616700520,285000,3,2.5,1590,9736,2,1590,0,1985
4415600030,433000,3,2.75,2000,7200,1,1000,1000,1954
1072000260,399000,3,1.75,1780,11440,1,1350,430,1977
8045000340,565000,3,2.5,1700,7210,2,1700,0,1966
0042000127,406500,3,1.5,1970,10080,1,1970,0,1966
2205500335,420000,4,1.75,1940,11500,1,1090,850,1955
1814800060,965000,4,3.5,3290,5559,1.5,2290,1000,1906
3885804260,1.375e+006,4,3.5,3500,9523,2,2460,1040,1996
9264920270,353950,5,2.25,3260,7969,2,3260,0,1982
1778350160,847700,5,3.25,4230,10260,2,3860,370,1996
0623049185,185000,5,1,1590,6700,1.5,1090,500,1942
1180002735,269000,2,1.5,1010,6000,1,1010,0,1923
3876313100,422800,3,1.75,1820,8400,1,1340,480,1976
0826000295,379950,2,1,870,7500,1,870,0,1947
3876311860,525000,3,2,1620,7800,1,1200,420,1969
2224079050,810000,4,3.5,3980,209523,2,3980,0,2006
8945000260,209950,4,1,1630,8400,1,1630,0,1962
2768301182,439950,3,2,1230,1613,2,1010,220,2003
1827200135,554820,4,2,3510,12905,1,2210,1300,1965
4307300520,359000,4,2.5,2160,4500,2,2160,0,2002
6632900354,242500,3,1,1020,5870,1,1020,0,1941
9540100060,330000,3,1.75,1590,9417,1,1590,0,1954
2424059116,740000,3,2.25,3440,44374,2,2190,1250,1979
0007600125,630000,5,1,3020,4800,2,3020,0,1901
0579003645,750000,3,1.75,2280,7800,1,1360,920,1941
3224600340,695000,4,2.5,2790,6540,2,2790,0,1999
7129800036,109000,2,0.5,580,6900,1,580,0,1941
3294700421,389000,3,1.5,2030,10075,1,1080,950,1961
6746700565,447000,2,1,850,2700,1,850,0,1924
0742000060,1.2e+006,3,2,2480,13310,1,2480,0,1955
0626059155,315000,3,1.75,1010,12000,1,1010,0,1977
1150000200,640000,3,2.5,2420,8244,2,2420,0,1988
1592000640,570000,3,2.25,2180,9246,2,2180,0,1984
3123039171,495000,3,2.75,1830,208216,2,1830,0,1997
3876312010,449500,5,2.75,2040,7488,1,1200,840,1969
5364200695,1.0845e+006,4,2.75,2640,5000,2,1840,800,1943
7979900806,294950,2,1,1060,7868,1,1060,0,1952
8643200060,170500,3,1,1640,13939,1,1040,600,1960
7972602080,312000,4,1,1190,7620,1.5,1190,0,1926
7212650200,350000,3,2.5,2180,15484,1,2180,0,1992
8079100140,690000,4,2.5,2120,8448,2,2120,0,1989
8091800140,375000,4,2.5,2210,9427,2,2210,0,1999
7214720510,575000,4,2.5,2510,47044,2,2510,0,1987
9346920260,646000,4,2.25,2500,8500,1,1600,900,1978
3750603471,239950,3,2.5,1560,4800,2,1560,0,1974
3438502501,400000,5,2.5,2510,7525,1.5,1710,800,1929
1775500310,455000,4,1.75,3060,94089,1,3060,0,1958
1796380310,240000,3,2,1310,8069,1,1310,0,1990
1118000320,3.4e+006,4,4,4260,11765,2,3280,980,1939
3362401000,695000,3,2,2500,4080,1.5,1680,820,1922
7454000990,304950,2,1,670,6720,1,670,0,1942
5244800125,650000,3,1.75,1840,2310,1,1140,700,1914
0789000520,402500,3,1.75,1480,2211,2,1480,0,1995
7852000340,482000,3,2.5,2420,7307,2,2420,0,1998
8827900560,655000,3,2,1820,4480,1,1120,700,1923
2768000390,577000,5,2.75,1940,5000,2,1940,0,1951
2475200370,350000,3,2.5,1630,5996,2,1630,0,1986
8731981940,415000,4,2.25,2520,8000,1,1680,840,1970
3626079032,396400,4,2.5,2120,215186,2,2120,0,1983
6646200710,654300,3,2.5,2490,8582,2,2490,0,2000
7167000060,774950,4,2.5,3410,179419,2,3410,0,2004
5249802085,855000,4,2,2380,10800,2,2380,0,1925
3528900060,1.145e+006,3,2.5,2490,4000,2,1670,820,1918
6056100295,330000,2,2.5,1240,1546,2,1240,0,2007
9392200030,290000,4,2.25,1900,10950,1,1400,500,1959
0936000055,519500,3,3,2390,19454,1.5,2390,0,2008
3840700560,450000,3,1.75,1810,12600,1,1400,410,1977
0333100295,3.12e+006,3,3.5,4490,56609,2,4490,0,1993
0133000127,265000,3,1,1620,9450,1.5,1620,0,1928
4221970060,359000,4,2.5,2640,7883,2,2640,0,1990
1732800310,2e+006,4,3.75,2870,4500,2,2510,360,2012
2025069037,1.05e+006,4,2.5,3250,48037,1,2030,1220,1985
2516000486,402500,2,1,800,2280,1,800,0,1946
4037400070,450000,3,1.75,1360,5445,1,1360,0,1957
3375300370,262500,5,2.25,1950,8086,1,1130,820,1980
1682500240,285000,4,2.25,1970,7200,2,1970,0,1979
6806100340,290000,3,2.5,2020,4861,2,2020,0,2005
8682281070,752500,2,2.5,2280,6230,1,2280,0,2005
8691330260,820000,4,2.75,3540,13515,2,3540,0,1998
0869700140,292000,3,2.5,1560,2740,2,1560,0,1999
7221400320,213000,2,1,750,6089,1,750,0,1937
7454001125,400000,4,3,2240,7035,2,2240,0,1942
7129304375,202000,1,0.75,590,5650,1,590,0,1944
0203100435,484000,1,0,690,23244,1,690,0,1948
6189200260,617450,3,2,1580,14398,1,1080,500,1981
1430800162,250000,3,1,1040,8000,1,1040,0,1956
2570300240,405000,5,1.75,1880,10000,1,960,920,1963
3294700320,325000,2,1,1070,8750,1,1070,0,1951
2976800700,301350,3,3,1860,7440,1,1040,820,1954
7625704340,425000,2,1.75,1550,7800,1,1050,500,1940
9238900390,460000,3,1,1860,6360,1,1470,390,1954
4139430310,938000,3,2.5,3090,10940,2,3090,0,1992
1402630270,348000,3,1.75,1720,8867,1,1320,400,1985
3735901600,435000,2,1,1260,4080,1.5,1260,0,1926
0739500270,227950,3,1.5,1120,11430,1,1120,0,1963
3566800125,425000,2,1,1250,5880,1,900,350,1948
2886200070,550000,3,2,1810,4064,1.5,1810,0,1925
3529300060,347500,3,2.5,1890,7053,2,1890,0,1992
3085001610,397000,4,1.75,2020,6000,1,1620,400,1959
9414500200,410000,4,1.75,1790,11875,1,1490,300,1969
8651611230,780000,3,3.5,3190,6776,2,3190,0,1998
8712100350,1.35e+006,4,3.25,3030,5164,1.5,2700,330,1925
7202350310,476000,3,2.25,1630,3070,2,1630,0,2004
1326059070,390000,3,1.75,1180,16552,1,1180,0,1967
1311900240,226500,3,2,1560,7000,1,1560,0,1968
7518503490,495000,3,2,1340,2550,2,1340,0,1984
6669200200,1.5e+006,5,3.25,2590,11500,1,2590,0,1968
3438501860,385000,3,1,1020,5950,1,880,140,1950
7852170570,535950,3,2.5,2370,5344,2,2370,0,2003
9290850060,910000,4,2.5,3170,32430,2.5,3170,0,1989
4206901505,465000,2,1,1120,4000,1,1120,0,1926
6600220550,495000,3,1.75,1440,11787,1,1440,0,1983
8699100160,250000,4,2,2170,5404,1.5,1470,700,1920
1068000520,1.225e+006,4,2.25,3490,6906,2,2280,1210,1928
2558610070,400000,4,2.25,1970,8941,2,1970,0,1973
1829300270,715000,4,2.5,2780,13521,2,2780,0,1987
7212650240,342000,3,2,2250,7757,1,2250,0,1992
3205200240,420000,4,1.75,1340,8400,1,1340,0,1967
1682000350,148226,3,1,1400,7360,1,1400,0,1968
7229900885,313000,3,1,1510,10369,1,1010,500,1968
7888000400,150000,3,1,1320,8220,1,1320,0,1959
0523049195,150000,2,1,820,10270,1,820,0,1954
1423400160,230000,2,1,1080,9435,1,1080,0,1958
1766600075,389100,2,1,840,5400,1,840,0,1948
1088020070,645000,4,2.25,2070,8720,1,1360,710,1974
7893200486,310000,3,1,1520,6500,1,990,530,1958
8929000060,351358,2,1.75,1210,1189,2,1210,0,2014
8146200070,1.7e+006,5,2.75,3810,9360,2,3810,0,2014
0624069050,1.565e+006,4,3.5,5370,323215,2,5370,0,2002
5318100935,850000,3,2,1540,3600,2,1540,0,1900
1313300340,470000,4,2.5,2310,14023,2,2310,0,1991
8032700070,770000,3,2.25,1870,1900,3,1870,0,2008
1072000240,366000,3,1.75,1840,11440,1,1340,500,1977
3904920390,545000,3,2.5,2060,7184,2,2060,0,1987
7345200400,205000,3,1,1010,8800,1,1010,0,1968
0923000270,405000,2,1,1020,8155,1,1020,0,1948
7016310270,467000,4,2.5,2220,7210,1,1270,950,1973
3650100105,392500,2,1,1050,4125,1,1050,0,1909
3761100240,901000,4,2.75,3030,18400,1.5,2360,670,1973
2126049277,500000,3,1.75,1800,7199,1,1300,500,1972
0253600160,384950,3,2.5,1860,3690,2,1860,0,2000
1623069046,1.7e+006,4,3.5,4070,336283,2,4070,0,2006
9235900030,245000,2,1,860,6120,1,860,0,1948
5451200370,1.165e+006,4,2.25,3080,10487,2,3080,0,1968
7338000270,184500,3,1.5,1280,3640,2,1280,0,1983
2115720270,269000,2,2,1540,5000,1.5,1540,0,1986
0011200070,570000,3,2.5,1530,3296,2,1530,0,1998
8732300060,850000,4,1.75,2350,11914,1,2350,0,1961
8651410240,209000,3,1,920,5200,1,920,0,1969
3342102220,327000,4,1.75,1840,5100,1,1840,0,1933
7663700783,369500,3,1.5,1650,9957,1,1100,550,1961
9477201370,440000,3,1.75,1760,8025,1,1230,530,1976
1923000370,947500,4,2.25,3290,12329,1.5,3290,0,1968
6841700070,510000,2,1,1270,4500,1.5,1270,0,1919
3293700105,385000,3,2,1600,10318,1,930,670,1941
8001450060,370000,5,3,2670,9920,1,1400,1270,1990
2877104316,660000,4,1.5,1960,4500,1.5,1960,0,1922
1522039105,729000,3,4.25,3300,308080,2,2520,780,1976
0924069190,440000,3,1.75,2000,11880,2,2000,0,1979
2722059185,445000,4,2.5,2360,81892,1,2360,0,2000
4073200575,460000,2,1,1430,12092,1,1430,0,1938
9542600070,516000,3,3,2330,7304,1,1300,1030,1971
2459960030,343888,4,2.5,2060,5607,2,2060,0,2002
0259800640,500000,4,1.75,2240,9886,1.5,2240,0,1965
1223039195,465000,5,1.75,2330,6450,1,1330,1000,1958
1545804510,302000,5,2.25,2180,7813,2,2180,0,1986
1921059045,195000,2,1,1280,7861,1,1280,0,1913
8078460070,640000,3,2.5,2140,8925,2,2140,0,1991
7525300260,502000,6,2.5,2890,8122,1,1630,1260,1977
4249400270,360000,3,2.5,1480,3851,2,1480,0,1998
0179000240,290500,4,2.5,1680,3000,2,1680,0,2003
8856004327,248000,4,3,2163,5883,2,2163,0,2006
8029550160,433000,4,2.5,2280,7568,2,2280,0,2001
5016001260,480000,2,1,820,4200,1,820,0,1980
1133000036,410000,3,1,1330,5000,1,1120,210,1957
5416510710,309950,4,2.75,2310,5000,2,2310,0,2006
1796380060,253000,3,2,1290,7372,1,1290,0,1990
1223089050,280000,3,1.75,1630,11800,1,1630,0,1971
7436900060,440000,3,1,1410,8925,1,1410,0,1958
2202500135,333000,5,1.75,1240,8936,1,1240,0,1954
0224069195,759950,3,2.5,3100,23790,2,3100,0,2002
9407101180,345000,3,2.25,2020,9000,2,2020,0,1979
6699950310,350000,4,2.5,2500,5831,2,2500,0,2007
5379800810,198000,2,1,790,14200,1,790,0,1951
0711000070,730000,3,1.75,2040,11294,1,1340,700,1952
5127001170,266200,3,1.5,1430,9600,1,1430,0,1966
0191100140,1.06e+006,4,2.5,2250,10160,2,2250,0,1967
6198400218,95000,2,1,1070,20450,1,1070,0,1948
3578400270,430000,3,1.75,1300,12731,1,1300,0,1981
9573120260,650000,4,2.25,2560,9731,2,2560,0,1973
2310110070,379900,3,2.5,2190,5071,2,2190,0,2004
6413600192,325000,2,1.5,940,1222,2,860,80,2004
4037500335,455000,4,2.25,1740,8449,1,1170,570,1958
5141000510,392000,4,3.75,2220,3797,1.5,1330,890,1917
3876311180,373000,3,1.75,1310,7811,1,1310,0,1976
5036300575,951250,5,3,2710,8227,1,1910,800,1953
0384000135,502000,3,2,1300,14350,1,1300,0,1955
0322059326,362500,3,2,1940,40588,1,1940,0,2000
9530101670,525000,2,1,1080,3500,1,1080,0,1924
5490220030,580000,4,2.5,2110,11680,1,1420,690,1977
2459500070,278000,3,2.25,1590,9425,1,1170,420,1985
7312400075,422500,2,1,910,4800,1,910,0,1923
7011200830,783200,4,2,1590,5400,1,990,600,1900
8691390860,715000,4,2.5,3290,6628,2,3290,0,2003
8929000350,472217,3,2.5,2010,2212,2,1390,620,2014
1322049335,244615,3,2.5,2060,4030,2,2060,0,1999
7715600070,385000,3,1.75,1560,14288,1,780,780,1944
2985800070,549995,3,1,1120,6600,1,1120,0,1943
0098000560,959900,4,3.75,3550,15151,2,3550,0,2004
0125059179,510000,6,4.5,3300,7200,2,3300,0,1980
7558800570,367000,3,1.75,2000,12669,1,1200,800,1965
9378700200,375000,5,3,2680,8410,2,1810,870,1990
2767603612,500000,2,2.25,1290,1334,3,1290,0,2007
2767603612,489000,2,2.25,1290,1334,3,1290,0,2007
3259400024,340000,3,2,1150,700,2,800,350,2000
7954000125,562000,3,1.75,1880,5978,1,940,940,1957
5535600640,489950,3,2.5,2400,7478,2,2400,0,2002
1313000710,652000,3,2.25,1920,9600,1,1560,360,1968
1786700240,472000,4,3.25,4350,7090,2,2870,1480,1999
2739200160,333000,4,2.5,1910,9244,1,1910,0,1963
2874600335,560000,3,1.5,2000,7350,1,2000,0,1953
3222049159,799000,4,3.5,3290,20107,2,2220,1070,1990
7856550240,860000,5,2.25,3480,9200,2,3480,0,1979
2817910030,449500,4,2.5,2410,55931,2,2410,0,1989
8649900160,692500,4,3,2820,11500,2,2820,0,1991
7856610160,925000,4,1.75,2710,11400,1,1430,1280,1976
3705000070,267500,3,2.25,2080,2856,1.5,1550,530,2003
2619950400,396800,4,2.5,2200,6018,2,2200,0,2010
7749500160,220000,4,1.5,1180,8058,1,1180,0,1969
3585300445,892500,3,1.75,2120,56192,1,1720,400,1959
2909700070,455500,3,2,1460,10311,1,1460,0,1975
2581900036,743000,3,1.75,2110,11250,1,2110,0,1961
5589900400,338000,4,1.5,1790,17925,1,1790,0,1951
0323089159,332000,3,1.75,1340,13115,1,1340,0,1978
5015000700,563225,3,1,2460,4000,1.5,1370,1090,1918
0624110860,1.15e+006,4,3.5,3760,20609,2,3760,0,1990
9521100465,645000,2,1,1240,5000,1,1000,240,1920
3275790140,739000,3,2.5,2750,16000,2,2560,190,1981
1313300400,435000,3,2.5,2530,13446,2,2530,0,1993
8670900140,995000,3,2.25,3200,3800,2,2650,550,1914
2540850070,520000,4,2.75,2020,7357,1,1350,670,1986
1921069068,400000,4,2.5,3030,180263,2,2030,1000,1987
3574800860,440000,3,1.75,2350,7641,1,1510,840,1978
5652600069,440000,3,1.5,1690,6010,1,1230,460,1946
4083302625,738000,3,1,1280,3900,1,1280,0,1921
0114100791,250000,3,1.5,1170,9848,1,1170,0,1963
9432900070,338150,4,2.25,2700,8580,2,2700,0,1992
7214820400,425000,3,2.25,1800,7371,1,1280,520,1979
2725069157,883000,4,2.5,3670,54450,2,3670,0,1999
1025079074,510000,3,2,2350,266151,1.5,2350,0,1983
0724069070,950000,4,1.75,3100,21303,1,3100,0,1962
2206700070,435000,3,1,1120,9656,1,1120,0,1955
8564500240,415000,5,1.5,1900,10226,1,1130,770,1961
7579200765,439000,2,2.5,1350,944,2,870,480,2004
7893205525,295832,5,1,1410,6400,1,960,450,1955
9320700400,285000,3,1.75,1560,9514,1,1560,0,1967
3226049045,350000,3,1.5,1090,5003,1,1090,0,1962
9828701741,489000,2,2.75,1465,972,2,1050,415,2006
7205510370,304500,3,2.25,1790,6930,1,1390,400,1974
8899000310,288000,3,1.5,1300,7313,1,1300,0,1968
6804600240,417000,3,1.75,1920,9512,1,1440,480,1980
2902201126,615000,3,3,1420,991,2,1040,380,2005
5536500200,730000,5,3.5,3760,4857,2,2820,940,2004
3530490160,178500,2,1,930,3447,1,930,0,1978
2008000550,300000,4,2,1580,9600,1,1050,530,1965
2045400075,415000,4,2.5,2170,8518,1,1350,820,1955
0616000200,452500,3,1.75,2040,15695,1,2040,0,1959
7852160310,1.01e+006,4,2.75,3430,15877,1,3430,0,2005
8079100640,653000,4,2.5,2160,7000,2,2160,0,1989
6662000070,715000,4,2.25,2060,5649,1,1360,700,1941
1928300640,541000,3,1.75,1410,4080,1.5,1410,0,1927
7888100240,245000,4,1.5,1850,7547,1.5,1850,0,1960
3034200516,547000,2,1,1370,10038,1.5,1370,0,1922
7504000510,750000,5,2.75,3330,12408,1,1740,1590,1976
9141100070,575000,5,2.5,1970,12375,1,1570,400,1959
0921059200,216000,3,1.75,1310,8670,1,1310,0,1984
3645100240,443000,3,1.75,1640,4579,1,1640,0,1916
4123800260,257700,4,2.25,1600,6202,2,1600,0,1986
7334401000,278000,3,1,1230,9440,1,1230,0,1978
2111010890,300000,3,2.5,2240,3691,2,2240,0,2003
4137070830,269100,3,2.5,2190,7904,2,2190,0,1995
7283900036,402500,3,1,990,10752,1.5,990,0,1929
0345700340,306888,2,1.5,1010,7719,2,1010,0,1981
4178300070,795000,4,2.5,2920,14210,2,2920,0,1978
3342103228,525000,4,2.5,2310,5573,2,2310,0,2003
5451300105,1.05e+006,3,2.5,3470,12076,2,2560,910,1988
5249803645,452000,2,1,1220,6000,1,880,340,1938
7326200030,350000,3,2.25,1550,5401,2,1550,0,2000
7227502075,410000,4,2.5,2070,6180,2,2070,0,2007
7011200160,595000,3,1.75,2060,3600,1.5,1180,880,1905
7202340390,499000,3,2.5,1690,4851,2,1690,0,2004
5412100240,340000,4,2.5,2550,7555,2,2550,0,2001
1245000685,1.065e+006,5,3.25,3370,7947,2,3370,0,2001
3222059187,460000,4,3,2230,52983,2,2230,0,1991
1822500270,345000,4,2.5,2382,5899,2,2382,0,2011
2310010270,280500,3,2.25,1620,7566,2,1620,0,1990
9547204930,704000,3,1,1140,6120,1.5,1140,0,1926
8137500400,545000,3,2.5,2140,40173,2,2140,0,1990
3343901242,335000,3,1.5,1900,7584,1,1900,0,1962
0486000510,1.325e+006,4,3,3370,7920,1,1860,1510,1988
0537000075,420000,3,2.75,2300,8000,1,1430,870,1965
3544400045,705000,4,2,2040,5050,1,1160,880,1937
9211520400,274900,4,1.75,1840,10528,1,1210,630,1990
2738600140,499950,4,2.5,2860,3345,2,2190,670,2004
3073500111,415250,3,1.5,1400,7550,1,1400,0,1953
7889000160,222000,3,1,990,7520,1,990,0,1958
1422059129,375000,3,2,3120,42247,1,2150,970,1980
9430000070,300000,3,2.5,1640,5707,2,1640,0,1995
2518400046,456700,3,1.75,2820,8879,1,1540,1280,1920
1315300070,925500,3,2.75,1970,5200,1.5,1970,0,1915
1081330030,375000,5,2.5,2840,15598,1,1470,1370,1975
4397010140,420000,3,2.5,2370,15375,2,2370,0,1993
8564700240,575000,3,2.5,2610,7301,2,2610,0,2004
0597000566,335000,3,2,1340,1951,1,670,670,1915
9828202030,428000,4,2,1300,7200,1,1300,0,1958
7214711260,655000,4,2.5,3340,34238,1,2060,1280,1977
5569620550,738000,3,3,2630,4896,2,2630,0,2006
6145601890,415000,5,1.75,1960,3748,1,980,980,1965
9269200831,392000,3,1,1090,6125,1,790,300,1945
6021502470,555000,2,1,1550,4600,1,1050,500,1941
0646910560,260000,3,2.5,1770,2677,2,1770,0,2005
2475900565,392500,3,1,1390,10500,1.5,1390,0,1940
4139430810,912000,3,2.5,2979,17313,2,2979,0,1993
2586800140,135000,2,1,830,7609,1,830,0,1943
0226059121,500000,3,2.75,1560,77536,1,1400,160,1978
7696610270,238000,3,1.5,1360,7488,1,1050,310,1975
4279900140,251000,4,2,1650,5974,1,860,790,1972
5422560810,406500,2,1.75,1510,5319,2,1510,0,1978
1657300270,433495,4,2.25,3010,10925,2,3010,0,1988
8648210140,265000,3,2.25,1510,6071,1,1150,360,1985
3034200247,360000,3,1.75,1950,7260,1,1520,430,1957
2204500550,425000,4,1,1800,12485,1,950,850,1955
7390400069,450000,2,2.75,2810,11205,1,1510,1300,1968
1077100070,449900,3,1.75,1760,8266,1,1760,0,1954
0423059360,345000,4,2.5,2040,5875,2,2040,0,2004
3316500200,612500,4,2,1690,35346,1,1690,0,1967
1328300990,317000,3,1.75,1530,7650,1,1530,0,1977
4443800505,585000,3,1.5,1810,3880,1.5,1310,500,1929
7327500200,455000,3,1.75,1180,14292,1,1180,0,1981
4054510310,1.035e+006,4,4,4090,51908,2,4090,0,1991
7525100060,497000,4,2.25,2250,3463,2,2250,0,1968
3065600270,226750,3,1.75,1070,6315,1,1070,0,1992
2881700273,385000,4,2,1820,7102,1,1220,600,1950
7889600685,205000,3,0.75,1080,5025,1,1080,0,1948
1137500070,745000,4,2.5,2760,13093,2,2760,0,1989
5104530810,371000,4,2.5,2550,4770,2,2550,0,2005
3905060070,545000,4,2.5,2080,8504,2,2080,0,1991
6450302545,443000,3,1,1280,5460,1.5,1280,0,1931
7972602435,287000,2,1,950,6350,1,950,0,1951
5423500240,194000,3,1,1050,7577,1,1050,0,1983
8074200160,265000,3,1,1800,7650,1,1800,0,1957
3317500070,1.135e+006,4,2.75,3840,10004,1,2110,1730,1963
6119700030,699950,4,3.25,3674,12793,2,3674,0,1987
2568800160,433000,4,1,1710,7000,1.5,1710,0,1950
2781250520,200000,2,1.75,910,2693,1,910,0,2003
7230200310,289571,3,1.5,1340,25160,1,1340,0,1968
4400900030,440000,4,2.75,2340,11034,1,1720,620,1967
4038300070,400000,3,1.5,1510,8360,1,1120,390,1960
5706000070,589000,4,2.5,2630,15000,2,2630,0,1962
0825069078,850000,5,2.25,3100,97661,2,3100,0,1986
0363000045,520000,3,1,940,3000,1.5,940,0,1903
1912100875,555000,2,2.25,1370,1248,2,1200,170,2000
7853230200,470000,3,2.5,2480,5082,2,2480,0,2004
9406500350,207000,2,1.5,1068,1158,2,1068,0,1990
5152960350,379750,4,2.75,2390,9650,1,1620,770,1976
6021500320,709000,4,1.75,2170,4600,1,1270,900,1950
7137910140,240000,3,2.5,1520,9864,1,1160,360,1993
6117500955,445500,4,1.5,2210,10497,1,1650,560,1953
0269001331,1.308e+006,5,2.5,3200,7863,1,1600,1600,1959
1023059190,210000,3,1.5,1160,10125,1,1160,0,1959
8961970560,603000,4,2.5,2670,5895,2,2670,0,1999
3066400710,720000,3,2.5,2520,10012,2,2520,0,1987
0795000765,92000,2,1,760,5500,1.5,760,0,1947
2767603535,600000,3,1.75,1310,5000,2,1310,0,1901
7774200070,725000,4,2.5,2750,13950,1,1380,1370,1948
4029400140,409950,5,2.25,1790,10300,1,1270,520,1961
1954400060,515000,3,2.5,1790,7167,2,1790,0,1989
2473002650,495000,4,2.5,2400,11640,1,1800,600,1968
5451220200,998000,4,2.25,2420,10200,2,2420,0,1973
1472700200,630000,3,1.75,1710,8767,1,1710,0,1986
1661000060,410000,3,1.75,2000,7480,1,1320,680,1972
2600110710,602000,3,2.25,1580,11580,1,1580,0,1979
2600110560,750000,4,2.75,2310,10232,1,1310,1000,1980
8617000060,711600,4,3,3580,9316,2.5,2370,1210,1991
8562720390,1.05e+006,4,4,4320,8709,2,3190,1130,2006
1137300890,700500,3,2.5,2560,35265,2,2560,0,1981
4104900340,710000,4,2.5,3220,18618,2,3220,0,1991
2616700560,250000,3,2,1660,13085,1,1010,650,1985
1061500510,350000,4,1.75,2420,8400,1,1620,800,1964
6411600370,475000,7,3.5,2870,29699,1,1520,1350,1961
4154302075,200000,2,1,830,7200,1,830,0,1920
1727500390,450000,4,2.25,1710,7000,1,1040,670,1972
2538410260,316000,5,2.5,2600,4641,2,2600,0,2005
9269200520,310000,1,1,670,4920,1,670,0,1920
7334400070,392000,3,1.5,1500,11975,1,1500,0,1970
1972200696,521000,3,3.25,1460,1254,3,1460,0,2000
2267000486,495000,2,2,1540,7110,1,960,580,1949
1311800560,209000,3,1.75,1250,8084,1,1250,0,1967
9542400075,809950,4,2,2230,9900,1.5,2230,0,1959
3223069065,400000,2,1.75,1800,224769,1,1420,380,1950
1724500030,415000,4,2.5,2400,7292,1,1530,870,1980
3751602797,411000,4,2,2370,76665,2,2370,0,1978
0809002030,825000,2,2,1830,3600,1,1230,600,1926
0993002127,436000,3,2.25,1480,1384,3,1480,0,2008
1473120140,460000,4,2.5,2620,8331,2,2620,0,1991
7849200861,281000,3,1,1300,5782,1,1300,0,1959
0269000030,976000,4,1.5,3120,7680,1,1660,1460,1956
2607760700,485000,4,2.5,2400,10364,2,2400,0,1995
7715801090,429000,3,2.5,1430,9240,2,1430,0,1984
1999600320,729000,3,2.5,2480,7428,2,2480,0,1990
4221250340,625000,3,2.5,2280,4757,2,2280,0,2003
3668000810,218500,3,1.75,1390,9328,1,1390,0,1987
2337300370,175000,3,1,1030,8395,1,1030,0,1960
1453602065,442500,3,1,1120,8200,1,1120,0,1938
3359500960,480000,3,2,1300,3000,2,1300,0,1986
6133100125,715500,3,2.25,2410,9668,1,1540,870,1965
8562600260,432500,3,1.75,1470,7350,1,1470,0,1963
2325069032,875000,5,4.25,4720,18741,2,3210,1510,2005
1223039235,605000,5,2.75,2910,13332,2,2910,0,1940
4139480350,1.688e+006,4,4,5000,12941,3,5000,0,2002
3348401382,318000,3,2.25,1690,12662,1,1090,600,1982
0164000267,311300,2,1,1000,7228,1,1000,0,1947
1099900030,325000,5,2.75,2400,7904,1,1450,950,1992
4139700260,795000,5,3.5,3330,3705,2,2610,720,2008
6071800310,558000,4,2.25,2060,10358,1,1320,740,1962
1321720140,370000,4,2.5,3090,18645,2,3090,0,1995
8078460320,598850,4,2.5,2350,7245,2,2350,0,1993
6388930570,515700,3,2.5,2180,9722,2,2180,0,1994
3709500060,458000,3,2.5,1870,5013,2,1870,0,2003
5469500640,583500,3,2.25,3530,13000,2.5,3530,0,1985
0293910070,653750,4,2.5,2460,4166,2,2460,0,2003
3158500340,299000,3,2.5,1650,4725,2,1650,0,2011
2617300200,532000,5,3,3480,57499,1,2340,1140,1976
0521049200,819000,3,2.75,3176,13391,2,2726,450,1985
7779200105,945000,4,2.25,2420,9000,1,2000,420,1967
8651500710,608700,4,2.5,2260,9696,1,2260,0,1983
0871000435,812000,4,2,2380,6122,1,1310,1070,1949
0217500140,464000,5,2.5,3400,8970,1,1700,1700,1959
9290850810,950000,4,2.5,3770,35081,2,3770,0,1989
6844700510,700000,4,2.5,2672,4297,2,2020,652,2005
1232001040,435000,3,1,1180,4219,1,1060,120,1939
3751601171,229500,3,1.5,1810,14400,1,1810,0,1954
6117502220,1.575e+006,3,3,2610,22672,1.5,2610,0,1952
4322300140,265000,3,2.25,1450,13439,1,1180,270,1963
1526059051,995000,2,2,1600,64468,1,1600,0,1950
3800000160,590000,3,2.5,2650,9380,1,1680,970,1975
1454600116,740000,4,2.75,2490,17833,2,1490,1000,1979
4174600055,360000,2,0.75,850,7710,1,550,300,1909
2594200566,548500,4,2,1820,7200,1,1300,520,1976
8825900465,599000,3,1.75,1960,4788,1,1090,870,1920
8562900310,615000,3,1.75,2350,20820,1,1800,550,1978
1446401555,292000,3,1.75,1320,6600,1,1320,0,1988
3528000140,899000,4,2.5,3720,30649,2,3720,0,1988
7625704500,500000,3,1.5,2210,6500,1,1030,1180,1912
3575302397,580000,3,2.5,1910,11550,1.5,1910,0,2003
6190500340,580000,4,2.5,2840,6268,2,2840,0,1998
0475000510,594000,3,1,1320,5000,1,1090,230,1920
7199340320,500000,3,2.5,2440,7600,1,1420,1020,1981
3904940140,550000,4,2.5,2420,8056,1,1680,740,1988
2310030390,275000,3,1.75,1180,6260,1,1180,0,1993
2591800340,390000,3,2.25,1820,7420,2,1820,0,1983
3505100126,1.25e+006,3,3,3760,8500,2.5,3060,700,1910
3361401977,250000,3,2.25,1560,15340,2,1560,0,1997
5422570260,405000,2,2.5,1790,5400,2,1790,0,1979
0100600320,213950,3,1,1430,7000,1,1430,0,1968
8099200030,232000,3,1.5,1390,11340,1,1390,0,1963
7140600055,207000,3,1,990,10800,1,990,0,1959
3422049276,310000,3,1.75,1880,30346,1,1880,0,1988
3157600240,540000,3,2.5,2520,5000,3,2520,0,1990
0091000135,750000,4,1.5,2060,4000,1.5,1580,480,1920
0423059369,392500,4,2.5,2150,7303,2,2150,0,2005
5152000030,305000,5,2.5,2500,12220,1,1690,810,1962
7732300390,735000,3,2.5,2390,9157,2,2390,0,1984
1954430390,575000,4,2.5,2400,6137,2,2400,0,1990
7891600260,175000,2,1,660,5000,1,660,0,1915
2329800140,291000,4,2.5,1580,6633,2,1580,0,1984
8653900070,791500,4,2.5,3250,8970,2,3250,0,1994
7740500070,475000,3,2,1880,9659,1,1180,700,1951
3352401090,238950,2,1,1190,11400,1,1190,0,1951
2767704756,470000,3,3.5,1280,1257,2,1040,240,2000
7504400710,420000,4,1.75,2380,15324,1,1610,770,1978
7787100390,440000,3,2.5,2040,7605,2,2040,0,1996
4240400140,656000,4,1.75,1440,4300,1.5,1290,150,1929
7202270570,559950,3,2.5,2120,4310,2,2120,0,2001
3037200045,600000,2,2,990,5416,1,990,0,1935
3750605247,255000,3,1,1710,12000,1,1710,0,1972
7972604425,210750,4,1.5,1840,7076,1.5,1840,0,1957
0809002610,485000,4,1,1150,2560,1.5,1150,0,1909
4123840570,390000,3,2.5,2250,8076,2,2250,0,1995
1081200070,405000,3,2.5,2460,12600,1,1810,650,1970
9274204100,462500,4,1,1540,4500,1.5,1540,0,1905
1072010510,435000,4,2.25,2210,14073,1,1630,580,1978
7202330160,440000,3,2.5,1440,5434,2,1440,0,2003
8731990700,299950,3,1.75,1790,7650,1,1790,0,1978
9828200746,440000,2,1.5,1120,1024,2,1120,0,1970
9407100310,312620,3,2.5,1260,11877,1,1260,0,1975
6817800510,372500,3,1.5,1180,12324,1,800,380,1981
7212680860,297262,3,2.5,1730,8076,2,1730,0,1994
3260000570,735000,4,3,2250,7245,1,1250,1000,1963
1139000400,430000,3,1.5,1550,5034,2,1550,0,1922
8649401000,241000,2,1.75,1070,9750,1.5,1070,0,1995
6600400260,201000,3,1,1460,9750,1,1460,0,1969
1797500435,570000,2,1,1060,4000,1,1060,0,1910
2155000160,538000,4,1.75,1840,9600,1,1220,620,1967
9526600340,729000,3,2.5,2440,4244,2,2440,0,2011
2205500030,331500,4,1.75,1700,14756,1,850,850,1955
2123049114,110700,2,1,680,8064,1,680,0,1941
8078050140,245000,3,2,1700,8448,1,1700,0,1996
7617500075,427000,3,1.75,2000,7111,1,1360,640,1956
0381000240,650500,4,1.75,2340,5940,1,1290,1050,1953
7568700260,335900,2,1,1120,7440,1,1120,0,1939
1370803925,535000,2,2,1510,5133,1.5,1510,0,1939
1250200786,360000,5,2,2120,2400,1,1080,1040,1906
7399300510,294900,3,2.25,1500,8100,1,1210,290,1968
5430300106,460000,2,1,1030,5934,1,1030,0,1928
2954400310,1.769e+006,4,3.5,5440,38900,2,5440,0,1990
9209900335,463000,2,1,1150,4400,1,1150,0,1905
1920079062,332000,5,1.5,2420,43560,1,1500,920,1962
7227800055,199500,4,2,1750,8116,1,1750,0,1943
7227800055,247000,4,2,1750,8116,1,1750,0,1943
3296900160,442500,4,2.5,2170,14024,2,2170,0,1992
3421069053,600000,3,2,2540,237402,1,2540,0,2007
7202380340,449000,3,2.5,1690,3827,2,1690,0,2005
6716700240,725000,4,1,1600,4500,1.5,1600,0,1926
1431400070,215000,3,1,1060,7900,1,1060,0,1961
9554200200,582500,2,1.75,1990,6549,1,1170,820,1948
1310900140,305000,4,2.25,2210,9371,2,2210,0,1968
9454200030,734000,4,2.75,3090,7650,2,2340,750,1959
1402810140,300000,3,2,1050,10072,1,1050,0,1986
1823069155,525888,5,1.75,2550,71874,1,1810,740,1960
2530800070,711000,4,2.5,2095,4400,1.5,1295,800,1910
4024100496,360000,3,1.75,1520,12282,1,1220,300,1978
5252000200,357000,5,2.5,2750,12350,2,2750,0,1987
7331900270,235000,3,1.75,1200,9266,1,1200,0,1960
1574700140,550000,3,1.75,1830,9720,1,1150,680,1928
0162500030,324000,3,1,1160,7202,1,1160,0,1957
3705900292,420000,3,2,1750,9239,1,1410,340,1989
2141500070,450000,4,2.5,2400,7693,2,2400,0,2003
8562750060,825000,5,3.5,4140,6770,2,3030,1110,2004
7349620030,272000,4,2.25,2115,6234,2,2115,0,1998
2523039315,481000,3,2,2580,15653,1.5,2580,0,1990
2877101821,500000,3,1,1220,3400,1,1060,160,1927
1176000390,448000,2,1.5,1630,3780,1,890,740,1940
8682262190,480000,2,2,1350,4220,1,1350,0,2004
7202350060,475000,3,2.5,1690,2890,2,1690,0,2004
3630060070,472500,2,2.25,1700,2383,2,1700,0,2005
2413300810,291000,4,2.25,1890,7616,1,1260,630,1979
6450304260,294000,2,1,850,5250,1,850,0,1950
2025059204,1.01305e+006,4,2.5,2480,12688,1,1820,660,1967
7202290240,442500,3,2.5,1690,3129,2,1690,0,2002
1788700070,170000,2,1,810,8424,1,810,0,1959
8085400055,1.5825e+006,4,2.5,3980,16304,1,2480,1500,1968
5700002025,665000,3,2.25,2580,6000,2,1780,800,1925
0853600310,1.61e+006,5,4.5,6085,142725,3,6085,0,2000
5332200320,675000,2,1.75,2140,5000,1,1000,1140,1930
2130701535,279900,2,1.75,1360,10000,1,1360,0,1957
0510002010,875000,4,1.5,1800,3245,1.5,1800,0,1929
3630110510,571000,3,2.5,1920,3867,2,1920,0,2005
6300000400,320000,3,1,860,5060,1.5,860,0,1927
1560920200,525000,3,2.5,2340,35021,1,2340,0,1986
1652500060,1.65e+006,8,2.75,4040,20666,1,2020,2020,1962
9368700270,137900,3,1.75,1160,5082,1,580,580,1942
2223089053,440000,3,2.25,1680,57063,2,1680,0,1989
9828201920,360000,3,1,1280,3870,1,640,640,1945
7334401040,271000,4,1.5,1800,9576,1,1800,0,1977
5152700060,465000,6,3.25,4250,23326,1,2150,2100,1967
1460900030,280000,4,2.5,2400,4596,2,2400,0,2004
3626039250,283000,2,1,940,6350,1,940,0,1942
7199360320,411500,3,1,1110,7208,1,1110,0,1980
8731901610,282000,3,2.25,2420,7548,1,1370,1050,1967
6821102317,535000,3,2.5,1850,1499,2.5,1790,60,2005
3271300955,554729,4,2.5,2020,4350,2,1730,290,1943
3271300955,868000,4,2.5,2020,4350,2,1730,290,1943
2623089135,427000,3,2.5,1830,65340,1,1520,310,1991
2044500152,455000,4,1.75,1920,6000,1,960,960,1954
1725059187,595000,2,1.75,1280,8500,1,1280,0,1953
6699930260,400000,4,2.5,3130,5240,2,3130,0,2004
3295610200,770000,4,2.5,3920,12415,2,3920,0,1997
1186000125,742500,4,2.75,3100,3773,2,2000,1100,1919
6065300570,1.25e+006,4,2.5,3220,15600,1,1680,1540,1973
8039900400,375000,3,2,1670,13775,1,1670,0,1968
1925059200,1.5576e+006,4,2.5,2700,17853,2,2700,0,1960
5729000070,545000,4,2,5461,22880,1,3265,2196,1964
0098000960,1.05e+006,4,3.25,4400,16625,2,4400,0,2003
1330300451,1.565e+006,3,1.75,2190,8500,1,2190,0,1957
4312700340,178000,4,1.5,1200,11163,1.5,1200,0,1970
3797700030,262500,3,1.75,1470,10390,1,1470,0,1989
0452001890,730000,3,1.75,1650,5000,1.5,1650,0,1900
2927600105,395000,5,1.75,1840,10453,1,1360,480,1948
3298300140,355000,3,1,1210,6650,1,1210,0,1959
1321700390,299990,3,2.5,1870,8541,2,1870,0,1989
1222069129,1.125e+006,4,3.25,3890,422096,1.5,3150,740,2001
1081800070,425000,4,2.25,2660,11200,2,2660,0,1972
6414100732,349000,2,1,1150,7552,1,1150,0,1951
0513000445,554950,4,1.75,1740,4816,1,870,870,1942
6888900060,326000,6,3,2580,8064,1.5,1880,700,1913
7309100270,580000,4,1.75,1720,6975,1,1420,300,1975
2162000260,699000,3,2.5,2740,18455,2,1510,1230,1977
7732000045,757000,3,2.75,2610,11290,1,1630,980,1985
3764800510,335000,3,1.75,1400,7920,1,1400,0,1965
2481600030,660000,3,2,2570,28500,1,1970,600,1983
5126310060,540000,4,2.75,2830,7334,2,2830,0,2005
1310700390,320000,5,2.25,2630,8625,2,2630,0,1966
6402710070,280000,3,2.5,1580,7918,2,1580,0,1994
5702450260,324000,3,2,1540,10931,1,1540,0,1989
3243200310,300000,3,1,2120,7735,1,1060,1060,1967
2131200885,360000,3,1.75,1830,10000,2,1830,0,1913
8651480550,600000,3,2.5,2260,10153,2,2260,0,1987
3024059036,950000,4,1.75,2500,92347,1,1500,1000,1970
6382500079,599950,3,3.25,1830,1804,3,1830,0,2014
4363700200,190000,4,1,1190,7920,1,890,300,1951
3876310860,350000,4,1.75,2310,9002,1,1780,530,1970
2391602650,522000,3,1,1230,4600,1.5,1230,0,1929
2597530070,850000,3,2.5,2940,10809,2,2940,0,1992
1314300046,308000,3,1,1010,8800,1,1010,0,1954
3693900885,1.02e+006,6,2.25,2550,5000,2,2550,0,1907
6046400465,397500,3,1,1480,5100,1.5,1480,0,1938
4388000070,186000,3,1.75,1460,7967,1,1040,420,1977
8854000370,436500,5,3,3110,12429,1,1790,1320,1977
4459800075,710000,3,2,2140,4923,1,1070,1070,1928
7153200160,1.3786e+006,5,3.25,3450,6360,2,1860,1590,1905
7752400075,450000,3,2.25,1960,10682,1,1960,0,1957
7604410030,375000,4,2.75,1890,5240,1,980,910,1981
2144800311,315000,2,1,2080,14659,1,1040,1040,1960
1705400550,467500,3,1,1700,4165,1.5,1700,0,1918
9485700136,330000,3,1,1140,7316,1,1140,0,1959
1822039225,665000,3,2.5,3136,54450,1.5,3136,0,1910
2625059301,760000,4,3.25,2590,3889,3,2590,0,2013
7625702440,469000,3,1.75,1480,800,2,1000,480,2014
9126100487,408000,3,3,1500,1473,2,1120,380,2000
7922900030,851000,3,2.75,2660,10350,1,1330,1330,1971
8682292180,410000,2,2,1350,3926,1,1350,0,2007
6730700260,235000,2,1,860,10500,1,860,0,1943
7225000045,207100,2,1,1000,4500,1,1000,0,1916
4140500055,560000,4,2.5,2480,16360,1,1510,970,1959
2592210370,903000,3,2.75,3860,12786,2,3860,0,1984
1337800830,998500,3,1.75,2140,4800,2,1690,450,1905
1951500055,268500,4,1.75,1820,13600,1.5,1120,700,1959
1136100045,494950,2,1.75,2220,33000,1,2220,0,1970
3860400060,1.13e+006,4,2.5,2660,11200,2,2660,0,1999
1657000070,250000,3,2,1470,12096,1,1470,0,1942
1423069129,449000,4,1.75,2350,54450,1,1250,1100,1971
1118001631,1.225e+006,3,2.25,2980,7700,1,2530,450,1964
7399200240,325000,4,2,1870,7700,1,1870,0,1966
4037000160,506000,5,3,2430,8000,1,1370,1060,1957
8562740370,751000,4,2.5,2790,6538,2,2790,0,2003
9407001620,280000,3,2.5,1370,22326,2,1370,0,1993
2481620310,1.12e+006,4,2.25,4470,60373,2,4470,0,1988
7511200350,580000,3,1.75,2040,81021,1,2040,0,1980
4039100350,665000,4,2.25,2340,5300,1,1700,640,1963
0808300270,450000,4,2.5,2520,8515,2,2520,0,1999
3023059012,389900,4,1,1710,117176,1.5,1710,0,1942
4039300810,427000,3,1,1200,5252,1,1200,0,1962
8849300320,265000,3,1.75,1330,12618,1,1330,0,1983
0272000320,398000,3,1.5,1310,2996,2,1310,0,1998
1180002470,354000,6,3.5,3020,4500,2,3020,0,1941
1330290160,339950,4,2.5,2260,6086,2,2260,0,1999
6392000570,399000,2,1,790,4000,1,790,0,1948
8835200160,325000,2,2,970,5000,1,970,0,1983
0868000575,998800,3,2,2250,8000,1,2250,0,1955
0597000550,350000,4,2.5,1530,2248,1.5,1530,0,1914
6669000070,1e+006,4,1.75,1780,11436,1,1780,0,1967
7202340860,561000,3,2.5,2120,5277,2,2120,0,2005
6141100320,245000,2,1,1500,6685,1,1190,310,1926
6141100320,570000,2,1,1500,6685,1,1190,310,1926
6815100370,845000,4,3,2390,4000,1.5,1460,930,1931
5636010560,314500,4,2.5,2390,9600,2,2390,0,1996
2592200030,650000,3,1.75,2920,9370,1,1620,1300,1981
1823059159,298000,2,1,850,5000,1,850,0,1907
2254501620,500000,2,1,930,3200,1,930,0,1904
9275700765,870000,4,2.5,3340,12248,2,2470,870,1998
7454000875,299000,2,1,710,6732,1,710,0,1942
7434500127,527000,3,2.25,2240,6450,1,1440,800,1979
0646500070,420000,3,1,1060,7638,1,1060,0,1966
9432900560,290000,3,2.5,2360,8764,2,2360,0,1991
5154700060,1.662e+006,4,2.75,3520,19200,1,1950,1570,1951
3395300260,499990,3,1.75,1730,9334,1,1220,510,1977
2113700510,315000,3,1.75,1170,4000,1,720,450,1943
4053200566,425000,4,2.25,3680,26266,2,3680,0,1981
7214720400,630000,3,2.5,2900,46609,2,2900,0,1987
3211210200,365000,3,1.75,1290,7205,1.5,1290,0,1971
7010700810,774000,4,2.75,2010,7000,2,2010,0,1901
3971700390,368888,3,1.5,1490,12186,1,1490,0,1950
9406550060,339500,4,2.5,1930,7862,2,1930,0,1994
0414100045,344950,4,1.75,2240,7500,1,1120,1120,1956
4276400030,450000,3,2,2320,17688,1,2320,0,1952
9433000060,814950,4,2.75,2990,6626,2,2990,0,2014
7885800160,299900,4,2.5,2200,5730,2,2200,0,2003
2473101070,315000,3,2,1500,7828,1,1500,0,1967
3701000060,880000,3,1.75,3860,9000,1,1930,1930,1970
8651441290,195000,3,1.5,1430,5200,1,1030,400,1977
0255400060,910000,5,2.75,3750,8279,2,3750,0,2001
8567450140,540000,5,2.5,3100,10189,2,3100,0,2002
2517000140,306000,3,2.5,1870,5874,2,1870,0,2005
1938400520,272000,4,2.25,2040,7600,1,1580,460,1978
3179100055,1.295e+006,5,3.5,3700,8504,2,2750,950,1950
1924069105,450000,3,1.75,3150,9258,1,2370,780,1970
0704450070,450000,3,2.5,1990,12793,2,1990,0,1993
2881700046,310000,4,1,1740,11075,1.5,1740,0,1965
8955800045,530000,2,2.25,2080,11285,1,1180,900,1954
3816300105,435000,4,2.5,2060,10125,2,1560,500,1979
6649900030,485000,3,2,1590,11222,1,1590,0,1948
1912100885,690000,3,1.5,1760,4000,2,1760,0,1922
9542840570,305000,4,2.5,1620,4000,2,1620,0,2008
2473381070,300000,3,1.75,1210,7000,1,1210,0,1975
7137950350,289950,4,3,2040,5050,1,1490,550,1993
1088800060,575000,3,2.5,2270,9600,2,2270,0,1990
4054530260,1.82e+006,4,4.5,6640,53330,2,6640,0,1993
0248000240,219000,3,1.5,1060,9600,1,1060,0,1962
3995700435,265000,4,3,1940,8170,1,1940,0,1948
9287800135,1.105e+006,5,3.25,3070,5000,2,2050,1020,2006
4337000070,200000,3,1,930,7590,1,820,110,1943
8859000045,545000,4,2.75,2180,8480,1,1210,970,1959
8856920550,378000,3,2.5,2130,8404,2,2130,0,1991
5705500075,388000,2,1.75,800,4800,1,800,0,1922
6163901433,425000,4,2.25,2200,8384,1,1250,950,1959
0475000004,536000,2,1.5,1130,746,2,1030,100,2009
7936500172,1.175e+006,3,2.5,1970,23180,1,1100,870,1937
2770604080,629950,3,2.5,1680,1620,2,1120,560,2014
5101408599,465000,4,1.75,1470,5350,1,980,490,1955
1226059105,545000,4,2.25,2390,40510,1,2390,0,1969
3211700045,592000,4,2.5,2300,11165,2,2300,0,1979
8567300270,446000,4,2,2280,43692,1,1140,1140,1957
6021503655,375000,3,2.5,1330,816,3,1330,0,2004
7202331160,632500,5,2.5,2640,7096,2,2640,0,2003
2763710060,459950,4,1.75,2430,9747,1,1780,650,1974
3211270160,485000,4,2.5,2470,35073,2,2470,0,1989
3365900106,255000,3,1,1440,11330,1,1440,0,1965
1761300340,251750,3,2,1320,7200,1,1320,0,1975
2909300240,725000,3,2.5,2810,6300,2,2810,0,2001
0476000324,460000,3,3.25,1370,1194,3,1370,0,2005
2141200030,625000,3,2.5,2000,6341,1,1040,960,1981
9557300560,530000,3,1.75,1980,6760,1,1980,0,1973
2612000200,394950,3,2.5,2050,8172,2,2050,0,2002
6002400030,324950,4,1.75,2320,9240,1,1160,1160,1959
6064800060,330000,3,2.25,1960,1985,2,1750,210,2003
8091410390,220000,4,1.75,1910,8171,1,1910,0,1986
1786830060,685000,3,3.25,2030,11070,2,2030,0,1980
7277100055,500000,3,2.25,2210,7680,1,1730,480,1972
3392500060,368000,4,2.75,2610,9426,1,1360,1250,1965
3897100640,825000,3,2.25,2520,7975,2,1550,970,1990
7942602080,660000,6,1.75,1840,2774,1,1060,780,1900
2787311480,253000,3,1.75,1570,7416,1,1570,0,1971
5467200055,392500,4,2.75,2400,19923,1,1320,1080,1953
7277100510,605000,3,1.75,1930,5400,2,1930,0,1978
2525300200,215000,3,1,1160,10384,1,1160,0,1969
7732500270,650000,4,2.5,2820,15000,2,2820,0,1985
5700001920,877500,4,2,3060,8000,2,2040,1020,1922
5560000640,232500,3,1,1320,8450,1,880,440,1961
2781250560,234000,2,2,1200,3624,2,1200,0,2003
1122059037,380000,3,1.75,1560,104108,1,1250,310,1970
5515600163,420000,5,2.25,3070,64033,1,2730,340,1983
8807300570,399950,3,1,1040,9600,1,1040,0,1978
9412700550,256750,3,2.5,1990,8991,1,1570,420,1969
9202600060,535000,3,2.5,1690,9626,2,1690,0,1984
8857320030,515000,3,2,1810,2738,2,1810,0,1979
0685000160,770000,4,1.75,2520,8442,1,1640,880,1953
8001100030,256000,3,2.5,1570,5113,1,1090,480,1996
9144100126,489900,3,1,1680,8910,1,1680,0,1940
7149410060,165000,3,1.5,1250,7200,1,1250,0,1978
3388000640,220000,3,1.5,1280,7742,1,1280,0,1962
1321700030,575000,4,2.5,4620,20793,2,4620,0,1991
6662400105,375000,3,2.5,1580,5725,2,1580,0,2004
3971700903,422250,3,1.75,1650,7145,2,1300,350,1977
6804600260,420000,3,1.75,1660,9600,1,1380,280,1981
8078460520,608000,4,2.5,2410,7140,2,2410,0,1993
2436700800,620000,3,2.25,1720,4000,1.5,1450,270,1921
2592210510,850000,3,2.5,3120,12406,2,1940,1180,1983
9414610320,463000,4,2.5,2680,9928,1,1340,1340,1974
7567600030,750000,5,1.75,2640,13290,1,1400,1240,1954
0624110810,1.07e+006,3,3.25,3730,13264,2,3730,0,1989
4123800400,290000,3,2,1700,6498,1,1700,0,1986
9424400105,525000,4,1.75,2280,5959,1,1250,1030,1947
7941130140,319000,3,2.25,1220,2980,2,1220,0,1986
1568100295,592500,6,4.5,3500,8504,2,3500,0,1980
6683000295,350000,3,2.5,2010,14298,2,2010,0,1977
5710610520,454900,3,1.75,2130,9775,1,1430,700,1973
1565900390,272000,4,2.25,1800,9018,2,1800,0,1992
6608500260,357500,3,1,1070,10125,1,1070,0,1961
7338401230,285000,3,1.75,1020,5000,1,1020,0,1954
7212660520,280000,4,2,1600,6861,1,1600,0,1994
8901001290,477000,4,1.5,1380,7800,1,1080,300,1928
3345100030,750000,3,2.25,3270,168000,2,3270,0,1982
7986401275,595000,4,2.5,2100,3125,2,1400,700,1907
3047700045,525000,3,2.25,2110,2850,3,2110,0,2001
1422029117,319000,3,1.75,1640,53400,1,1640,0,1966
0104530240,225000,3,2,1320,5665,1,1320,0,1986
8718500260,485000,4,2.5,2420,10603,1,1210,1210,1958
3735901040,341000,3,1,1390,4814,1.5,1390,0,1908
3448002180,674000,3,3.25,2320,6744,2,1930,390,2014
5126300960,442250,3,2.5,2170,8169,2,2170,0,2003
1774220400,591000,4,2.25,2710,38180,2,2710,0,1977
8648100030,276000,3,2,1450,8928,1,1450,0,1998
7940710070,394000,3,2.5,1370,4400,1,1370,0,1988
1518000070,355000,3,2.5,1810,3192,1,1070,740,2001
3832500260,260000,3,2.5,1420,14850,1,1020,400,1963
1139600270,300000,3,2.75,2090,9620,1,1340,750,1987
1139600270,310000,3,2.75,2090,9620,1,1340,750,1987
1099610830,209000,3,1,1330,6900,1,1330,0,1976
5647000060,344950,3,2,1330,7419,1,1330,0,1985
3352402272,230000,5,2,1910,7200,1,1110,800,1951
6669020640,336950,3,1.75,2310,7680,1,1410,900,1978
6154900070,700000,3,2.75,2500,7378,1,1390,1110,1948
1545802080,230000,3,2,1310,7332,1,1310,0,1987
8161020060,443500,4,2.5,2040,21781,2,2040,0,1994
8161020060,471000,4,2.5,2040,21781,2,2040,0,1994
0443000060,595000,3,2.25,2400,16301,1,1400,1000,1962
4172100200,470000,3,1,1400,4914,1.5,1400,0,1929
7309100070,600000,4,1.75,1700,7800,1,1700,0,1975
0191100672,1.381e+006,4,3.75,3160,9525,2.5,3160,0,1997
2125400160,427800,3,1.75,1340,13241,1,1340,0,1985
0259800060,445000,4,2,1470,8395,1,1470,0,1965
4402700125,382000,3,1.75,1790,7679,1,1790,0,1953
7504180070,577000,3,1.5,1560,20251,1,1200,360,1989
2723069129,427000,3,2.5,2620,108464,2,2620,0,1990
3210400060,255000,3,1,1580,8206,1,1100,480,1962
8658301535,240000,3,1,1090,10000,1,1090,0,1961
8923100125,1.23458e+006,5,3.25,3240,6551,1.5,2500,740,1939
5592900105,435000,4,1.75,2520,7200,1,1260,1260,1955
8964800695,1.45e+006,3,1.75,2230,13529,1,2230,0,1949
5104510860,425000,4,3,2430,5502,2,2430,0,2002
1090000075,393000,2,1,1020,4200,1,1020,0,1923
1446800181,264950,4,1,1810,7500,1,1410,400,1959
1829300520,746500,4,2.5,3460,9699,2,3460,0,1987
3992700070,450000,3,1,2020,8100,1,1170,850,1956
2472950160,229950,3,2,1410,7466,1,1410,0,1983
3468800310,425000,2,1,750,4000,1,750,0,1933
6613000935,2.555e+006,4,2.5,5300,26211,2,4570,730,1923
4054530240,1.4e+006,4,3.5,4380,66613,1.5,4380,0,1993
2600040160,753000,3,2.25,2290,9047,2,2290,0,1984
4229900140,310000,2,1,720,5750,1,720,0,1943
1005000240,395000,2,1,1200,6014,1,600,600,1949
4188000240,725000,3,2.5,2620,28703,1,2620,0,1985
1562100340,295000,4,3,2120,7650,2,2120,0,1964
7941600390,225000,3,1.75,1580,8820,1,1580,0,1967
2655500241,1.699e+006,3,3.25,4160,35153,3,3690,470,2001
8651720060,431000,3,2.25,1830,8831,1,1460,370,1979
2621750350,358500,3,2.5,2000,8057,1,1360,640,1998
2397101375,595000,2,1,980,3600,1,980,0,1907
0808300200,468000,4,2.5,3040,20682,2,3040,0,2000
8645500370,260000,4,1,1740,8100,1,1020,720,1962
5668500045,375000,3,2,1450,7300,1.5,1450,0,1955
6679000370,295000,3,2.5,1560,4200,2,1560,0,2003
8699800070,403900,4,2.5,2050,8909,1,1690,360,1986
9500900060,269950,3,1.75,1760,12823,1,1460,300,1956
2255500060,640000,3,3.5,1740,1975,2,1310,430,1998
5071500140,221000,3,1,910,8789,1,910,0,1966
3546000070,255000,3,1.75,1700,7532,1,1700,0,1987
9478500570,300000,4,2.5,2620,4469,2,2620,0,2008
2473440070,270000,3,2.25,1500,7410,1,1500,0,1973
0952001710,575000,4,1.75,1630,5750,1,1160,470,1947
7905400160,246900,3,1.5,1370,9800,1,1370,0,1968
6852700520,635000,2,2.5,1390,1132,2,1130,260,2006
0625100004,450000,3,2,1540,67756,1,1540,0,1900
6600400370,215000,3,1,1190,7500,1,1190,0,1968
2025770310,785000,3,3.5,4500,21870,2,4500,0,2004
2126049290,522500,4,3,2370,8154,1,1380,990,1977
1843200350,150000,2,1.5,1360,1934,2,1360,0,1978
3750600566,199950,2,1.75,870,18537,1,870,0,1946
3761100045,3e+006,4,4.25,4850,12445,2,3850,1000,1989
7937600262,379900,3,2,3110,44967,2,3020,90,1999
3629921000,950000,4,2.5,3700,7051,2,3700,0,2006
7519000335,865000,6,2.75,3500,5150,2,2430,1070,1909
5459000240,785000,3,1.75,1670,9600,1,1670,0,1961
9835801000,245700,3,2.25,1640,8400,1,1180,460,1968
1102001274,951000,3,2.25,3400,12825,1,3400,0,1961
7950303290,499950,3,1.75,2060,3500,1,1030,1030,1951
7968460240,257000,3,1.75,1330,36537,1,1330,0,1989
9827700105,549000,3,2,2330,3600,1.5,1580,750,1900
3536900030,1.6e+006,3,2.75,3040,21052,2,3040,0,1980
0328000160,1.4e+006,5,3.75,3700,7920,3,2900,800,1983
6909700340,619000,3,2,1990,3000,1.5,1430,560,1927
0829000160,311000,5,3,2020,5917,1,1220,800,1993
4077800376,600000,5,2.25,2980,7781,1,1580,1400,1960
6154500030,1.08e+006,4,3.5,3990,5267,2,3990,0,2008
9828202325,436000,2,1,790,6600,1,790,0,1949
0795002190,205000,2,1,1060,8000,1,1060,0,1941
0226059065,514000,3,2.25,2260,54014,1,1450,810,1962
8682280270,530000,2,2.5,1900,2983,2,1900,0,2006
7695370160,511000,5,2.5,3361,6983,2,3361,0,2006
3025300226,2.1e+006,4,1.75,3550,19865,2,3550,0,1962
0241900160,370000,5,2.5,2740,5460,2,2740,0,2005
2461900550,500000,4,1.75,2040,6000,1,1020,1020,1943
9206700060,710000,4,2.5,4070,129808,2,4070,0,1998
1997200060,270000,1,1,720,5196,1,720,0,1911
5468700105,415000,3,1.75,2000,8400,1.5,2000,0,1959
5078400160,1.8e+006,5,4.5,4400,15580,2,3390,1010,2003
6603000030,236000,3,1.75,1300,8976,1,1300,0,1967
8598200070,278000,2,2.5,1420,2229,2,1420,0,2004
5101402435,312000,3,2.25,1540,5338,1,770,770,1954
5101402435,539000,3,2.25,1540,5338,1,770,770,1954
8820902400,498000,3,3,2360,2750,2,1780,580,1983
1246700251,857000,4,3,3720,29043,2,3720,0,1991
5315101716,780000,3,1.75,1690,13500,1,1690,0,1978
5035300570,650000,3,2,2300,5000,1,1150,1150,1938
4123400310,559500,4,1.75,1650,7088,1,1650,0,1973
4058802255,219950,2,1,990,6448,1,990,0,1948
2141330560,671500,4,2.25,2130,8410,2,2130,0,1977
2725069121,813000,4,2.5,3320,52707,2,3320,0,1999
7682200340,182000,3,2.25,1960,8875,1,1290,670,1965
9518100059,203700,2,1,770,2500,1,770,0,1913
1861400060,740000,4,1.75,2010,3600,1.5,2010,0,1902
2223059053,230000,2,1,800,17965,1,800,0,1942
0421049114,128000,3,1,910,11117,1,910,0,1955
6703100140,345000,3,1,1200,6628,1,1200,0,1952
6127010890,663000,4,2.5,3570,6246,2,3570,0,2005
8898700960,329950,3,2.5,1820,8085,2,1820,0,1983
0486000597,1.0475e+006,3,2.25,2930,7005,3,2670,260,1999
7175300045,402300,3,1.75,1480,4050,1,870,610,1926
3073500045,492000,4,2.5,3305,16164,1.5,2245,1060,1922
2407900550,448000,4,2.5,2230,5000,1,1650,580,2006
5379802650,273000,3,1,1560,7800,1,1560,0,1955
4364700990,335000,3,1,1030,7200,1,880,150,1948
2158900140,695000,3,3.75,2380,3600,1.5,1690,690,1927
3235100075,279000,3,1,1010,7903,1,1010,0,1948
2887701940,485000,2,1.75,2060,2700,1,1030,1030,1929
7399200510,383000,4,2.5,2370,10580,2,2370,0,1966
3578600045,490000,4,2.5,2242,37451,2,2242,0,1995
9406500310,240000,2,1.5,1078,1263,2,1078,0,1990
1560100135,285000,2,1,890,7250,1,890,0,1943
1326069094,524950,3,1.5,2700,24539,2,2120,580,1977
3396830310,729000,4,2.5,2450,27081,2,2450,0,1985
4040400340,460000,3,1.75,1420,8250,1,1420,0,1960
7234601221,687500,3,1.5,1280,2114,1.5,1280,0,1904
6065301040,1.168e+006,5,2.75,2910,15118,1,1780,1130,1972
2600010390,825000,4,2.25,2430,10050,2,2430,0,1979
6679000560,314950,2,2.5,1860,6359,2,1860,0,2003
6743700335,470000,3,2,1800,12669,1,1800,0,1956
2207000060,500000,3,1.5,1960,8815,1,1020,940,1958
1900000060,313000,3,1.5,1550,7260,1.5,1550,0,1925
1232001480,445000,2,1,840,3840,1,840,0,1926
9835800320,300000,4,1.75,2080,8750,1,1330,750,1967
9285800055,619500,4,2.5,2210,5077,1.5,1480,730,1912
3438500677,305000,3,1.5,1210,5240,1,610,600,1983
3879901290,874000,3,2.5,1350,941,3,1350,0,2007
3905040060,477500,3,2,1860,5146,2,1860,0,1991
9530101290,700000,3,2,1940,4500,1,1090,850,1926
5104532030,515000,4,3.5,3400,5222,2,3400,0,2005
6411600045,590000,4,2.5,2240,9385,2,2240,0,1991
1796360990,205000,3,1.75,1170,8239,1,1170,0,1981
9264911550,310000,3,3.25,3130,9302,2,2190,940,1987
7715800310,442500,2,2.25,1510,7280,2,1510,0,1987
3407700012,1.0785e+006,4,3.5,3740,41458,2,3740,0,2000
2322069116,530000,4,2.5,2690,46609,2,2690,0,1980
4058800875,343500,4,1.75,1760,6204,1,1180,580,1950
8113101070,334900,4,1.75,2180,4066,1.5,1270,910,1911
9512501370,544300,4,1.75,1560,9000,1,1560,0,1969
3670500465,370000,3,2.5,1780,4050,2,1780,0,2001
8856950310,245000,3,1.75,1260,6908,1,1260,0,1994
4315700505,535000,4,1.75,1570,3250,1.5,1570,0,1928
3046200125,202000,2,1,740,6550,1,740,0,1946
2922701420,490000,4,2.25,2020,4960,2,1710,310,1938
6430500238,651500,4,1.5,1500,3075,2,1420,80,1929
6031400071,270000,4,2.5,1670,8056,1,1170,500,1961
1854750030,1.164e+006,3,3.5,3620,8072,2,2920,700,1999
7950302121,289000,2,1.5,1010,1309,2,860,150,2007
1421069117,240000,3,1.5,1460,13503,1,1460,0,1977
1370803510,790000,3,1.75,1790,6117,1,1350,440,1940
1559900140,350000,3,2.25,1760,9621,2,1760,0,1995
2734100738,246950,3,3.5,1790,1682,2,1480,310,2006
7007700030,400000,3,1,1050,6000,1,1050,0,1952
7702020030,533000,4,2.5,2590,6394,2,2590,0,2003
1795500060,198400,3,1,1040,8645,1,1040,0,1962
3303860030,495000,4,2.5,4060,8547,2,2790,1270,2007
7701960990,862000,4,2.5,3190,14565,2,3190,0,1990
7701960990,870000,4,2.5,3190,14565,2,3190,0,1990
5453700060,875000,4,1.75,2180,9726,1,2180,0,1966
2143700935,317000,6,3.5,2120,5840,2,2120,0,1979
9485300560,325000,4,2.75,2110,6838,2,2110,0,1991
3693900135,615000,2,1.5,1210,5000,1.5,1210,0,1907
7212650990,334950,4,2.5,2410,7846,2,2410,0,1992
1245001659,775000,3,2.5,1980,7807,2,1980,0,1989
6071300550,600000,4,2.5,2370,9135,1,1600,770,1967
4083306620,565000,3,1.75,1720,2218,1.5,1270,450,1931
8122100392,292500,2,1,750,5026,1,750,0,1942
5418500800,825000,3,2.25,2510,10418,1,1810,700,1968
2421059036,495000,3,2.5,2577,156816,2,2577,0,2000
0952000310,525000,3,1.5,1540,4773,2,1540,0,1941
5694501195,438600,1,1,720,2500,1,720,0,1910
2872900390,507000,3,2.25,1810,8158,1,1450,360,1984
1502400140,275900,3,1.75,1380,8400,1,1380,0,1967
3860900003,1.17e+006,4,2.5,2570,6251,2,2570,0,2000
1180003435,275000,4,1.75,1690,6000,1,1690,0,1957
6430000070,355000,3,0.75,1420,3060,1,860,560,1923
5530000030,233000,4,2,2130,9579,1,1250,880,1968
5700000465,666000,3,2.5,3000,5000,1.5,2110,890,1918
3211100570,317500,4,2.5,2150,9000,1,1360,790,1979
9536601331,420000,4,2,2280,10319,1,1270,1010,1989
0985000955,290000,4,2,1560,8800,2,1560,0,1942
0323059208,320000,3,2,1880,10758,1,940,940,1952
4221270350,650000,3,2.5,2320,5284,2,2320,0,2004
3768000030,325000,3,1.75,1010,7171,1,1010,0,1967
7211401610,165000,3,1,1120,5000,1,1120,0,1917
9542000340,500000,3,1.75,1560,16194,1,1560,0,1961
2426049078,443000,4,1.5,1860,12197,1,1860,0,1964
5438000160,213400,3,1.5,1150,8686,1,1150,0,1963
0259600890,480000,4,1.75,1920,9380,1,1920,0,1964
8732190200,275000,4,2.25,2490,7233,1,1460,1030,1978
3395040200,299880,3,2.5,1460,3044,2,1460,0,2000
6362900171,499950,3,3.5,1820,1501,2,1430,390,2014
2154500060,1.705e+006,5,3,4290,17100,1,2480,1810,1972
5706200370,550000,4,2.75,2230,9460,1,1480,750,1960
1402950240,300000,4,2.5,2070,7476,2,2070,0,2003
4141800030,920000,3,1.75,2480,4000,1,1240,1240,1948
3426049284,2.3e+006,4,3.25,4110,15929,2,2720,1390,2001
3658700510,620000,4,2.75,2290,3060,1.5,1550,740,1928
2220069196,253500,3,1,1220,20400,1,1220,0,1959
5700004485,978000,4,2.75,2620,13777,1.5,1720,900,1926
1328320350,387500,4,2.5,3190,9856,2,3190,0,1979
3432500310,325000,3,1,850,6906,1,850,0,1948
9274200318,568000,3,2.5,1740,1308,3,1740,0,2008
3034200550,525000,4,2.5,2140,7754,2,2140,0,1996
2078500350,560000,3,2.5,2070,12708,2,2070,0,1996
7203101290,394000,3,2.5,1680,4075,2,1680,0,2008
9287801455,484950,2,1,1000,4956,1,1000,0,1916
9472200060,1.295e+006,3,2.75,3340,12690,1,2550,790,1956
0869700060,315000,3,2.5,1260,2767,2,1260,0,1999
4298100060,590000,4,2.25,2430,32496,1,2430,0,1993
7211402105,106000,1,1,560,5700,1,560,0,1947
7135520260,751000,3,2.5,3380,9528,2,3380,0,1994
9222400565,474000,2,1,1100,3500,1,1100,0,1908
7116500125,189000,2,2,1700,3171,1,850,850,1927
7202290320,440500,3,2.5,1600,3172,2,1600,0,2002
9808630260,1.017e+006,3,2.5,2605,2216,2,2090,515,1979
8682310310,589000,2,2,1850,4667,1,1850,0,2010
4137000700,273000,3,2.25,1830,7651,2,1830,0,1986
5119400075,950000,3,3.25,3050,18892,1,1650,1400,1962
8857100060,277700,2,1.5,1240,1055,2,1200,40,1967
3329510200,299900,3,2.25,2100,8163,2,2100,0,1984
7789200070,235000,3,1,1250,15603,1,1250,0,1959
6140600049,464000,2,2,1230,4800,2,1230,0,1952
9324320030,281000,3,1.75,1690,9826,1,1690,0,1988
2555900030,320000,3,1,1520,8870,1.5,1520,0,1951
8662500350,282000,4,2,1890,6302,2,1890,0,1997
7856601040,745000,4,1.75,1990,8900,1,1990,0,1972
0109200390,245000,3,1.75,1480,3900,1,1480,0,1980
0109200390,250000,3,1.75,1480,3900,1,1480,0,1980
6870300060,470000,3,2.5,2120,2374,2,1770,350,2005
2734100732,216650,3,3.5,1480,1077,2,1300,180,2007
7201900370,440000,3,1,1250,8412,1,1250,0,1975
3904960700,590000,4,2.5,2010,7972,2,2010,0,1989
2225059240,935000,5,2.5,3150,35283,1,1800,1350,1975
4397650160,848000,3,3.5,3010,5717,2,3010,0,2000
3629860060,827500,5,4.25,3920,5823,2,3000,920,2000
4083305085,1.125e+006,6,3,2880,3192,2,2180,700,1919
0518500700,630000,2,2.25,2550,5663,1,1720,830,2011
3580900260,340000,5,1,1120,9022,1.5,1120,0,1962
1974300060,570000,4,2.75,3140,10918,1,1900,1240,1968
0624069035,2.75e+006,4,4,4130,5575,2,2860,1270,1993
5152980070,514500,4,2.5,2990,9614,1,1740,1250,1976
2624039114,360000,2,1,1120,12625,1,1120,0,1940
4337000200,228900,4,1.5,1570,8775,1,1570,0,1943
7203100550,660000,3,2.75,2210,4000,2,2210,0,2008
2782100260,647000,4,2.5,2390,5800,2,2390,0,2000
1737320060,366000,3,1.75,1520,8625,1,1520,0,1976
7972604001,354000,5,1.75,1830,7986,1,1060,770,1962
2719100240,850000,4,3.5,2640,5900,2,2640,0,1937
3904990570,496700,3,2.5,1740,5782,2,1740,0,1989
7399000350,300000,3,2,1550,8300,1,1550,0,1965
6400700189,390000,3,1,1040,8075,1,1040,0,1961
4305200070,350000,3,2.25,1640,7200,2,1640,0,1985
4305200070,561000,3,2.25,1640,7200,2,1640,0,1985
2201500240,475000,3,1.75,1260,10065,1,1260,0,1954
3277800729,275000,3,1.5,1170,1174,2,840,330,2007
2525310320,290000,3,1.75,1590,13500,1,1090,500,1980
2215901840,199000,3,2.5,1750,6725,1,1330,420,1993
1796700160,279900,4,2.5,1770,4338,2,1770,0,2001
4218400671,1.655e+006,4,2.25,3530,5500,2,2860,670,1940
6415100350,405000,3,2.5,2160,10200,1,1360,800,1978
7504020400,615000,4,2.25,2360,15860,1,2360,0,1977
8732190070,268000,3,1.75,1980,12543,1,1180,800,1978
2826049200,451000,4,1.5,1620,5444,1.5,1620,0,1955
8682292190,850000,2,2.75,2700,9854,1,2700,0,2012
2524049250,1.18e+006,5,2.25,3270,16553,2,2470,800,1968
7972603385,245000,2,1,870,6150,1,870,0,1941
4454800060,450000,2,1.75,840,3340,1,700,140,1912
8910500226,370350,3,3.5,1340,1168,2,1080,260,2002
1972202505,543000,3,2.5,1540,1256,3,1540,0,2004
6303400520,265000,2,2,1650,8975,1,1650,0,1942
7852020340,497000,3,2.5,2630,4611,2,2630,0,2001
3824100041,419000,4,2.25,1880,9727,1,1100,780,1979
3904990260,545800,4,2.5,1980,4500,2,1980,0,1989
0204000140,403000,3,1,1500,10730,1,1000,500,1977
6083000071,195000,3,2,1230,8235,1.5,1230,0,1959
6819100111,1.125e+006,4,2.5,2520,2600,2,1670,850,1925
7806210400,255000,5,1.75,1970,8925,1,1170,800,1977
4375700055,500000,2,1.5,1520,8040,1,1520,0,1951
0207500012,855000,4,2.75,2600,5390,1,1300,1300,1960
2731600045,390000,4,2,2290,9200,1.5,2290,0,1920
1953400570,339000,3,2,1979,8470,1,1329,650,1956
2883200139,1.325e+006,4,3.5,2170,3672,2,2170,0,1905
3345100251,429900,4,1.5,1820,17918,1,1190,630,1962
1387301740,370900,3,1.5,1200,8560,1,1200,0,1975
3214200070,457500,3,1,1210,7636,1,1210,0,1952
1937300193,499000,4,2.5,1970,2601,2,1440,530,1999
2821049082,225000,2,1,1040,11500,1,1040,0,1947
2207500200,615000,3,1.75,1920,4000,1,1070,850,1950
9528104286,455000,2,1.5,1020,1146,3,1020,0,2001
8901001170,458000,3,1,1660,7500,1,1060,600,1940
3260200200,580000,3,2.25,1670,7416,1,1220,450,1974
1853080640,966000,5,4.5,3810,8019,2,3810,0,2008
0986000045,240000,4,1.75,2020,10332,1,1010,1010,1954
4322200105,229050,1,1,420,3298,1,420,0,1949
1453600681,328500,3,2.25,1390,1407,3,1390,0,2004
3365900041,319000,3,1.5,2010,10100,1,1110,900,1964
9294300070,650000,4,2,1820,5000,1.5,1640,180,1945
5096300140,398500,3,2.5,1630,1971,2,1630,0,1996
0985001275,250000,1,1,800,16306,1,680,120,1931
6669200370,815000,3,2,2270,11989,1,2270,0,1968
3885806840,1.065e+006,3,2.75,2290,5002,2,1950,340,1995
2025079037,510000,3,2.25,2750,219542,2,1870,880,1981
3812400202,156000,2,1.75,590,6138,1,590,0,1947
4136880140,254500,4,2.75,2570,7264,2,1720,850,1998
0258500059,760000,3,2.5,2050,15020,1,1600,450,1960
8016250140,210000,3,2.5,1610,6732,2,1610,0,1994
5153100030,349950,3,2.5,2140,7715,2,2140,0,1991
1377800135,676000,3,2,1730,6784,2.5,1730,0,1942
7549800045,475000,4,3.5,2440,3052,2,1940,500,2006
3179101070,880000,4,2.75,3220,4392,1.5,2320,900,1931
0629800520,1.209e+006,4,3.25,4330,26162,2,4330,0,1997
7129302800,420000,3,1.5,1780,5000,1,1030,750,1958
2450000320,607000,3,1,1230,8114,1,1230,0,1951
6804600990,475000,4,1.75,2160,19283,2,2160,0,1981
3389900800,395000,2,1.75,1400,2500,1,710,690,1916
0524059208,650000,4,1.75,1900,10454,1,1180,720,1954
1523069128,625000,5,2.75,2910,85377,1,1510,1400,1966
5701700640,849000,3,3,2960,42159,2,2960,0,1995
4077800247,429950,3,1.5,2010,9480,1,1570,440,1951
3629860160,825000,3,2.5,3760,5260,2,3230,530,2002
2877102180,505000,2,1,1020,5000,1,1020,0,1916
7203101610,265000,2,1,1290,2828,2,1290,0,2008
3342100685,283000,3,1,890,8400,1,890,0,1954
3575301550,560000,3,2.75,1620,7500,1,1140,480,1979
1829300260,765000,4,2.5,3360,13636,2,3360,0,1987
6071000030,610000,5,2.75,2930,31411,1,1520,1410,1975
4099100260,589000,3,2.5,2940,4799,1,1710,1230,1996
3365900520,192500,3,1,1080,8580,1.5,1080,0,1900
8964800890,3.2e+006,3,3.25,4560,13363,1,2760,1800,1995
7977200055,550000,3,1,1010,6120,1,860,150,1940
7589700106,460000,2,1.5,1790,3760,1.5,1280,510,1928
9324300030,264500,4,2.25,2060,11385,1,1200,860,1962
5347200070,339000,3,1,1150,2496,1,1010,140,1947
2771600550,950000,4,3.5,4030,4200,3,4030,0,1992
5456000135,677500,3,1.75,2020,9718,1,2020,0,1956
0629811360,690000,4,2.5,2740,8120,2,2740,0,1999
1354600160,312000,4,2.25,1930,7452,1,1430,500,1984
8566100160,840000,5,1.75,2500,11617,1,1560,940,1966
5104520550,357500,3,3.5,2080,5100,2,2080,0,2004
2819100140,675000,3,1.5,1460,6480,1,980,480,1940
7298020140,515000,3,2.75,3290,11441,2,3290,0,1988
8929000140,491234,4,2.5,1540,1860,2,1540,0,2014
9407600070,290000,3,2,1310,6265,1,1310,0,1988
2896000510,490000,4,2.5,2120,7820,1,1280,840,1975
1938000140,810000,4,2,2920,10424,1,1520,1400,1964
4331000400,252000,3,1.5,1150,13200,1,1150,0,1956
4031700030,299999,3,2.5,2380,9719,2,2380,0,2001
1722800860,400000,3,2.75,2220,5000,2,2220,0,1993
2491200955,530000,5,2,3020,6000,1.5,1860,1160,1925
2013802030,357000,3,2,2460,53882,1,2460,0,1955
1923300135,365000,3,1.75,1820,5555,1,1030,790,1939
2391600335,804000,4,2.5,2620,5060,2,2620,0,2005
2425039017,808250,3,2,1750,2640,1,1010,740,1914
6752600320,360000,4,2.5,2020,7289,2,2020,0,1994
0193300140,240000,3,1.75,1240,10956,1,1240,0,1987
5651010320,335000,2,2,1380,5840,1,1380,0,1988
0243000045,380000,3,1.75,1920,8775,1,1920,0,1953
1558100398,350000,3,1.75,1680,250470,1,1070,610,1940
4204400339,194000,3,1,1400,7955,1,1400,0,1964
9567800140,310000,3,1,1240,7194,1,1090,150,1936
4046500140,315000,3,1.75,1410,15134,1,1410,0,1980
2115510160,258950,3,1.75,1440,8050,1,1440,0,1985
9828702518,479000,2,2.25,1230,932,2,1020,210,2004
3888100117,510000,5,1.5,1550,9750,1,1550,0,1966
1775900140,400000,3,2,1760,6875,1,1760,0,1967
6645950070,1.45e+006,4,3.5,5000,38012,2,3610,1390,2004
6840701160,680000,5,2,2140,5000,1.5,2020,120,1913
1336800240,1.75e+006,6,3,3510,5760,2.5,3510,0,1906
3830200140,335000,3,1.75,2010,9417,1,1500,510,1967
2473510260,460000,5,2.5,3390,9760,1,1750,1640,1978
5056500260,440000,4,2.25,2160,8119,1,1080,1080,1966
8682280260,412250,2,2,1300,2983,1,1300,0,2006
7338000800,185000,3,1.5,1280,4031,2,1280,0,1985
3260701160,286500,3,2,1840,8140,1,1040,800,1975
3793500510,422000,4,2.5,3200,6691,2,3200,0,2002
9485950340,408000,3,2.25,2800,35362,2,2800,0,1985
2011400662,306500,2,1,1390,19988,1,1390,0,1949
6699940320,359900,4,2.5,2600,5188,2,2600,0,2005
6134500070,560000,3,2.5,1960,6058,2,1960,0,2002
8807810890,259875,3,1,1250,21303,1,1250,0,1970
8807810890,385000,3,1,1250,21303,1,1250,0,1970
6453300055,188000,1,1,550,16345,1,550,0,1945
1118001820,1.142e+006,4,3.25,2500,5801,1.5,1960,540,1926
8570900023,255000,3,1,1250,10094,1,1250,0,1927
0629000510,1.185e+006,4,2.75,3020,8622,2,3020,0,1976
2028701000,635200,4,1.75,1640,4240,1,920,720,1921
7147400045,355000,3,1.75,1870,8250,2,1870,0,1956
3180100023,544000,3,2.5,1760,1755,3.5,1760,0,1998
1032000079,402000,3,1.5,1320,3145,2,1320,0,1998
7010700860,575000,4,1.5,1430,4163,1.5,1430,0,1910
5547500070,216000,3,1.75,1580,9705,1,1580,0,1977
7237501040,1.2e+006,4,3.5,4170,9748,2,4170,0,2004
7284900030,850000,4,3.25,3090,6744,2,3090,0,1923
3277801646,238000,3,2,1020,1204,2,720,300,2004
8722101370,625000,4,1.75,2180,4431,1.5,2020,160,1912
2436200200,1.11e+006,5,3.25,3350,4000,2,2510,840,1997
2716600273,820000,3,2.5,2510,5503,2,2510,0,1995
1795700030,355000,3,2.5,1880,5290,1,1250,630,1974
9421500160,495000,4,1.5,1810,7998,1,1210,600,1960
4139910030,1.3e+006,5,2.5,4170,33310,2,4170,0,1991
3080000030,398750,3,2.5,2230,4000,2,2230,0,1954
2568200070,835000,4,2.5,3650,7784,2,3650,0,2006
1546600565,705000,6,2.75,2830,10579,1,1430,1400,1967
9187200045,625000,4,1.5,2120,5000,2,2120,0,1900
8078450340,550000,4,2.5,2090,6926,2,2090,0,1990
9297301535,540000,3,1.5,2600,5085,1,1400,1200,1940
6431000196,519000,2,1,830,2820,1,830,0,1920
9406520260,311000,4,2.5,1975,8734,2,1975,0,1996
9510900140,305000,4,2.5,1900,7000,1,1420,480,1968
7932600140,395000,4,2.75,2640,35070,1.5,2640,0,1963
7864500140,275000,4,1.5,1610,6923,1,1010,600,1969
3629960550,450000,3,3.25,1770,1863,2,1430,340,2003
2239000016,324000,2,1,1070,6000,1,1070,0,1955
1069000070,2.795e+006,5,3.25,4590,12793,2,3590,1000,1928
1972201550,565000,4,1,1540,2452,1.5,1540,0,1906
5469000140,373000,4,1.75,1590,7920,2,1590,0,1960
7871500685,613000,2,2,1170,1890,1.5,1170,0,1927
7214820200,614000,4,2.25,2880,9996,1,1920,960,1981
6072300800,595000,4,1.75,2510,8989,1,1680,830,1964
6817801040,440000,2,1,1280,12086,1,850,430,1983
6117500160,425000,3,1.5,1570,12412,1,1570,0,1954
5100401516,407000,2,1,740,6380,1,740,0,1912
6751100125,472000,3,1.5,1740,9038,1,1740,0,1955
2771602420,472000,3,2.5,1180,1262,3,1180,0,2010
3585900045,1.25e+006,5,2.75,2960,28300,1,2160,800,1959
2492200055,412000,3,1.75,1880,5752,1,940,940,1945
0461004730,717000,3,1,1150,5000,1,1150,0,1959
4038000055,425000,3,1,1320,7076,1,1320,0,1959
4338800685,299999,4,2,1640,7200,1,820,820,1944
2215901230,254000,3,2,1470,7694,1,1470,0,1992
2730000270,178500,3,1,900,10511,1,900,0,1961
2397100560,800000,3,1.75,1510,3600,1,1230,280,1910
5100403754,420000,3,1,1440,5623,1,720,720,1922
5634500891,319900,2,1,1380,9251,1,1380,0,1940
3834000004,350000,2,1.5,1150,7552,1,1150,0,1944
5569700075,968000,6,2.75,3610,17580,1,2070,1540,1959
0476000338,491000,3,2,1250,1306,3,1250,0,2000
3299610260,948000,3,2.5,3510,9824,2,3510,0,2002
4441300075,900000,3,2.5,2260,9577,2,1700,560,1925
1796200140,270000,3,1.75,2840,9800,1,1420,1420,1977
5029451230,198000,3,1.5,1430,7347,1,820,610,1980
2523039282,250000,2,1,1420,21158,1,1420,0,1953
3629971290,615000,4,2.5,2120,3720,2,2120,0,2004
8078350520,550000,3,2.5,2080,7749,2,2080,0,1988
3395380200,190000,2,2.5,1370,3438,2,1370,0,1987
1687910200,629000,4,2.25,1900,11171,1,1280,620,1984
3818700016,434000,3,1.75,1660,8301,1,1660,0,1955
9842300036,415885,3,1,1310,4163,1,1310,0,1964
4206901550,550000,3,2.5,1840,3035,1,920,920,1926
3878900681,272000,1,0.75,1040,6034,1,580,460,1991
2195700270,665000,3,2.5,2610,35000,2,2610,0,1988
2824059128,510000,3,2,1990,7405,1,1990,0,1971
7635801370,530000,3,2,3080,17700,1,1740,1340,1965
1775910270,355000,3,1,1200,16000,1,1200,0,1970
5245400030,255000,4,1,1250,9102,1,1250,0,1955
2600400030,790000,4,2.75,2640,9000,2,2640,0,1990
3860900111,695000,5,1.75,1790,9335,2,1790,0,1952
9558800030,255000,2,2,1140,8400,1,1140,0,1954
0255000270,410000,3,2.25,1790,5794,1.5,1380,410,1985
3526039074,650000,4,2.75,1910,16532,1,1420,490,1940
4083304355,675000,4,1.75,1530,3615,1.5,1530,0,1913
6840701610,332888,2,2.5,1050,1029,2,950,100,2007
2212200270,300000,3,1.75,1730,6900,1,1130,600,1976
2203500140,320000,4,1.5,1100,11824,1,1100,0,1954
9353301070,342500,5,2.25,2100,10726,1,1050,1050,1963
1326059185,752875,4,2.5,2800,72309,2,2800,0,1992
0046100350,1.73e+006,5,3.5,5000,26540,2,3410,1590,2008
7987400316,255000,1,0.5,880,1642,1,500,380,1910
3971702325,244000,3,2.5,1470,9337,2,1470,0,1991
7419500200,1.42e+006,5,3.25,3950,11438,2,3430,520,2006
0923049468,218000,3,1,980,12812,1,980,0,1956
5589300435,359000,4,1,2180,10617,1.5,2180,0,1950
3303990030,840000,4,2.75,3040,13559,2,3040,0,2003
2926069083,900000,5,3.75,4130,226076,2,3170,960,1985
3622059157,205000,4,1.75,1850,65340,1.5,1850,0,1972
5466350160,205000,3,2.5,1600,7295,2,1600,0,1993
4174600262,500000,2,1.5,2070,5432,2,1370,700,1951
9477940390,510000,4,2.5,3180,5405,2,3180,0,2001
1126069045,1.135e+006,6,4.25,6900,244716,2,4820,2080,2002
6096500105,1.545e+006,4,2.25,2640,3000,2,2080,560,1908
2923069037,210000,3,1.5,1920,61014,1,1920,0,1953
5649300160,597500,3,1.75,2030,32565,1,1600,430,1981
3121059036,400000,2,1,1140,101529,1.5,1140,0,1932
6136900045,412000,3,1,1660,6992,1,1260,400,1952
2426039247,299950,2,1.5,1390,1756,3,1390,0,2005
8818400340,1.081e+006,4,3,2490,4325,1.5,1690,800,1922
7429000240,422500,4,2.5,2550,8824,2,2550,0,1990
3888100030,410000,3,2,1270,10227,1,1270,0,1968
5699000070,1.4e+006,4,3.25,2980,7000,2,2140,840,1900
8731982470,245000,3,2,1470,8000,1,1470,0,1974
6899990200,720000,4,3,3550,12327,1.5,2180,1370,1990
4154300505,315000,2,1,780,7200,1,780,0,1935
9268710140,191950,2,2.5,1390,1302,2,1390,0,1987
9290860140,455000,4,2.5,2440,5001,2,2440,0,2005
5708500270,523000,3,1.5,1260,3135,1.5,1260,0,1931
0016000200,250000,3,2.25,1640,4420,2,1640,0,1918
1352300520,294000,3,3,1670,4120,1.5,1140,530,1929
5207200160,490000,3,2.25,2380,6000,1,2040,340,1961
9284800844,310000,4,1,1030,5750,1,1030,0,1971
5602000105,265000,3,1.5,1560,10489,1,1560,0,1961
3585220340,402000,4,1.75,1640,10500,1,1010,630,1968
0220069083,705000,2,2.5,2200,188200,1,2200,0,2007
5104531290,589450,4,2.5,3190,7941,2,3190,0,2005
8125200273,219950,3,1.5,1200,8404,1,1200,0,1964
3176600105,750000,3,2.25,2250,5301,2,1510,740,1975
6821101275,478000,2,1.75,1960,6000,1,980,980,1904
5379802090,170000,3,1,1250,7015,1,1250,0,1958
3211240320,489950,4,2.25,2640,31941,1,2640,0,1986
0486000520,1.37e+006,2,2.25,2460,16940,1.5,1930,530,1936
0705710640,319950,3,2.5,1700,7000,2,1700,0,1996
2185000685,208417,2,1,840,4200,1,840,0,1938
7518502030,410000,4,2,1900,5100,1,950,950,1914
4078300024,590000,4,2.75,2160,4205,1,1080,1080,1969
6071400710,648000,3,1.75,1610,10229,1,1610,0,1961
4136950200,255000,3,2.5,1720,6194,2,1720,0,1998
9527300200,465000,4,2.75,2190,3267,2,2190,0,2004
6071000310,622000,4,1.75,3020,10714,1,1510,1510,1958
9183702220,306000,3,1.75,1980,9800,1,1980,0,1991
0369000045,617000,3,2.5,1880,5500,2,1880,0,1947
2826049117,438750,3,1.75,1610,6480,1,1610,0,1947
0811000055,1.28e+006,4,3,3260,4500,2,2300,960,1930
7154200070,995000,5,3.25,3970,8029,2,2970,1000,1979
2303900045,1.58e+006,4,2.5,4570,74487,2,4570,0,1948
1254200045,635000,5,2.75,2620,5500,1.5,1710,910,1911
8731730710,215000,3,1,1180,9000,1,1180,0,1970
9528104109,530000,3,2.5,1365,1090,3,1315,50,2003
3298700012,295000,2,1,720,4125,1,720,0,1943
7967700570,245000,3,2.25,1350,6775,1,930,420,1981
1402200140,400000,6,2.5,3060,17112,1,1530,1530,1967
3797300140,303000,3,2.75,1850,8820,2,1850,0,1993
2481200140,330000,3,1.75,1320,9675,1.5,1320,0,1970
3582900310,700000,3,1.75,1990,13000,2,1990,0,1980
1352300990,126000,1,1,610,4400,1,610,0,1922
1525059074,850000,4,1,2500,35802,1.5,2500,0,1955
3876000710,405000,3,2,1440,7425,1,1440,0,1965
1994200260,869900,6,4.5,2750,4400,2,1770,980,1987
1121000058,485000,3,1.75,1790,6775,1,1790,0,1951
1407300012,400000,2,2,1050,1173,2,720,330,2004
1565930070,299950,3,2.5,1780,4650,2,1780,0,2011
3574900030,585000,4,2.5,2200,9099,2,2200,0,1994
5100401441,495000,4,2,1720,5413,2,1470,250,1938
3629940160,2.2e+006,5,4.5,5840,17168,2,4570,1270,2006
7715800390,447000,3,2.25,1520,14080,2,1520,0,1984
1682000160,206000,3,1,1320,9239,1,1320,0,1968
0952007055,500000,3,1,1070,4600,1,950,120,1930
3790700070,302500,4,2.5,1990,5511,2,1990,0,1994
3134100023,1.25e+006,4,4.25,4980,13000,2,3080,1900,1982
1862400292,391000,2,1,890,5423,1,890,0,1946
4123800270,250000,3,2,1440,5457,2,1440,0,1986
3448700070,435000,4,2.5,2440,5350,2,2440,0,2003
9133600135,160000,4,2.25,1800,14722,1,1440,360,1962
6163901913,451000,5,3,2260,6508,1,1330,930,2003
1446403305,206000,2,1,810,7158,1,810,0,1944
0059000445,590000,4,2.75,2240,5400,2,1540,700,1940
7510700030,695000,3,2.5,4560,17622,2,3800,760,1986
1722059222,350000,3,1.5,1550,40752,1,1550,0,1954
8127700132,1.2363e+006,5,3.5,3180,4628,2,2420,760,2001
1774000030,395000,6,2.25,2950,11200,1,1700,1250,1970
4058800135,419000,5,3,2190,9652,2,2190,0,1999
8682281600,592350,2,2,1570,4665,1,1570,0,2006
8562740520,855000,5,3.25,3420,5669,2,2620,800,2003
3982700125,771000,4,2.5,2420,7200,2,2420,0,1991
1120069036,325000,3,2.25,1570,43350,1,1570,0,1967
3592500800,1.85e+006,5,3.25,3680,6060,2,2630,1050,1925
7905200310,545000,4,1.75,1910,6731,1,1210,700,1953
7577700136,615000,3,1.75,1780,5175,1,990,790,1927
2629600016,625500,2,1,2160,7439,1,1300,860,1953
9262800002,232000,3,1.5,1460,15000,1,1460,0,1966
2892700041,168000,3,1.5,1370,7439,1,1370,0,1963
2892700041,238000,3,1.5,1370,7439,1,1370,0,1963
4136950070,260000,3,2.5,1500,7401,2,1500,0,1998
2354300550,460000,3,1.75,1210,7500,1,1210,0,1951
7740100260,900000,3,2.5,2850,11535,1,1680,1170,1952
6163901352,289950,3,1,1090,8280,1,1090,0,1947
2025700200,265000,3,1.75,1450,5858,1,1450,0,1991
1775801090,465000,4,2.25,1820,20349,1,1340,480,1977
1138000070,370000,3,1.5,1320,7201,1,1320,0,1971
1823049046,240000,2,1.5,1670,9880,1,1670,0,1941
7227801580,232000,4,2,1440,5911,1,1440,0,1943
4364700875,237502,3,1,980,7560,1,980,0,1951
8127700390,1.28e+006,4,3.5,4340,5500,2,2850,1490,2008
9560500105,957000,4,2.25,2860,11545,1,1430,1430,1966
8651411420,218000,3,1.5,1140,4875,1,1140,0,1970
1274500240,205000,3,1.5,1120,8366,1,1120,0,1968
3278602190,350000,3,3.25,1460,1592,2,1130,330,2006
0873900240,256000,4,2.5,2050,5787,2,2050,0,2002
3834000520,275000,3,1,1250,7654,1,1000,250,1952
4224100030,372000,4,2.5,2520,9604,2,2520,0,1990
5710500060,688888,3,3.25,2580,9825,1.5,1760,820,1978
0203101370,170000,2,1,1200,24792,2,1200,0,1976
4039300140,530000,5,2.25,2140,7910,1,1070,1070,1962
3629920990,905000,4,3.25,3440,7661,2,3440,0,2006
6882510060,365000,4,2.5,1800,5070,1,1080,720,1979
2597150270,312000,4,2.5,1790,10584,1,1290,500,1981
4365200445,400000,2,1.75,1250,7680,1,1250,0,1922
6145601819,278750,2,2,800,5765,1,800,0,1936
3447000030,510000,3,2,1410,11995,1,1410,0,1965
4442800162,527700,2,2.25,1330,806,3,1330,0,2009
1698900075,740000,4,2.75,2890,4000,1.5,2190,700,1931
9432750070,512000,4,2.5,2550,17209,2,2550,0,1996
3204850140,362000,5,2.5,2880,8216,2,2880,0,2001
1446401550,225000,3,1,660,6600,1,660,0,1940
3904901840,491500,3,2.25,1470,4322,2,1470,0,1985
3299200075,429950,4,1.75,1700,10230,1,1320,380,1959
2206500550,375000,3,1,1040,9800,1,1040,0,1955
2112700370,199400,2,1,880,4000,1,880,0,1916
4397010350,364900,4,2.5,2490,9346,2,2490,0,1996
4364700885,324950,3,1.5,1210,7560,1,1210,0,1941
1498301672,467000,5,2,2080,4000,1,1040,1040,1909
3992700326,380000,3,1,1380,5400,1,1380,0,1954
5438000060,250000,3,2.25,1620,10850,1,1620,0,1966
9550200370,700000,4,1,1680,4021,1.5,1680,0,1921
3977630270,206990,3,1,1330,9620,1,1330,0,1976
0475001000,670000,3,1.75,1730,3400,1,970,760,1928
3426059050,315000,2,1,790,6969,1,790,0,1955
4137000070,319950,3,2.5,2240,7500,2,2240,0,1985
2759500105,419000,3,1.5,1500,8272,1,1500,0,1958
4137010310,205000,3,2,1800,11419,1,1800,0,1989
5616000030,335000,4,2.5,1980,4745,2,1980,0,2004
9266700295,397000,3,1.75,1340,5100,1,1340,0,1953
9828200187,370000,2,1,750,2020,1,750,0,1908
6061400160,330000,4,2.25,1790,9920,1,1170,620,1969
4139420640,1.785e+006,4,3.5,5490,14300,1,2910,2580,1996
4022900197,399000,3,2,1940,16300,1,1140,800,1978
3221069035,400000,4,1.75,2670,189486,2,2670,0,1972
2591730200,249900,3,2,1220,6404,1,1220,0,1994
9165100260,717000,3,1.5,1310,3880,1,1090,220,1956
5201810060,319000,4,2.5,1930,8336,2,1930,0,1995
5499200060,635000,4,3,2100,3800,2,2100,0,1972
1568100060,355000,3,1,1180,7573,1,1180,0,1977
4139910160,1.6e+006,5,3.25,4320,32840,2,4320,0,1990
6743700060,585000,4,1.75,3140,12519,1,2320,820,1951
7258200060,320000,3,2,2320,7800,1,1160,1160,1960
5127000810,305495,3,1.75,2110,10200,2,2110,0,1966
2011400520,240000,4,2,1790,14690,1,1670,120,1960
1953400510,199950,5,2.5,1740,8750,1,1740,0,1959
2450500060,1.62e+006,4,3.25,3820,8114,2,3820,0,2005
2623039082,770000,3,3.5,2050,21744,2,1750,300,1930
3204400030,255000,4,2.25,1680,3179,2,1680,0,2002
2473370890,289000,4,2.25,1930,8925,1,1930,0,1974
3343901401,494500,4,3,3760,8804,2,2470,1290,2002
4376700030,746000,3,2.25,2370,9619,1,1650,720,1973
1072000400,385000,4,3,2120,13000,2,2120,0,1978
2193330030,688100,4,2.5,2370,10513,2,2370,0,1987
4083300070,870300,4,2.5,2350,3150,1.5,1690,660,1910
2241700075,310000,3,1,1180,8474,1.5,1180,0,1956
9250900111,500000,3,2.5,2270,5654,2,2270,0,1999
9412700160,255000,3,2.25,1830,7770,1,1400,430,1977
1118001360,1.475e+006,3,2.75,3910,7080,1,1970,1940,1949
4383500030,154500,3,1,890,9465,1,890,0,1957
2558630060,425000,3,2.25,1820,8058,1,1260,560,1974
1150000400,700000,4,2.5,2440,7491,2,2440,0,1988
5244801275,410500,2,1,1110,3943,1,740,370,1916
1839920160,432000,3,2,1870,7080,1,1210,660,1969
9834200030,530000,3,1.5,1240,4080,1.5,1240,0,1914
3288200710,465000,3,2,1560,8640,1,1560,0,1967
3904980320,498688,3,2.5,1910,5600,2,1910,0,1989
2927600435,573500,3,1,2200,21450,1,1600,600,1952
1321740260,349900,4,2.75,2530,13474,2,2530,0,1994
7809200055,220000,3,1,1130,12519,1,1130,0,1958
3298700671,260000,2,1,820,6771,1,820,0,1918
1231000640,290000,2,1,960,4000,1,960,0,1918
1498303905,615000,4,1.5,1980,3240,1.5,1780,200,1930
7491010060,730000,4,3.5,3370,5638,2,2250,1120,2001
8835800350,1.95e+006,4,3.25,7420,167869,2,7420,0,2002
8856960260,332500,3,2.25,1800,10500,2,1800,0,1995
1088810160,650000,5,3.5,3990,10120,2,2820,1170,1990
3931900510,1.4e+006,4,2.5,4070,7800,3,3390,680,2002
9567800435,465000,4,1.75,1640,7194,1.5,1480,160,1915
2806000560,690000,4,3.25,3730,11820,2,2460,1270,1990
2473101360,289900,3,1.75,1220,7004,1,1220,0,1966
2288900140,1.62e+006,3,3.5,3490,4000,2,2570,920,2009
9320990140,339950,3,2.5,1730,4286,2,1730,0,1999
8731982050,367999,4,2.75,3430,8000,1.5,3430,0,1972
0705700240,380000,4,2.5,2320,10079,2,2320,0,1994
4335000030,440000,3,1.75,2030,17100,1,2030,0,1953
2806300070,975000,5,4,4850,36450,2,4850,0,1977
5631501323,309500,3,1.5,1340,13560,1,1340,0,1968
3738900105,350000,3,1,1130,8201,1,1130,0,1948
2781270400,215000,2,2,1180,2521,2,1180,0,2005
3336001360,254000,2,1,910,6000,1,910,0,1943
2464400435,567000,3,1.75,1630,4275,1.5,1630,0,1908
2025049114,402000,2,1,710,1173,2,710,0,1943
1523089012,365000,4,1,1520,80150,1,1520,0,1948
7305300695,625000,4,2.5,2820,8408,2,2820,0,2014
9269200340,432000,4,1.75,1970,5160,1.5,1970,0,1942
1402100070,335500,5,3,2240,19090,1,1700,540,1968
2998300060,672500,2,1.75,1860,5940,1,1020,840,1956
8113101000,336000,4,1,1780,4310,1.5,1780,0,1919
1388600070,294400,4,2.5,1788,10183,2,1788,0,1990
8944600060,541900,3,2.5,1880,3054,2,1880,0,1988
8860310240,505000,3,1.75,2300,11400,1,1520,780,1977
8016250060,255000,3,2.5,1610,6176,2,1610,0,1994
2061800045,435000,6,2.5,2270,11970,1,1470,800,1964
2652500070,636000,2,1.75,1230,3600,1.5,1230,0,1925
3622069114,655000,4,3.5,3420,33106,2,3420,0,2004
4438000075,280500,3,1.5,1670,6988,1,1370,300,1953
2776600002,520000,2,1,1120,6141,1,900,220,1946
0241900060,354000,4,2.5,2580,5476,2,2580,0,2005
5151800045,810000,5,2.75,3847,17654,1,2299,1548,1975
3221059036,400000,4,2.5,3630,42884,1.5,2300,1330,1979
7504020960,879900,4,2.75,3580,12000,1,1840,1740,1979
1924059319,1.288e+006,5,4,4050,11358,2,2780,1270,1980
4067600160,902500,3,3.5,3240,23522,2,2130,1110,1992
9828700685,900000,3,1.75,1540,8400,1.5,1540,0,1902
4307330070,419500,4,2.5,2550,7200,2,2550,0,2003
6822100310,685000,4,2,2340,6000,1,1270,1070,1953
3295900520,429950,4,2.5,2320,4524,2,2320,0,2004
1773100310,464950,4,2.5,1640,6000,2,1640,0,2011
9407000990,239900,2,1,910,9000,1,910,0,1983
1472800160,406250,4,3.25,2550,11524,2,2550,0,1990
7787110370,447000,4,2.5,2660,8027,2,2660,0,1997
3041700570,466800,3,2.5,1480,14250,2,1480,0,1996
3999200310,674000,4,2.5,2810,11560,1,1740,1070,1962
1931300955,525000,1,1,830,3200,1,830,0,1924
2591720160,674950,3,2.75,3510,92347,2,3510,0,1990
8691510310,374900,3,2.5,2480,4950,2,2480,0,2004
9831200520,1.44392e+006,4,3,3720,5000,2.5,2720,1000,1905
8123710070,559500,3,2.25,2150,9250,2,2150,0,1984
7852170370,522500,3,2.5,2370,7875,2,2370,0,2003
3528000310,1.13e+006,5,2.5,4310,28008,2,4310,0,1988
6403500570,498500,5,2.75,2990,7420,2,2990,0,1996
6021501420,571000,4,1,1350,4000,1.5,1350,0,1930
0723069128,543000,2,2,2370,217800,1.5,1600,770,1992
3329530030,271920,3,2,1410,10248,1,1410,0,1985
0723049326,104950,2,1,1170,8254,1,1170,0,1949
7215721070,485500,4,2.5,1800,4500,2,1800,0,1999
3179101580,1.21e+006,4,2.75,3650,6982,2,2530,1120,1951
2025700270,260250,3,1.75,1490,8357,1,1490,0,1993
8691300260,875909,4,2.5,3610,13292,2,3610,0,1996
5112800060,455000,4,1.75,2050,94525,1,1250,800,1959
2112700240,309000,3,1,1092,7500,1.5,1092,0,1918
8732190990,229000,4,2.25,2010,7688,1,1170,840,1979
0537000416,250000,3,2,1680,7900,2,1680,0,1953
3761700251,600000,4,2,2510,38141,1,2510,0,1960
0625100181,535000,4,2.5,2280,65836,2,2280,0,2004
7202261260,571000,3,2.5,2510,5186,2,2510,0,2001
7856410030,1.03e+006,5,2.75,3190,16920,1,1690,1500,1976
8128600060,600000,4,3.25,4690,14930,2,3680,1010,1995
1775800860,469500,3,2.25,1850,12000,1,1300,550,1977
3303980140,1.15e+006,4,3,4160,13170,2,3040,1120,2001
4206901200,785000,4,1.5,2220,4000,1.5,1970,250,1925
0011500240,872750,3,2.5,2870,13695,2,2870,0,1991
6383500295,900000,4,2.75,3950,10214,1,2050,1900,1955
7849202220,350000,2,1.75,1740,6620,1.5,1740,0,2002
2260300060,2.575e+006,5,3,4780,20440,1,3660,1120,1975
7701950060,940000,4,2.5,3160,39960,1,3160,0,1980
5153200486,185000,5,1.75,1990,27810,1,1990,0,1955
0205000310,850000,4,3.5,3920,37122,2,3920,0,1996
0920069053,201000,3,1,960,15273,1,960,0,1963
6141100445,499000,2,1.5,1540,6549,2,1540,0,1980
8809200070,315000,4,2.5,1970,5190,2,1970,0,2002
3905080310,509950,3,2.5,1880,4668,2,1880,0,1993
0393000311,286300,3,2.75,2000,6405,1,1260,740,1964
3127200036,590000,3,2.5,1990,8325,2,1310,680,1997
0123039128,325000,4,1,1400,9384,1.5,1400,0,1948
2896310160,625000,4,2.5,3190,27806,2,3190,0,1997
5272200045,378000,3,1.5,1000,6914,1,1000,0,1947
9211500520,239950,3,1.75,1670,6900,1,1170,500,1978
3589500260,550000,4,2,2100,4500,1,1060,1040,1924
3330500335,325000,2,1,1010,6180,1,1010,0,1903
9445300045,831000,4,2.5,2030,3905,1.5,1630,400,1926
0114100354,249000,3,1,1090,10296,1,1090,0,1950
1775920340,484000,4,1.75,2440,16730,1,1390,1050,1976
8946700140,395000,4,3,2500,6278,2,2500,0,2002
8651610240,839900,4,2.5,3420,7462,2,3420,0,2002
1237500105,760000,4,2.5,2850,11000,2,2850,0,1998
9151600106,750000,4,1.5,2030,3300,1.5,1530,500,1927
1118000340,3e+006,5,3.75,4590,11265,2,3450,1140,1927
7853230570,440000,3,2.5,2230,5800,2,2230,0,2004
4353700200,501000,2,1.75,1810,7523,1,1170,640,1962
7228501805,739000,6,4.5,4000,7500,2,4000,0,1978
9541800075,685650,3,1.75,1490,16200,1,1490,0,1958
3425069083,1.005e+006,4,4.5,4225,284011,2,4225,0,1985
7613700270,980000,4,1.75,2120,4000,1.5,1920,200,1929
6882200140,275000,3,1.5,1030,7184,1,1030,0,1968
2473380400,319950,4,1.75,2310,8045,1,1650,660,1976
3579000370,448500,3,2.25,1830,7943,2,1830,0,1985
2623029078,437000,5,2,2120,137565,1.5,2120,0,1913
3124049196,330000,4,1.5,2500,9448,1,1250,1250,1966
3374500240,365000,3,2.5,2470,7700,2,2470,0,1990
8911000445,329000,2,1,940,7700,1,940,0,1916
1066100260,681500,5,2.75,3260,11700,1,1630,1630,1964
7205850030,566000,3,2.25,1660,10140,1,1370,290,1980
1330910370,897500,4,3,4370,217882,2,4370,0,1984
0011520370,738000,3,2.5,2620,9112,2,2620,0,1995
3327000070,185000,3,1.75,1500,7800,1,1500,0,1968
2594200350,445000,2,1,910,7200,1,830,80,1936
2724049185,175000,3,1.75,1430,4920,1,1430,0,1957
3123800125,315000,2,1,900,8556,1,760,140,1941
3298200320,445000,4,1.75,1250,7400,1,1250,0,1959
2068000270,1.4e+006,5,3,3850,14990,1,2290,1560,1964
7732500700,832500,4,2.5,3450,35100,2,3450,0,1987
7851990240,771150,4,3.5,3950,12320,2,3950,0,2001
3423049269,225000,4,1.5,1950,12559,1.5,1950,0,1939
7852150200,389950,3,2.5,1700,6396,2,1700,0,2003
7853230270,435000,3,2.5,2370,6082,2,2370,0,2004
1965200075,845000,3,1.75,1600,2538,2,1600,0,1929
1959700445,1.3e+006,4,1.75,4060,5500,2,2660,1400,1924
1250200765,350000,3,2.25,1322,1796,2,1087,235,2005
3275300270,250000,3,1.75,1140,10400,1,1140,0,1983
7548300751,370000,2,1.5,1280,2096,2,1080,200,2007
9526600260,750000,4,2.5,3080,4553,2.5,3080,0,2008
2880100240,439950,2,1.75,1210,3000,1,910,300,1906
5253300320,395000,4,1.75,1950,10219,1,1950,0,1962
2291400566,375000,4,1,1450,6820,1.5,1450,0,1947
0103400160,263000,3,2.25,1590,7748,2,1590,0,1991
1951600240,185000,3,1,1240,9198,1.5,1240,0,1959
0224069129,500000,3,1,1440,54315,1,790,650,1974
5608000860,920000,4,2.5,3470,10045,2,3470,0,1993
0424069271,936000,7,3.75,5100,21802,2,3640,1460,2001
8964800390,1.5e+006,3,1.75,2430,12757,1,1340,1090,1952
7533800885,1.1e+006,3,2.25,2420,7200,1,1420,1000,1948
2312400200,247000,3,2.5,1510,10875,1,1150,360,1990
3226049267,289500,3,1,1200,5525,1,1200,0,1947
7852130640,432500,3,2.5,2240,6396,2,2240,0,2002
9530101535,680000,3,1.75,1870,4320,1,970,900,1920
6822100030,589000,3,1,1110,6000,1.5,1110,0,1932
1090000036,756450,4,2,3210,8400,1.5,2040,1170,1914
6619910260,536650,3,1.75,2090,8910,1,1230,860,1975
0342000036,540000,3,2.25,1320,1800,2,1320,0,1994
3448002267,385000,3,1.75,1340,3850,1,1340,0,1960
7974200765,485000,3,1,1020,6120,1,1020,0,1941
7230400400,240000,3,2,1220,17652,1,1220,0,1980
7230400400,415500,3,2,1220,17652,1,1220,0,1980
2028700575,550000,3,2,1390,2688,1.5,1390,0,1915
4232400400,1.26e+006,4,2,2970,5400,2.5,2970,0,1900
0792500260,430000,2,2,1440,213008,2,1440,0,1990
2493200370,415000,2,1.75,1550,4257,1,830,720,1953
0844001052,365000,4,2.5,1904,8200,2,1904,0,1999
7696610240,257000,4,1.5,1400,8500,2,1400,0,1975
3630110370,420000,3,2.5,2140,3821,2,2140,0,2005
1217000270,338995,3,1.75,1320,9450,1,1320,0,1943
9441300030,615000,3,1.75,2620,8280,1,1330,1290,1948
2991000160,312500,4,0.5,2300,5570,2,2300,0,1996
6641020160,513000,4,2.5,2000,5684,2,2000,0,1996
2998300075,857500,4,2.75,2960,5040,2,2210,750,1952
5456000570,1.06e+006,3,2.75,2700,22343,1.5,2700,0,1977
7784400070,585000,3,1.75,1740,9500,1,1150,590,1958
2781250400,350500,2,2.5,1770,4950,1,1770,0,2003
3821400200,215000,3,2,1290,9312,1,1290,0,1947
3580900200,440000,4,2,1450,8400,1.5,1450,0,1962
5466750140,270000,3,2.25,1420,7800,1,1130,290,1985
8122100160,385000,3,0.75,1330,7020,1,1330,0,1924
9523102447,688500,3,1.75,1760,4125,1.5,1760,0,1927
7234601525,700000,3,1.75,2010,4905,1,1230,780,1912
6071300160,585000,5,2,2560,14467,1,1280,1280,1960
8044200200,401000,2,1.5,1260,2625,2,1260,0,1983
8563050350,655000,4,2.25,2420,7725,1,1890,530,1972
1282300105,317000,3,1,1010,5400,1,1010,0,1959
3374300030,500000,4,2.5,1770,8155,1.5,1770,0,1970
9232900075,314963,2,1,890,6350,1,890,0,1943
0952000640,715000,3,1.5,1670,5060,2,1670,0,1925
7334600030,280000,3,2.25,1360,9600,2,1360,0,1992
0200500700,531000,3,2.5,2120,9736,2,2120,0,1988
0011200400,617000,3,2.5,1910,4488,2,1910,0,1998
1139000135,440000,4,1,1480,7560,1.5,1480,0,1940
7468900270,140000,3,1,1090,10114,1,1090,0,1955
1036400200,661000,4,1.75,1670,13125,1,1670,0,1973
1036400200,697000,4,1.75,1670,13125,1,1670,0,1973
3622900200,1.195e+006,5,2.75,3650,13297,2,2750,900,1969
6884800262,535000,4,2,1970,3515,1,1030,940,1969
7950302255,404500,2,2,1320,3060,1.5,1320,0,1910
3524039196,396500,3,1,1710,5110,1,1100,610,1954
2064800830,450000,3,2.25,1740,9488,1,1180,560,1977
1861400116,605000,3,3.25,2200,2400,2,1740,460,1988
7129302685,699000,3,2,2010,4320,2,2010,0,1999
4046600070,805000,3,3,3910,19023,2,3910,0,1985
8655900162,156000,1,0.75,470,15000,1,470,0,1947
2193310320,595000,4,2.5,2330,7064,1,1780,550,1984
5417600200,285000,3,1.75,1930,7200,1.5,1930,0,1929
4178900070,725000,4,2.5,3270,6055,2,3270,0,2007
2115720070,216300,3,2.5,1650,5000,2,1650,0,1985
3211100990,410000,4,2.75,2220,8450,1,1260,960,1983
5288200260,597000,2,1.75,2470,4600,1,1140,1330,1916
1771110070,325000,3,1,1300,9300,1,1300,0,1977
0274000070,355000,5,2.75,2530,9375,1,1530,1000,1966
2816900030,338000,3,1.5,2400,8215,1,1200,1200,1961
0304100070,210000,4,2.25,1500,5393,2,1500,0,1999
3876200350,423000,4,1.75,1700,9000,1,1700,0,1967
7806210070,249500,4,1.5,2120,8554,1,1170,950,1977
5437600140,325000,4,2.5,2240,5105,2,2240,0,2002
1796360370,257000,3,1.75,1540,8223,1,1070,470,1987
1428001160,550000,3,1.75,1890,100623,1,1890,0,1978
1233100260,490000,3,1,1260,9638,2,1260,0,1920
8835220200,299000,2,1.5,1160,3838,2,1160,0,1983
2023039045,295000,2,1,1300,39639,1,1300,0,1960
7504400400,630000,4,2.5,3220,14463,2,3220,0,1978
1432900310,320000,4,1.5,2020,8474,1,1010,1010,1962
9541600295,1.11e+006,4,2.5,2990,8640,1,2100,890,1959
2914700310,398000,4,1,1420,6458,1,1420,0,1953
7972604355,218000,3,1,1020,7874,1,1020,0,1956
2423069084,590000,4,2.75,2400,104108,2,2400,0,1988
8655000070,1.595e+006,5,3,3640,8239,2,2540,1100,1982
8165501620,348500,2,2.25,1550,1824,2,1550,0,2007
8682281480,592500,2,2,1870,4751,1,1870,0,2006
1137610140,505000,3,2.5,2340,5957,2,2340,0,1995
4232900310,1.43e+006,5,4.25,3350,3600,2,2260,1090,2014
0324000370,502000,3,1,1710,5000,1,1140,570,1921
3822200036,257500,2,2,1180,9265,1,1180,0,1940
3876100310,405000,3,1.5,1600,7500,1,1600,0,1966
8024201525,427000,3,1.75,1300,5111,1,1300,0,1959
4024101670,290000,3,1.5,1040,9997,1,1040,0,1955
3124049171,222000,3,1,1220,7695,1,1220,0,1954
2310100240,315000,3,2.5,2240,6097,2,2240,0,2002
8021700030,371000,3,1.5,1420,4500,1,1420,0,1959
3861500340,279900,3,1.75,1580,6620,1,1580,0,1988
1823069046,250000,3,1.5,2390,23522,1,1890,500,1938
6070500055,599000,4,2.25,2260,29930,2,1400,860,1977
0520069032,267300,3,1.75,1890,93218,1,1890,0,1964
4154303655,585000,2,1.75,1830,7200,1,1070,760,1949
3876800710,350000,3,1.75,1000,8268,1,1000,0,1969
0259000240,506000,3,1.75,2180,7700,1,1480,700,1961
1822069041,400000,6,2,2320,210830,2,2320,0,1962
7520000695,151100,3,1,840,4495,1,840,0,1921
7520000695,251000,3,1,840,4495,1,840,0,1921
2141330700,555000,4,2.25,2350,8140,1,1430,920,1977
3123039082,467500,3,1.75,2040,273556,1,2040,0,1997
7215420370,479000,4,2.5,2370,30378,2,2370,0,1996
1311000270,247000,5,2,1590,9350,1,1060,530,1962
7334500800,299500,3,1,1380,10875,1,1380,0,1977
2832100270,306888,4,1.5,1940,8970,1.5,1270,670,1980
3022079094,675000,4,2.5,3320,244807,2,3320,0,2001
2436200320,577000,2,1,1090,5265,1.5,1090,0,1947
1042500013,219950,3,1.5,1650,9936,1,1090,560,1967
3897100060,375000,3,1.5,1110,5500,1,1110,0,1940
3188100105,650000,4,2.5,2110,6820,1,1530,580,1942
2767604170,975000,3,3,1850,5000,1.5,1850,0,1900
1773100765,229000,1,1,600,3720,1,600,0,1920
1211000070,575000,5,2.5,2760,4000,1.5,1730,1030,1926
8920100041,815000,4,1.75,2970,14880,1,1560,1410,1962
0126059225,525000,3,1.75,2300,43560,1,1350,950,1979
9286100320,471000,3,2.5,2030,2805,2,1720,310,2001
4449800681,450000,4,1.75,2160,4333,1,1260,900,1942
5505700030,590000,3,2,1650,6150,2,1650,0,1926
3260590070,744000,4,2.5,3140,7260,2,2200,940,2004
3211240370,460000,4,2.25,2690,36114,2,2690,0,1986
8142000060,299000,5,2.5,1940,9389,1,1290,650,1960
5595900316,231000,4,1,1220,5120,1.5,1220,0,1940
4312700200,195000,3,1,1300,9600,1,1300,0,1975
9407001600,305000,3,1.75,1660,11500,1,1130,530,1979
5700001895,895000,4,1.5,3390,6200,2,2530,860,1916
1424200070,1.11e+006,4,1.5,2310,13300,1,1890,420,1950
1708400370,339000,2,1,950,7954,1,950,0,1941
5457801925,885000,4,3.75,2400,3520,1,1370,1030,1924
2895600350,375000,3,1,1780,5236,1.5,1050,730,1944
4036801070,367400,4,1.5,1280,7400,1,1280,0,1958
0976000879,700000,4,2,1930,5398,1,1430,500,1953
7923100400,667000,5,2.25,2560,10360,1,1870,690,1966
7129304200,200000,2,1,920,5250,1,920,0,1906
2225069062,552775,3,2.5,1900,18414,2,1900,0,1971
3343903240,452000,3,2,2270,148975,1,1270,1000,1900
5095401360,418000,3,2.5,2080,16050,1,1360,720,1978
2547200160,601500,3,1.75,1460,10128,1,1460,0,1968
0124069032,600000,3,1.75,1670,39639,1,1670,0,1976
7300400320,340000,4,2.5,2810,6481,2,2810,0,1998
7212660560,310000,3,2.5,2370,6752,2,2370,0,1994
3343902650,290000,2,1.75,1700,18000,1,1700,0,1972
3034200036,438000,2,1,1630,9255,1,1630,0,1941
1498303855,718000,4,2.75,2930,4408,1,1660,1270,1939
1446404015,200000,2,1,860,6600,1,860,0,1949
5467910140,479900,3,2,1980,12150,1,1980,0,1994
2472920800,400000,3,2.5,2080,7877,2,2080,0,1987
7147600070,219950,3,1,1060,10042,1,1060,0,1957
3820350140,300000,3,2.5,1590,3381,2,1590,0,2000
0520700125,437000,3,2.25,1980,8775,1,1290,690,1959
3211200140,350000,4,2,1720,7210,1,860,860,1971
0250000320,626000,4,1.75,1350,9293,1,1350,0,1954
6139800640,490000,3,2.5,2080,12032,2,2080,0,1978
6699000710,289000,3,2.5,2090,4700,2,2090,0,2002
7010700550,595000,3,2.5,2030,5100,2,2030,0,2008
5506500070,676000,3,2.25,2680,41804,1,2680,0,1989
3293700521,389000,3,1.75,1820,8028,1,1220,600,1980
6929604005,240000,3,2,1300,5000,1,1300,0,1983
3216900070,382500,4,2.5,2210,7079,2,2210,0,1993
7922800160,511555,3,2,1400,7293,1,1400,0,1963
6610000320,710500,3,1.75,2040,4125,1.5,1540,500,1917
5561400140,429000,3,2.5,2420,49928,2,1860,560,1985
7686202065,170000,4,1.75,1920,7500,1,1920,0,1962
4107100204,2.135e+006,4,3.25,3860,17820,1,2630,1230,1975
7214810510,480000,5,2.75,2760,7200,1,1430,1330,1979
5350201180,1.665e+006,4,3.75,3450,8395,2,2640,810,1993
8148600055,225000,3,1,1040,6535,1,1040,0,1947
0226039270,615000,3,1.75,2220,7224,1,2040,180,1975
1220069035,438950,4,2.5,2470,385506,2,2470,0,1991
7466900320,242000,3,1.75,1300,9856,1,1300,0,1962
8078430030,560000,3,2.5,1960,9686,1,1460,500,1989
9523100550,857500,3,1.5,2040,3960,2,2040,0,1928
8961970510,685000,4,2.5,3030,7864,2,3030,0,1999
3574800810,486000,4,3,2260,7336,2,2260,0,1977
7732410390,749000,3,2.5,2670,10338,2,2670,0,1987
7697870700,260000,3,2.5,1520,6298,2,1520,0,1986
9275702405,1.015e+006,3,1.75,3610,8502,1.5,2610,1000,1930
1370804461,565000,3,1.75,1130,5111,1,930,200,1942
4310702440,355000,3,2,1480,2502,2,1480,0,1991
3935900030,775000,5,2,3540,9970,2,3540,0,1970
6385800030,335000,4,2.25,2100,7305,1,1050,1050,1963
1193000390,1.3e+006,5,4,3366,7800,2.5,2966,400,1937
8605900060,545000,3,1.75,1810,3000,1.5,1810,0,1903
3964400160,540000,3,1.75,1680,4240,1.5,1680,0,1926
1455600045,687500,3,1.75,2450,9377,1,1540,910,1962
4031000520,115000,1,2,1150,9812,1,1150,0,1962
4031000520,227000,1,2,1150,9812,1,1150,0,1962
3299610240,870000,4,2.5,3240,7621,2,3240,0,2003
1727850350,1.19e+006,4,2.5,3480,12164,1.5,3480,0,1984
5416510990,375000,4,2.5,2800,5000,2,2800,0,2006
4154303215,902000,3,2.75,3240,7200,1,1620,1620,1960
0421000465,269500,2,1.5,1480,7276,1,940,540,1978
9164100105,570000,3,1,1700,4750,1.5,1200,500,1909
6300000320,359950,2,1,1240,7590,1,1040,200,1939
0824059324,1.45e+006,4,3.5,3720,8301,2,2880,840,2008
0259900320,615000,3,2.5,1910,3427,2,1910,0,2001
7888200140,250000,4,2,2120,8701,1.5,2120,0,1960
7852130550,530000,4,2.5,3020,6788,2,3020,0,2002
2824089053,474950,3,2,2250,222156,1,2250,0,1987
3935900350,490000,4,2,1650,6480,2,1650,0,1947
5347200162,210000,2,1.5,880,1157,2,880,0,2007
1953400520,265500,3,1,1860,9225,1,1860,0,1957
1251200045,1.4625e+006,5,3.25,3840,4800,3,2750,1090,2008
1858600012,310000,4,2.25,2192,12128,2,2192,0,2006
4307310400,324500,3,2.5,1590,4108,2,1590,0,2003
6708200320,599000,4,4.75,3700,11000,1,1840,1860,1962
1473060030,525000,4,2.5,3670,9958,2,3670,0,2005
6163901382,400000,3,1,1630,10304,1,1630,0,1953
0617000030,887500,3,3,4230,54977,2,3780,450,1951
2887700875,344000,2,1,1060,3325,1.5,770,290,1932
9465910030,525000,3,2.5,2700,7434,2,2700,0,1991
6918710340,385000,3,2.25,2110,8000,2,2110,0,1975
0629810560,820000,4,2.5,3720,8633,2,3720,0,1999
1025039320,1.305e+006,4,3.5,3440,5000,2,2560,880,2006
3575200030,549000,4,2.25,2420,59800,1,1350,1070,1985
3298701070,180000,3,1,1090,6771,1.5,1090,0,1929
7852011040,589000,4,2.5,2910,5776,2,2910,0,1998
1705400350,350000,3,1,1050,5518,1,1050,0,1948
7682200320,197400,3,2,1610,7575,1,1110,500,1965
3814701090,267000,3,2.5,1760,6477,2,1760,0,1986
8099800340,480000,3,1.5,1540,20281,1,1540,0,1977
5418200340,650000,4,2.5,2580,9450,1,1660,920,1959
2767601805,600000,2,1,1370,5000,1.5,1370,0,1905
8682280340,490000,2,1.75,1440,6265,1,1440,0,2005
1432900030,225000,3,1,1410,7700,1,980,430,1962
1546600125,640000,3,2.25,1980,10115,1,1980,0,1959
7560000070,710000,3,3.5,2440,3427,2,1990,450,2000
2130200160,325000,3,2,1350,11805,1,1350,0,1986
9238430140,595000,3,3.25,3130,28001,1,2210,920,1985
7116000350,128750,3,1,880,7004,1,880,0,1950
4039500390,465000,3,2.25,1920,7300,1,1240,680,1961
8031700186,710000,4,1.75,2700,7625,1,1450,1250,1937
7625702505,605000,4,2.75,1670,6000,1,840,830,1917
7511000140,994000,4,2.5,3470,20445,2,3470,0,1963
3191000030,489950,3,2.25,1820,7326,2,1820,0,1983
6150700394,365000,3,1.5,1310,8160,1,1310,0,1950
1786640030,359950,3,2,1790,7212,1,1790,0,1998
7708200400,495000,4,2.5,2460,4774,2,2460,0,2006
4406000390,255000,3,1.5,1060,9039,1,1060,0,1973
1926059094,330000,3,1.75,1340,10276,1,1340,0,1961
9413500350,450000,3,1.75,1480,8394,1,1480,0,1971
7853240310,655000,4,2.5,3500,11306,2,3500,0,2005
5152800030,485000,4,2.75,2910,16362,1,2120,790,1969
1775950030,375000,4,1.75,1940,15909,1,970,970,1974
4221250320,570000,4,2.5,2280,4534,2,2280,0,2003
6749700117,350000,3,2.25,1190,1022,3,1190,0,1998
0290000075,550000,3,1,1260,6000,1,1260,0,1951
1842100160,513000,5,2,2270,8652,1,1150,1120,1965
4365200055,450000,4,2.25,1990,7320,1,1030,960,1965
3644100030,432500,4,1.75,1500,1856,1,750,750,1901
3220079017,432000,5,2.75,2060,329903,1.5,2060,0,1989
8121200710,480000,3,2.25,1950,8892,2,1950,0,1983
3574801740,402200,3,1.75,1790,6980,1,1330,460,1980
0644000102,650000,3,1,1520,10227,1,1520,0,1951
5315100784,1.1995e+006,4,2.5,3240,13044,2,3240,0,1984
9578200030,312000,3,2,2440,13250,1,1440,1000,1977
2313900810,610000,4,2,2220,5821,1.5,1380,840,1916
1623300055,823000,5,1.75,2640,7722,1.5,1650,990,1915
9191200435,471000,4,1.75,1450,3750,1,950,500,1925
2591020560,481015,3,2.25,1550,5511,2,1550,0,1987
1923000260,1.959e+006,5,4.5,6200,23373,3,5050,1150,1988
2193300390,624000,4,3.25,2810,11250,1,1680,1130,1980
7016200030,480000,4,2.5,2080,7966,1,1200,880,1970
0727500030,815000,3,1.5,1370,8671,1,1370,0,1955
1651800030,1.65e+006,4,2.25,2920,20400,1,2920,0,1966
0623049094,180000,3,1,1000,18513,1,1000,0,1940
2538800030,156601,2,1.75,1210,9750,1,1210,0,1984
7714000310,374950,4,2.5,2790,4650,2,2790,0,2004
0254000075,368000,2,1.5,1660,4680,1,830,830,1908
1257201375,550000,3,2,1650,3952,2,1650,0,1950
8856004582,198000,3,1.75,1300,6318,1,1300,0,1980
3205400240,345000,3,1.75,1090,7200,1,1090,0,1968
3738000070,1.71275e+006,5,2.5,2660,6572,1,1960,700,1959
8856001090,185900,3,1,940,10890,1,940,0,1909
3224500240,950000,3,2.75,2750,18029,1,1810,940,1978
4139460390,995000,4,4.5,3850,13551,2,3000,850,1998
3531900060,345000,2,1,860,8250,1,860,0,1940
4457300135,741000,4,2.75,2070,10125,1,1390,680,1962
8682292090,737000,2,2.25,2290,9772,1,2290,0,2007
7278700069,668750,4,2.5,2340,6420,1,1590,750,1964
5710610800,575000,3,1.75,2680,8625,1,1590,1090,1974
8651443420,280000,4,2,1710,5440,1,1030,680,1976
7751800070,583000,3,1.5,1800,10050,1,1800,0,1955
2570600140,196000,3,2.25,1510,9600,1,1090,420,1966
1565950260,349950,3,2.5,1700,7496,2,1700,0,1994
7550801170,429000,4,1,1350,3333,1.5,1350,0,1912
6648701740,270000,5,2.5,2140,10320,1,1330,810,1967
7529500030,385000,6,4,2700,7416,1,1350,1350,1969
9523102420,535000,1,1,920,5000,1,920,0,1906
7283900521,352500,3,1.75,1500,10269,1,1030,470,1958
7519001275,624000,3,1.75,1510,5200,1,860,650,1922
1432900350,215000,5,1.5,1980,7958,1.5,1980,0,1962
1924059248,870000,4,3,4500,21780,2,3040,1460,1980
6649500060,440000,4,2.5,3220,8256,2,2610,610,2006
2254501342,518000,2,1.5,1140,1149,2,940,200,2001
2025700260,259500,3,2.25,1490,7589,2,1490,0,1993
2386000070,795127,4,3.25,4360,91158,1,3360,1000,1993
2206500105,290000,3,1,960,9000,1,960,0,1955
1953400045,385000,4,3,2253,7700,2,2253,0,1957
3996900575,259950,2,1,770,6542,1,770,0,1948
0869700350,330000,2,2.5,1310,2915,2,1310,0,1999
7387500335,280000,3,1,980,7480,1,830,150,1948
6795100563,595000,4,2.5,1820,20011,2,1820,0,1987
8001470560,925900,4,3.75,3980,7828,2,3980,0,2001
4140100200,499000,3,2.25,3010,9600,2,2410,600,1978
7212650510,325000,4,2.5,1830,7762,2,1830,0,1993
0686800070,895000,5,2.5,2550,20875,1,1610,940,1953
5126900200,162248,2,1,800,8960,1,800,0,1944
6329000070,1.0725e+006,3,2.25,2890,21480,2,1790,1100,1941
5430300171,430000,3,1.5,1810,5080,1,1030,780,1958
5430300171,615500,3,1.5,1810,5080,1,1030,780,1958
2742100016,260000,3,1,940,5650,1,940,0,1949
1324079082,295000,4,2,1810,42981,1,1810,0,1973
1422200496,1.18604e+006,3,1.75,2550,6117,2,1650,900,1951
3754500566,749950,4,2.5,2370,2971,2,2080,290,2008
5132000140,175000,6,1,1370,5080,1.5,1120,250,1931
5132000140,415000,6,1,1370,5080,1.5,1120,250,1931
6131600240,190000,3,1,1200,8316,1,1200,0,1953
2768000295,625000,3,1.75,2100,3264,1.5,1350,750,1912
4046600320,420000,3,2.25,2020,21010,2,2020,0,1995
1598600320,339900,4,1.5,1570,9210,1,1400,170,1965
4140900270,160000,2,1,1140,23030,1,1140,0,1980
5104510060,353000,4,2.5,1830,5331,2,1830,0,2002
3578400710,390000,3,2,1010,14183,1,1010,0,1982
4036400030,675000,4,2.5,1770,9858,1,1770,0,1971
6084200060,400000,3,2.5,2120,3757,2,2120,0,2006
1251200055,1.34e+006,4,3.5,3190,5040,2,2160,1030,2003
8964800860,1.65e+006,4,2.5,2780,11904,1,1730,1050,1951
9551200270,1e+006,5,3,3350,9450,2,2180,1170,1912
3226059128,850000,5,3.5,3450,28324,1,2350,1100,1972
3438500798,275000,3,1.5,1060,6954,1,1060,0,1983
9286100200,450000,3,2.5,1670,2589,2,1670,0,2000
5151600390,305000,4,1.75,2251,12731,1,1390,861,1957
4172100240,643002,3,2.5,1770,3744,1.5,1270,500,1929
5422560830,468000,2,1.75,1510,4500,1,1510,0,1978
5104520640,324950,4,2.5,1770,5000,2,1770,0,2004
8078550320,290000,3,2,1260,7346,1,1260,0,1987
8099600160,488500,3,2,1710,10959,1,1030,680,1981
7287700059,367950,3,1.75,2290,8234,1,1250,1040,1950
8862000075,285000,2,1,790,6555,1,790,0,1956
8887001625,417000,3,2.75,1820,52889,2,1820,0,1991
9464700340,1.115e+006,4,2.5,3180,31931,1,2390,790,1978
5451300117,1.55e+006,4,4,5280,17677,2,3220,2060,1978
0587550340,604000,3,2.5,3240,33151,2,3240,0,1995
2591820070,380000,3,2.5,2390,8102,2,2390,0,1986
6679000960,336500,4,2.5,2500,5264,2,2500,0,2003
9138100350,685000,4,2,2290,6000,1.5,2290,0,1900
6065300370,4.208e+006,5,6,7440,21540,2,5550,1890,2003
5315100393,670000,3,1,1600,16868,1,990,610,1946
5244800695,524000,2,1,1120,2000,1.5,1120,0,1910
3584000400,172000,3,1,1340,10260,1,1340,0,1968
6746701090,680000,6,2,1670,3000,1,900,770,1911
2421059017,549900,4,3,2830,213879,2,2830,0,1987
4053200926,357000,4,2.75,2700,49428,1,2700,0,1988
7899800045,107000,3,1.5,910,5120,1,910,0,1973
7899800045,232900,3,1.5,910,5120,1,910,0,1973
9482700075,800000,4,3.5,2370,3302,2,1610,760,1926
6300000368,248500,2,1.5,880,1498,2,880,0,1999
5135000160,670000,3,2.5,2050,6420,1,1730,320,1956
1022069050,207000,3,1.75,1180,21275,1,1180,0,1958
2599000370,164000,3,1,1070,8250,1,1070,0,1961
2652500126,570500,2,1,1380,1800,2,1080,300,1954
2923500550,599990,3,2.25,2680,9162,1,1570,1110,1978
3760100200,395000,5,1.75,2100,9599,1,1060,1040,1961
1226069045,979500,4,3.75,4133,361548,2,4133,0,2000
3935900232,207000,3,1,920,5546,1,920,0,1928
3935900232,237000,3,1,920,5546,1,920,0,1928
0224069105,650100,2,1,1750,60872,1,1180,570,1973
8087800400,385000,4,2.5,1950,7350,1,1150,800,1963
0723049301,335000,2,1.75,1660,11437,2,1660,0,1958
4136920030,347000,4,1.5,2670,10026,2,2670,0,1996
7686203385,204000,3,1,980,8000,1,980,0,1954
7922710520,615000,4,2.25,1780,10260,2,1780,0,1971
0824059293,943500,3,2.25,2370,10890,2,2370,0,1980
3959400335,560000,3,2,1640,7333,1,1020,620,1941
6072760390,547500,4,2.5,2610,7254,1,1610,1000,1975
2787700030,359500,4,1.75,2030,7210,1,1450,580,1968
6446200060,660000,3,2.5,2590,35640,1,2590,0,1987
1545800710,258000,3,1.75,1620,7540,1,1310,310,1988
3522059196,355000,3,1.75,2040,22693,1,2040,0,1980
4365200186,253500,2,1,810,4800,1,810,0,1948
2064800890,422500,3,1,1270,8920,1,1270,0,1969
9268710390,239000,2,2,1470,2052,1.5,1470,0,1986
2273600260,628000,3,2.25,1720,8521,1,1140,580,1984
9206950200,352000,2,2.5,1320,1957,1,660,660,2004
2291400341,311600,3,2.25,1358,1196,3,1358,0,2007
1311400350,235000,4,1.5,2070,7245,1,1060,1010,1964
0191100810,870000,5,2.25,2910,9525,2,2910,0,1968
7895500550,190848,4,1.5,1370,7904,1,900,470,1970
9221400335,570000,4,1.75,2340,5080,1,1170,1170,1924
6087100070,661254,4,4,2290,6250,1.5,1690,600,1940
3052700695,575000,4,2,1650,5000,1,1650,0,1955
6150200435,230000,2,0.75,650,5360,1,650,0,1931
5423040140,680000,3,2.25,2300,9914,2,2300,0,1980
0123039336,148000,1,1,620,8261,1,620,0,1939
0123039336,244900,1,1,620,8261,1,620,0,1939
1446401290,214950,3,1,1400,6600,1,1280,120,1954
8010100135,580000,3,1.5,1800,6250,1,1420,380,1947
8899000140,263000,3,1.5,1300,7885,1,1300,0,1968
2172000570,317000,5,2.5,2360,11375,1,1180,1180,1962
1471701200,302000,4,3,3320,13500,1,1750,1570,1963
9808700370,899000,3,1,1480,6978,2,1480,0,1949
0904000045,1.289e+006,3,2.5,2190,11394,1,1550,640,1956
7680400140,710000,3,3.25,3740,136915,2.5,3100,640,1990
3291800140,230000,3,1,1360,9310,1,1020,340,1980
3624039074,430000,3,1,1210,5200,1,1210,0,1941
0098001070,1.169e+006,5,4.25,4610,13252,2,4610,0,2004
5100402767,397000,3,1,860,6380,1.5,860,0,1927
2826049070,595000,3,2.5,2250,8300,2,2250,0,2003
9414610240,485000,3,1.75,2030,10089,1,1330,700,1976
4019301160,755000,5,2.5,3260,24300,1.5,2310,950,1950
1217000340,185000,3,1,1840,8100,1,920,920,1953
1217000340,340000,3,1,1840,8100,1,920,920,1953
8081650400,236000,4,2.75,2000,5827,2,2000,0,1997
9465910310,550000,4,2.5,2810,7549,2,2810,0,1992
9468200163,680000,3,2,1780,5720,1,980,800,1925
0305000310,630000,4,2.5,2540,8706,2,2540,0,1997
2624049035,560000,3,2,2340,3477,1,1170,1170,1971
8098400135,385000,3,2,1480,6600,1,740,740,1943
2291400342,280000,3,2.25,1358,1141,3,1358,0,2007
4051110240,225000,3,2.5,1750,7490,1,1180,570,1979
3024059078,610000,4,1.75,1830,29110,2,1230,600,1990
3182100105,592500,3,2,1170,6750,1,800,370,1947
6705850140,750000,4,2.75,3170,7634,2,3170,0,1992
8651442440,164000,4,1,1530,4875,2,1530,0,1977
3432500765,320000,2,1,1100,8281,1,1100,0,1947
3905100310,544000,4,2.5,2030,3974,2,2030,0,1994
1328330510,344950,3,1.75,1870,7500,1,1320,550,1978
4017050260,539500,3,2.5,3080,12476,2,3080,0,1990
2323069053,420000,4,1.75,2480,60548,1,1600,880,1968
4022900951,305000,2,1,910,22725,1,910,0,1926
6450304630,229000,2,1,810,5100,1,810,0,1955
3303960060,1.068e+006,5,3.5,3990,9938,2,3990,0,2001
0993001342,397500,3,2.25,1430,1383,3,1430,0,2005
6743700030,540000,4,2,2190,8402,2,2190,0,1928
6696800030,650000,4,2.5,2290,10186,2,2290,0,1985
4114601580,1.9e+006,6,4,3020,13237,2,2840,180,1942
2025079045,649000,2,1.75,2260,280962,2,1890,370,2005
0182000350,287500,5,2,2020,67953,1.5,1620,400,1936
8082400136,815000,4,2.75,2620,4743,1,1310,1310,1949
6352600350,795000,2,2.5,2830,8630,2,2830,0,2001
9414610070,502775,3,1.75,1700,9840,1,1200,500,1976
7812801125,222900,2,1,1110,6411,1,1110,0,1944
1121039105,399950,4,3,2150,64694,1,1450,700,1969
3591000030,728000,4,2.5,2650,13684,2,2650,0,1994
2386000240,850000,5,3.5,3870,65556,2,3870,0,1994
4254000060,525000,4,2.75,2530,17856,2,2530,0,1998
6623400193,257000,3,1,1450,7850,1.5,1450,0,1910
8944550140,433500,3,2.5,2200,3360,2,2200,0,2009
2730500140,314950,4,1.75,1890,9623,1,1290,600,1969
5490210510,500000,3,1.75,1530,14633,1,1100,430,1977
8718500560,300000,3,1.5,1590,8911,1,1590,0,1956
8651520160,645000,4,2.5,2690,18653,2,2690,0,1985
2868900160,222500,3,1,990,10125,1,990,0,1972
8062900030,275000,3,1.75,1300,8099,1,1080,220,1976
3336000626,498000,3,1.5,1720,6570,1.5,1720,0,1909
3226059083,800000,3,1.75,2080,75794,1,2080,0,1958
7212660960,297000,3,2.5,1840,8234,2,1840,0,1994
1180007375,625000,5,3.5,4010,6000,2,2560,1450,1997
1150900060,770000,4,2.5,3560,6187,2,3560,0,2003
9528102110,517000,3,2.25,1640,4635,1.5,1540,100,1930
1172000150,238000,1,1,530,6350,1,530,0,1941
1523049115,234550,3,1,1990,15375,1,1140,850,1946
4222310410,230500,3,2.25,1690,7245,1,1160,530,1973
2568300210,585000,5,2.5,2670,16777,1.5,1620,1050,1920
3131201320,733000,4,1.75,1930,3876,1.5,1450,480,1924
1982201255,357950,2,1,810,3880,1,810,0,1952
0125039025,530000,3,1.75,1550,3680,1,1050,500,1927
5379805121,377500,4,2.5,2640,10720,2,2640,0,1999
7853302520,475000,4,2.5,2320,10046,2,2320,0,2006
1921069101,399000,3,1.75,2170,73616,1,2170,0,2008
9276202160,660000,3,2,2080,5750,1,1040,1040,1926
4037500230,400000,5,2.25,2070,10488,1,1080,990,1958
1982201345,440000,2,1,800,4850,1,800,0,1944
5469500180,366400,4,2.25,2040,14383,1,1270,770,1977
1088810040,627250,4,2.5,2830,10677,2,2830,0,1993
2117700085,375950,3,1.75,1480,7560,1,1100,380,1920
9211500730,162000,3,2.25,1810,6750,1,1280,530,1978
4083801395,780000,3,2.75,1970,2600,2.5,1970,0,1924
9274201006,705000,4,2.5,2650,4316,1.5,1520,1130,1905
7205800040,450000,4,2.5,2820,15233,1,1820,1000,1972
3276180210,311000,3,2.75,1400,7880,1,1000,400,1981
3904900530,485000,3,2.5,1580,6065,2,1580,0,1985
9560800040,485000,3,2.5,1800,11034,2,1800,0,1987
5249801411,725000,5,3.75,3360,6000,2,2640,720,1963
3750603492,185000,3,1,1510,17040,1,1510,0,1975
0249000180,1.89e+006,4,4.25,4285,9345,2,4285,0,2013
1796370180,260000,3,2.25,1610,7423,2,1610,0,1990
6699940120,356000,4,2.5,2470,5074,2,2470,0,2004
3830210230,225205,3,1,1200,7220,1,1200,0,1977
9144100158,445000,3,1,1260,8910,1,1260,0,1949
3332500636,356000,2,1,920,4095,1,920,0,1914
5315100476,760250,5,2.75,2540,8250,1,1440,1100,1953
8682260610,572000,2,2,1870,5143,1,1870,0,2005
5700004525,970000,3,2.25,3060,9950,1.5,1810,1250,1930
3303950220,348450,4,2.5,1950,8628,2,1950,0,1994
7399800150,535500,3,1.5,1730,40250,2,1730,0,1983
1454600256,710000,5,2.5,2570,9600,1,1620,950,1956
0629000730,745000,3,1.75,1490,9800,1,1140,350,1947
7520400040,355000,4,2.5,2040,8265,2,2040,0,1996
2799800180,333000,4,2.5,2690,5505,2,2690,0,2004
2025701530,282000,3,2.5,1610,6000,2,1610,0,1993
1794501415,840500,3,2,2520,5400,1.5,1410,1110,1906
4038500330,432000,3,1.75,1550,8134,1,1550,0,1959
9297301065,625000,3,1,1800,4800,1,900,900,1927
0985000833,209977,3,1,1170,6134,1,1170,0,1948
3353400120,174000,2,1,900,13531,1,900,0,1979
8860310120,740000,4,2,2800,8540,1,1730,1070,1977
9547200790,518000,3,1.75,1830,4500,1.5,1830,0,1909
9136103026,539000,3,1.75,1380,3225,1,940,440,1915
5710600620,575000,3,2.75,1990,9600,1,1530,460,1978
6003001999,530000,2,1.75,1170,976,2,780,390,2010
0922059020,242025,4,1.75,1400,54014,1.5,1400,0,1935
0644200065,1.03e+006,4,2.5,2620,11200,1,1770,850,1962
6929602390,230000,3,1,880,7500,1,880,0,1978
7399000230,350000,4,2.5,2260,7500,1,1460,800,1965
3885805300,595000,3,1,1300,11520,1,1300,0,1958
0200800330,440000,3,1.75,1450,6829,1,1450,0,1983
6819100330,550000,3,1,1110,6000,1,1110,0,1904
1338600175,940000,4,2.25,1890,5940,1,1470,420,1963
8728100781,375000,3,1.5,1100,1751,2,940,160,2007
0871000515,567500,2,1.5,1350,4592,1,1070,280,1939
6446200175,735000,3,2.5,3020,50800,1,1510,1510,1968
7889600230,114000,2,1,730,5200,1,730,0,1928
2652500210,608000,2,1,1390,3600,1,1010,380,1913
7302000210,442500,3,1.5,2710,47419,1.5,2170,540,1980
6450301530,381800,4,2,1530,5250,1,1110,420,1981
7905200230,330000,3,2,2170,3978,1,1340,830,1919
1049010620,90000,2,1,790,2640,1,790,0,1973
9284802825,312000,2,1.75,1160,8625,1,1160,0,1941
3782100145,339000,3,1,1080,8100,1,1080,0,1955
8731951490,313000,3,1.75,2190,8000,1,2190,0,1967
9202650210,618080,3,2.5,2030,6500,2,2030,0,1988
2473450870,325000,3,2.25,2480,8755,2,2480,0,1979
2899200040,242000,4,1,2240,7620,1,1120,1120,1966
2644900149,364000,2,1.5,1650,7311,1,860,790,1978
0952005000,545000,3,1.75,1700,5750,1.5,1450,250,1925
7298030210,445000,3,2.5,2790,16173,2,2790,0,1988
3760500730,1.0855e+006,4,2.75,3010,10830,2,3010,0,1980
1562000120,660000,4,2.5,2550,10000,1,1290,1260,1964
9290850760,845000,4,2.5,2880,35610,1,2880,0,1989
0272000220,417000,4,2,2090,4000,1,1060,1030,1907
0418000145,213800,2,1,740,5200,1,740,0,1952
3560800040,400000,2,1.75,960,6200,1,960,0,1946
1139000035,759950,4,3.5,2100,7560,2,2100,0,2005
6681500150,990000,4,2.5,2540,5930,2,2540,0,2003
2330000035,710000,3,1.75,1650,10250,1,1650,0,1963
3095000040,315000,1,0.75,770,4600,1,770,0,1910
3343300065,515000,4,2.5,2280,14810,1,1500,780,1977
0375000230,638000,3,2,1660,3729,1,970,690,1922
7663700772,370000,4,2,2020,8100,1.5,1160,860,1946
0302000065,184000,3,1,970,14850,1,970,0,1968
6134500220,583800,3,2.5,2480,6600,2,2480,0,2002
2787700580,309500,3,1,1250,7320,1,1250,0,1968
2806300065,1.96e+006,4,4,4430,31353,2,4430,0,1998
7866500035,299000,1,1,740,5000,1,740,0,1923
7689600360,215000,2,1,710,7200,1,710,0,1943
3541600210,410000,4,2,1970,10500,1,1820,150,1961
6821600065,478000,2,1,820,6000,1,820,0,1939
7625703405,431000,2,1,1000,6500,1,1000,0,1918
6979900360,635000,4,2.5,3080,35430,2,3080,0,1997
6072100790,648000,5,2.25,2410,12000,2,2410,0,1973
4113800410,640000,3,2.5,2370,11172,2,2370,0,1993
4139450760,932808,5,4.5,4690,6705,2,3450,1240,1995
8682220150,835000,2,2,2280,6815,1,2280,0,2002
2325039057,469775,2,1.75,1530,7020,1,1030,500,1942
2459900040,587000,5,3.5,3610,52595,2,3610,0,1989
6819100150,677915,3,2,1740,3600,1,990,750,1923
7922900040,1.075e+006,4,3,3600,9200,1,2100,1500,1976
0430000035,671000,4,3,3130,5700,1.5,1750,1380,1953
7853301520,695000,5,3.25,3940,9780,2,3940,0,2007
1623049133,205000,4,2,2200,13320,1,1100,1100,1944
4024101451,350000,4,1,1510,7200,1.5,1510,0,1955
3211100730,360000,3,1.75,1560,7930,2,1560,0,1980
9542840410,313999,4,2.25,1870,4198,2,1870,0,2008
6648500580,300000,3,2.25,2070,7225,1,1690,380,1979
8665900206,452000,2,1.75,1660,11747,1,830,830,1981
3025079003,495500,3,2.5,2010,57934,1,2010,0,1978
2377000040,288000,3,1,1410,40500,1,1410,0,1961
9315100210,227490,3,1.75,1820,7194,1,1820,0,1967
4046500720,470950,3,2.5,2560,16420,2,2560,0,1989
8956000120,735000,4,2.75,2450,4187,2,2450,0,2010
2862100366,730000,7,2.75,3110,4400,1.5,2010,1100,1914
1402660150,412000,3,2.5,2210,7000,2,2210,0,1985
7853310450,589500,4,2.5,2630,6326,2,2630,0,2008
3812400455,291000,7,1,2350,8636,1,1550,800,1962
0269000970,1.3e+006,5,3.75,4450,7680,2,3460,990,2010
1788800910,190000,3,1,1200,10458,1,1200,0,1961
8820902700,456200,2,1.75,1210,7733,1,1210,0,1904
8945300040,225000,3,1,1290,8470,1,970,320,1966
3225069241,2e+006,3,2.5,3490,21064,1,2290,1200,1968
7202430150,740000,4,2.5,3360,15091,2,3360,0,1997
2070100040,467000,3,1.75,2660,5511,1,1330,1330,1948
1139000620,385000,2,1,770,7554,1,770,0,1946
0976000790,670000,3,2.5,1800,4763,2,1240,560,1985
6617500085,500000,4,2.5,2900,5760,1,1660,1240,1959
6163900971,352450,3,2,1430,6000,1,1430,0,1945
7135521530,669888,4,2.75,2550,7591,2,2550,0,1989
4036800925,405000,3,2.75,1310,7300,1,1310,0,1957
6751300065,518000,3,1.5,1430,8000,1,1430,0,1956
7192200040,280000,4,1,1880,6288,1,1120,760,1974
3629970610,435000,3,2.5,1600,2375,2,1600,0,2005
3797310230,314950,3,2,1760,9732,1,1760,0,1996
2781270210,209900,2,2,1180,3003,2,1180,0,2005
1330900230,630000,4,2.5,2330,31705,2,2330,0,1980
8917100206,442000,4,1.5,1960,12688,1.5,1960,0,1962
1219000120,340000,4,1,1140,13440,1,1140,0,1944
0522059158,230000,3,1.75,1400,6956,1,1400,0,1957
0526059122,495200,5,2.25,2710,22120,1,1410,1300,1955
0293620180,900000,4,2.5,3510,6745,2,3510,0,1998
0945000410,265000,2,1,910,4600,1,910,0,1917
0226059106,489500,3,1.75,2090,65558,1,1330,760,1977
4166600610,335000,3,2,1410,44866,1,1410,0,1985
8854100220,585000,3,3.25,3050,12700,2,2240,810,1990
5249804655,800000,4,2.25,2010,7200,1,1010,1000,1950
2220069203,379500,4,2.25,2120,53578,2,2120,0,1985
3298200790,475000,3,1,1270,8000,1,1270,0,1959
4038400040,520000,3,2,1670,8800,1,1150,520,1961
7215730730,515000,4,2.5,1800,4338,2,1800,0,2001
3126049107,577500,2,1,1640,5515,1,940,700,1926
3110800040,269900,3,2.25,1740,9672,1,1110,630,1963
2608300035,329000,3,1,1600,5952,1,1150,450,1964
7217400650,458500,3,1.5,1280,1920,1.5,1280,0,1905
0924069106,890000,4,2,1480,11171,1.5,1480,0,1947
2310050040,361500,4,2.5,1980,7334,2,1980,0,2003
7490000040,2.535e+006,5,3.25,3730,10626,1,3730,0,1963
6675500133,325000,2,1,900,8374,1,900,0,1984
0809001520,1.85e+006,4,3.25,3480,6000,3,3480,0,2014
1424200035,945000,4,2,2840,13367,1,1420,1420,1952
5641300220,370000,3,2.5,2490,4244,2,2490,0,2005
7849202299,320000,0,2.5,1490,7111,2,1490,0,1999
8682292020,450000,2,2,1510,4908,1,1510,0,2006
1604590230,800000,4,2.5,2900,18303,2,2900,0,1994
2856101540,676000,3,2.5,2240,3825,2,2240,0,1995
1336300610,1.2725e+006,4,1.75,2040,5000,2,2040,0,1921
3819500065,290000,3,1.75,1460,7980,1,1460,0,1972
2329600040,158000,3,1.5,990,8925,1,990,0,1962
4440900040,379950,4,1.75,1970,9389,1,1140,830,1960
7202260330,583000,4,2.5,2660,4000,2,2660,0,2001
0425000230,150000,2,1,870,5700,1,870,0,1957
5466400530,261500,3,2.5,1740,6992,2,1740,0,1990
6600490220,278000,4,2.5,2290,3777,2,2290,0,2004
2156500220,555000,4,2.75,2170,7140,1,1290,880,1977
9438300035,355000,3,1.75,2040,8173,1,1470,570,1958
4036800770,375000,4,1.5,1770,6650,1,1770,0,1958
4006000281,227000,3,1.75,2380,12681,1,1380,1000,1918
0619079061,335000,4,2,2030,103672,1,2030,0,1969
3586501135,680000,3,2.25,2270,23900,1,1820,450,1975
8819900220,686500,2,1.75,1390,5025,1.5,1390,0,1928
1775801020,410000,3,1.75,1530,26642,1,1180,350,1988
3758900150,425000,2,1,1430,13300,1.5,1230,200,1921
1954420230,562500,3,2.5,2030,7549,1,2030,0,1988
4307320230,345000,4,2.5,2390,6976,2,2390,0,2003
7856620910,627500,4,2.5,2540,11500,1,1640,900,1979
1624079021,355000,3,1,1890,36300,1,1890,0,1962
4123800330,335000,3,2.25,1870,5876,2,1870,0,1986
7186800120,350000,4,3,1780,4228,1,1780,0,1953
0925069123,590000,3,1,1610,58370,1,1610,0,1978
5422420120,252000,3,2,1420,6788,2,1420,0,1990
5460500040,1.295e+006,5,4,4440,9270,1,2220,2220,1968
5113400264,705000,4,2,1820,5001,2,1820,0,1947
1828000230,498000,3,2,1620,8400,1,1180,440,1968
6415100331,312500,2,1,870,7227,1,870,0,1948
7686205370,260000,4,1.75,1830,5375,1,1060,770,1962
8092501400,209950,3,1.5,2290,9600,1,2290,0,1967
0643300210,610000,3,1.75,1110,10402,1,1110,0,1967
7550801225,500000,4,1,1440,7100,1.5,1440,0,1906
4078300040,850000,3,3.5,3070,7050,1,1570,1500,1928
4036100175,689000,4,2.5,2440,11700,1,1480,960,1961
1036700220,470000,4,2,2410,4680,2,2410,0,1974
1644500450,640000,3,3,2270,5175,2,2130,140,2002
6326000205,290000,4,1.75,2340,7200,1,1590,750,1960
3375300150,258500,3,2.5,1800,9000,2,1800,0,1983
2344300220,1.1e+006,4,3.5,2210,7597,1,1550,660,1977
0203101065,420000,3,1.75,1820,22320,1,1250,570,1977
5083100065,230000,3,1,1190,9083,1,1190,0,1955
1545804240,252000,3,1.5,1400,6865,1,1400,0,1986
2329720040,515000,3,2.5,2600,4506,2,2600,0,2003
7551300065,425000,2,1,910,4635,1,910,0,1905
4321200580,575000,3,2.5,1760,2320,2,1760,0,1994
9164100040,390000,2,1,860,5160,1,860,0,1909
7922750150,561500,4,2.25,2310,9800,1,1780,530,1968
2804600155,1.35e+006,4,1.75,2000,3728,1.5,1820,180,1926
5101402296,835000,5,2.75,2460,7830,1,1490,970,1955
8019200845,245000,2,1,1020,15000,1.5,1020,0,1933
9286100150,475200,3,2.5,1670,3980,2,1670,0,2000
3727800065,425000,2,1,790,5024,1,790,0,1941
7657000085,218000,2,1.5,2010,7755,2,2010,0,1952
7954300120,600000,4,2.5,2600,6536,2,2600,0,1999
0686400040,545000,4,2.25,1890,7210,1,1890,0,1967
0853200040,2.408e+006,5,2.5,4600,23250,1.5,3600,1000,1918
7857003046,460000,5,3,2008,5050,1,1216,792,1992
5014000085,425000,2,1,880,6413,1,880,0,1950
2205500355,455000,3,1.75,1700,8360,1,850,850,1955
2595650220,313100,3,2,1730,12821,1,1730,0,1994
7880010150,780000,4,3.5,3910,59863,2,2490,1420,1987
6386550040,345500,4,2.5,2160,9682,2,2160,0,1999
1355000220,243000,3,1.75,1200,8034,1,1200,0,1975
6619900120,670000,5,3.5,3860,9600,1,2660,1200,1973
2132200230,325000,3,1.5,1320,7560,1,840,480,1983
2988800065,281000,2,1,1280,12500,1,1060,220,1951
0013001215,130000,3,1,1100,5100,1,1100,0,1913
0705700530,340000,3,2.5,2170,9798,2,2170,0,1995
7230100120,485000,4,2.75,2720,51396,2,2720,0,1977
9520900230,642860,4,2.75,2520,6398,2,2520,0,2014
9828701085,747000,3,1.75,2560,4800,1,1280,1280,1911
1926049385,559950,4,2.5,2650,7200,2,2250,400,1979
5680000455,577288,4,2.75,2870,7200,2,2870,0,2008
0125039021,575000,2,1,1230,2726,1.5,880,350,1920
3241600150,287000,3,1,1450,6000,1,1450,0,1953
1245003006,1.149e+006,4,3.75,3180,9889,2,2500,680,2012
2789000120,335000,2,1,1800,8900,1,900,900,1945
6073300040,375000,4,2.25,2020,12500,2,2020,0,1966
7663700531,325000,2,1,620,14823,1,620,0,1926
0123059042,530000,3,2.25,2190,220414,1,1330,860,1976
7149400450,287000,4,2.25,1980,7081,1,1470,510,1977
9264911210,320000,5,3,2970,7000,1,1810,1160,1979
7853300650,425000,4,2.5,2270,4400,2,2270,0,2006
6383000150,550000,3,1,1630,6009,1,1630,0,1954
5560000650,135000,3,1,1520,8450,1,1120,400,1961
5700002020,695000,3,1.75,2080,5687,1.5,2080,0,1924
2141310540,975000,5,2.5,3020,9648,1,1980,1040,1977
7247000035,210000,4,1.75,2180,28710,1,1180,1000,1950
4077800438,518000,4,1.75,1780,8768,1,1050,730,1951
8821900155,335500,3,1,1370,6780,2,1370,0,1930
1324039110,750000,4,3.5,3050,7020,2,2050,1000,1984
5566100205,515000,3,1.75,1490,12000,1,1490,0,1956
7222000209,344500,4,2.75,1800,5453,1,1050,750,2002
7867500021,470000,3,1.5,1760,6723,1,1160,600,1958
8563010540,606150,4,1.75,1770,9848,1,1370,400,1967
7349650120,292000,4,2.75,2910,7712,1,1600,1310,1998
0620069061,450000,3,2.5,2880,426452,2,2880,0,1979
9269200540,429000,3,1.75,2520,5043,1,1260,1260,1957
1939000040,765000,4,2.5,3190,38119,2,3190,0,1988
2767603026,425000,2,1,540,2500,1,540,0,1905
9477920120,505000,4,2.5,3170,5340,2,3170,0,2000
4037200530,544950,3,1.75,1830,7371,1,1830,0,1957
8150600065,382000,3,2,1360,4840,1.5,1360,0,1936
4046600120,475000,3,1.75,1870,25157,2,1870,0,1978
8835220210,355000,3,1.5,1370,4790,2,1370,0,1982
7696300180,410000,4,2.5,1700,9000,1,1700,0,1972
6362900145,450000,4,2,1960,5008,1,980,980,1900
7663700968,565000,7,4.5,4140,9066,1,2070,2070,1978
6844700975,529100,2,1,1290,6528,1.5,1290,0,1941
7853300720,452500,4,2.5,2460,6454,2,2460,0,2006
4222200210,245000,4,2,1580,8000,1,1040,540,1967
7518505040,415000,1,1,700,2550,1,700,0,1954
6646200770,610000,4,2.5,2410,15899,2,2410,0,1990
1262700040,363500,4,1.75,2180,9702,1,1090,1090,1962
6811000220,510000,3,2.75,1950,12630,1,1230,720,1969
6979900330,650000,4,2.5,2630,28298,2,2630,0,1996
0984200540,290000,4,2.5,2050,9015,2,2050,0,1973
7812800155,170000,3,1,790,6750,1,790,0,1944
7228500610,510000,2,1,1070,5280,1,1070,0,1900
1225069038,2.28e+006,7,8,13540,307752,3,9410,4130,1999
5162100650,316000,4,2.5,2320,7379,2,2320,0,1987
3904902510,690000,4,2.5,2670,13463,2,2670,0,1989
0418000330,199950,2,1,700,5200,1,700,0,1952
7689600330,207000,3,1,860,7740,1,860,0,1960
2473370870,449950,4,2.25,3490,8400,1.5,3490,0,1976
2023069054,361550,3,1.75,1160,257875,1,1160,0,1980
0293800410,824000,4,3.5,3650,57538,2,3650,0,1996
7752000065,537000,3,1.75,1550,10050,1,1550,0,1957
0191100870,838400,4,2.5,2620,9525,2.5,2620,0,1974
5347200220,225000,2,1,720,4758,1,720,0,1947
7604400150,329900,3,2,1380,5198,1,1380,0,1982
3024089057,282500,4,1,1170,34925,1,1170,0,1942
2212901010,229950,3,1.75,1170,11960,1,1170,0,1969
6414100482,500000,2,1,1630,12059,1,1270,360,1947
9455200329,495000,3,1.75,1890,6557,1,1890,0,1967
9536601996,149500,3,1,1010,9450,1,1010,0,1959
1546600230,726000,3,2.5,2040,10033,1,1420,620,1974
8691330330,899000,4,2.5,4080,10295,2,4080,0,1998
7788400065,317000,3,1,1270,8925,1,1270,0,1955
2771101251,395000,1,1,790,3000,1,790,0,1953
4475000120,360000,4,3,2580,6740,2,2580,0,1999
3905120540,570000,4,2.5,2290,6738,2,2290,0,1996
8562890910,320000,4,2.5,3490,5000,2,3490,0,2003
7701700040,320000,3,1.75,1510,30185,1.5,1510,0,1976
7237300330,268000,5,2.5,2400,4564,2,2400,0,2004
7883608693,191000,2,1,900,3400,1,900,0,1905
4363700304,400000,2,1,1270,7440,1,910,360,1949
2768100040,515000,2,1,1050,5000,1,1050,0,1907
7853220120,610000,4,2.5,2950,9010,2,2950,0,2004
9547204675,538000,2,1.75,1850,3060,1,1060,790,1929
7852150220,432000,3,2.5,1970,4036,2,1970,0,2003
5089700720,335000,4,2.25,2400,8592,2,2400,0,1978
3705900124,302000,5,1.75,2360,8642,1.5,2060,300,1926
5425700150,787500,4,1.75,1580,9382,1,1080,500,1963
6141100065,420000,3,1,1790,7055,1,1520,270,1937
2726079098,560000,3,2.5,2840,216493,2,2840,0,1991
3904960150,535000,3,2.5,1970,6634,2,1970,0,1989
3298700156,310000,3,2.5,1780,6771,1,1230,550,1990
5700000180,760000,5,2,3920,5250,1.5,2560,1360,1910
0646910620,242500,3,1.75,1550,1905,2,1550,0,2005
2397100975,1.313e+006,6,3,2980,7200,1.5,2980,0,1911
5365200040,235000,3,1,1270,7153,1,1270,0,1949
4157600180,598780,4,2.25,3040,12160,1,1520,1520,1963
0723099044,433200,3,2.5,2075,16200,2,2075,0,2002
3343300644,343000,2,1,1110,9920,1,700,410,1942
2870000040,145000,2,1,800,8125,1,800,0,1964
0739000035,291970,1,1,680,21727,1,680,0,1952
8118600155,599950,3,1,1680,7910,1,1680,0,1949
3025059072,1.749e+006,4,2.5,3910,22710,1.5,3910,0,1908
0524059241,870000,4,1.75,2780,11000,1,1560,1220,1964
2215900410,323000,4,2.75,2000,9083,2,2000,0,1992
7215730410,727000,4,3,3150,9703,2,3150,0,2001
3751600146,166000,1,1,1120,17332,1,1120,0,1988
3461000120,450000,4,1.75,1740,12204,1,1270,470,1961
9238500040,400000,3,2.5,2970,23100,1,1510,1460,1967
9238500040,599000,3,2.5,2970,23100,1,1510,1460,1967
3751604895,165000,3,1,1150,19200,1,1150,0,1908
8961800035,229000,2,1,1190,7408,1,830,360,1941
1154100205,305000,1,1,900,7500,1,900,0,1946
9274203036,930000,3,3.25,2950,4446,2,2450,500,2001
3296000040,542000,3,2.5,1990,15985,1,1540,450,1964
1421069123,214000,3,1,1020,9147,1,1020,0,1900
1245500276,718000,3,2.5,2070,7200,2,2070,0,2001
0263000325,349000,3,2.5,1430,1002,3,1430,0,2002
8802400644,305000,3,2.5,2030,8000,2,2030,0,1997
9826701345,498000,3,2.5,1620,2640,2,1620,0,1900
3221059044,799950,4,3.5,4220,196817,2,4220,0,1993
9430110120,737000,3,2.5,2300,7800,2,2300,0,1997
0424069275,860000,4,3.25,3830,10005,2,3830,0,2001
9485940330,339950,3,2.5,2390,34041,1,1840,550,1984
2787460120,249000,3,2.25,1440,7673,1,940,500,1982
0293000180,370000,2,1,910,5525,1,910,0,1910
7785000220,725000,3,2,1550,12262,1,1550,0,1964
1523059183,529000,5,2.5,2380,91476,1,1580,800,1976
9536601852,310000,4,2.75,2060,8100,1,1310,750,1988
2591800530,315000,4,2.25,1880,9163,2,1880,0,1981
1732800865,1.3e+006,4,2.5,3470,4160,2,2480,990,1927
2525000760,435000,3,2,2360,12744,2,2360,0,1964
0428100580,350000,3,1.75,1970,10800,1,1300,670,1979
2143700676,240000,3,1,1040,7800,1,1040,0,1948
2313900610,410000,3,2.25,1420,3750,2,1420,0,1987
8946410040,430000,4,2.75,2290,5249,2,2290,0,2003
3275730120,446000,4,2.5,1530,8375,1,1020,510,1974
7334500120,240000,3,1.5,1360,9760,1.5,1360,0,1984
5561401210,595000,4,3,3680,35736,1.5,2320,1360,1970
8651410330,215150,3,1,920,4770,1,920,0,1969
4058801325,319950,2,1,1070,5824,1,1070,0,1949
2817100910,385000,3,2,1590,9912,2,1590,0,2000
8647800040,280000,3,2.5,1600,6700,2,1600,0,1991
1138010180,399950,3,2.5,1510,7300,1,1040,470,1974
4014400237,132500,3,1,1080,10500,1,1080,0,1967
9358000650,399950,2,0.75,1330,2856,1,930,400,1916
6150200180,290000,2,1,850,6800,1,850,0,1948
8146300180,860000,5,2.25,1960,8592,1,1290,670,1958
2424049029,3.1e+006,6,4.25,6980,15682,3,5330,1650,1999
3352400905,245000,4,1,1530,7200,1.5,1400,130,1948
0393000385,255000,3,1.5,1320,7980,1,1320,0,1956
7417100133,310000,4,3,2320,7200,2,2320,0,1976
3782100035,299000,3,1,960,8100,1,960,0,1955
3905120330,575000,4,2.5,2040,5508,2,2040,0,1996
9310300211,284000,3,1,1080,8214,1,1080,0,1944
1868900035,840000,3,1.75,2020,4800,1,1090,930,1926
3574801510,442573,3,1.75,1780,7567,1,1290,490,1980
5102400035,560000,3,1,1140,7028,1,1140,0,1931
2810100040,485000,3,2,1610,4160,1,1010,600,1917
0785000040,472500,4,1.75,1440,8536,1,1440,0,1961
3861470120,1.61e+006,4,2.75,4270,25807,2,4270,0,1996
8813400155,808000,8,3.75,3460,4600,2,2860,600,1987
0526059199,398000,3,1.75,1890,16001,1.5,1890,0,1950
5126300770,340000,3,2.5,2240,6000,2,2240,0,2003
2734100395,380000,2,1,760,4000,1.5,760,0,1910
0795000865,235000,3,1,1020,6173,1,780,240,1948
3763300040,400000,3,1.5,1330,9900,1,1330,0,1956
1777600880,582000,5,2.5,2780,12335,1,1590,1190,1968
3361401210,209000,2,1,1070,6120,1,1070,0,1962
1431600180,335000,5,3,2660,7700,1.5,1670,990,1962
7454001120,285950,2,1,710,7120,1,710,0,1942
5561100180,645000,5,2.25,3340,52476,2,3340,0,1975
8658303080,312000,2,1,1160,7500,1.5,1160,0,1916
6795100589,663000,3,2.25,2840,59677,1,1580,1260,1967
3345100184,443950,3,1.75,2000,36000,1,2000,0,1946
9284801165,315000,3,2,1060,5750,1,1060,0,1981
7229100180,302200,4,1.5,1730,10396,1,1730,0,1964
9808630120,770000,3,2.5,2190,2658,2,2190,0,1979
2473411210,374950,4,1.75,1660,8160,1,1660,0,1974
8029500180,330000,3,2.5,2210,7557,2,2210,0,1989
3438503014,230000,2,1,870,7020,1,570,300,1942
5100403882,967000,4,2.5,3100,7250,2,3100,0,2010
6909200401,536500,4,2.5,1720,3515,2,1470,250,2000
2113700360,315000,6,4,3120,4240,2,2090,1030,1993
2028701075,626000,3,1,1040,4240,1,860,180,1924
3755200220,334009,4,2,1650,9305,1,1650,0,1960
2767800065,429000,2,1,1010,5000,1,1010,0,1924
1136100087,818000,4,2.5,4020,44431,2,4020,0,1987
3422059257,326000,5,2.75,2166,6342,2,2166,0,2013
3438502083,310000,5,3,1880,5000,1,1100,780,1997
0930000234,525000,4,2,2260,7680,1,1130,1130,1947
2475200330,350000,3,2.25,2010,4400,1.5,2010,0,1986
6352600650,936000,4,2.5,3330,8897,2,3330,0,2001
4415600040,226000,3,1,1520,7200,1,1030,490,1954
7974700150,1.25e+006,5,3.5,3510,4798,2,2700,810,2008
0820079043,428000,3,1.75,1580,507038,1,1580,0,1985
8910500150,329932,3,1.5,1460,5040,1,1100,360,1971
8910500150,539000,3,1.5,1460,5040,1,1100,360,1971
1938400410,275000,3,1.75,1650,7700,1,1650,0,1977
7338200180,590000,4,2.5,2660,35010,2,2660,0,1993
3636800180,782000,4,2.5,3510,24604,2,3510,0,1997
9545240180,575000,4,2.5,2120,9603,2,2120,0,1985
3293700482,509000,3,2.25,1780,9315,2,1780,0,1996
7968000120,290000,4,2.5,2000,13300,1,1200,800,1968
7655900062,305240,3,1,1300,9000,1,1300,0,1956
4321200970,555000,3,2,2180,4976,1.5,1680,500,1930
8645540040,317000,3,2,1790,8228,1,1390,400,1980
7504200120,430000,3,2,1910,5040,1.5,1910,0,1971
3867400175,850000,2,1.5,1800,4144,1,900,900,1962
4022906222,469000,3,2.25,2620,10659,1,1660,960,1976
7346600092,327200,2,2,1440,8425,1,1440,0,1942
3222049044,835000,3,3,2790,12523,2,1600,1190,1977
1843100580,360000,4,2.5,2340,13445,2,2340,0,1990
0393000142,372000,4,2.5,2070,8658,2,2070,0,1999
3288200360,453000,3,1,2160,11484,1.5,2160,0,1968
5379800040,275000,2,1.75,2090,11317,1,1090,1000,1931
6843600040,475000,4,2.5,2040,7260,2,2040,0,1963
1091500120,310000,4,2.75,1950,9720,1,1400,550,1986
7148200040,173000,4,2,1200,8460,1,1200,0,1957
1623089025,313500,5,3,2240,94960,1,2240,0,1985
3278600760,345000,3,2.5,1360,1489,2,1360,0,2007
1226039054,436000,3,1.5,1500,10200,1,1300,200,1955
0798000145,244500,2,1.75,1300,14500,1,650,650,1939
7905400040,206000,3,1.75,1140,9800,1,1140,0,1968
3825310720,890000,4,2.5,2930,9158,2,2930,0,2005
4137000540,329950,4,2.25,2140,8874,2,2140,0,1986
0120059044,250000,3,1.75,1628,286355,1,1628,0,1996
0420069021,246000,3,2,1990,203861,1,1990,0,1949
0622100092,440000,3,1.75,1950,19747,1,1150,800,1979
3876312620,395000,4,1.75,1910,8117,1,1460,450,1975
3331001165,305000,3,1,820,5150,1,820,0,1918
2019200220,160000,3,2.25,1470,8682,1,1160,310,1985
2019200220,269000,3,2.25,1470,8682,1,1160,310,1985
7956200220,169500,3,1,1060,10023,1,1060,0,1962
6632900452,690500,4,2.75,3130,8920,2,3130,0,2014
8165100035,245560,2,1.5,1260,9693,1,1260,0,1957
9264930970,345000,4,2.75,2200,13498,2,2200,0,1987
3344500085,383000,4,1.75,2580,19607,1,1290,1290,1958
3320000222,388500,3,2.25,1350,944,2,1050,300,2007
3375300210,250000,3,1.75,1350,8548,1,1350,0,1985
5469500580,455500,3,1.75,2290,19000,1,1650,640,1973
8146100610,672000,3,1,1220,8573,1,1220,0,1954
3223059123,550000,4,1.5,2750,128502,1,1500,1250,1958
2325059101,487000,3,1.75,1430,12632,1,1430,0,1959
9475710040,291375,4,2.5,2220,6233,2,2220,0,2001
9310300175,225000,3,1,1490,15850,1,1490,0,1946
8099900040,519950,5,3.5,2440,10200,2,2440,0,1974
3224800120,250000,3,2.5,2070,8400,2,2070,0,1990
4232903265,614950,3,1,1500,2400,1.5,1500,0,1900
8861500065,599500,4,2.25,2020,10260,2,2020,0,1984
3585300365,625000,4,1.5,2190,13660,1,2190,0,1952
8019200360,248500,2,1,780,10064,1,780,0,1958
2862100205,469950,5,2,1220,4200,1,1090,130,1921
7420100040,525000,3,1.5,1840,10956,1,1840,0,1970
0223039229,787500,2,2.5,2390,6928,2,1810,580,1949
7967950040,485000,4,2.5,3710,15935,1,2130,1580,2005
1443500120,310000,2,1,750,5379,1,750,0,1919
3920000040,280000,5,2,2110,7919,1,1110,1000,1966
0126059021,200000,4,1,1020,42966,1.5,1020,0,1922
8106300970,490000,3,2.5,3080,7363,2,3080,0,2006
9320900610,146000,3,1,900,4770,1,900,0,1969
5647900650,500000,5,3,3720,25474,2,2090,1630,1986
1432701430,242500,3,1,940,7380,1,940,0,1959
6632300477,324950,3,1,1040,7288,1,1040,0,1959
9476200150,231500,2,1,1000,7615,1,1000,0,1943
8029500450,300000,3,2.5,2080,9827,2,2080,0,1989
9510320150,545000,4,2.5,2500,50595,2,2500,0,1997
0415100085,350000,3,1,1050,8583,1,1050,0,1955
8562850150,467100,3,1.75,1620,8645,1,1190,430,1973
1951600150,180000,3,1,1610,8500,1.5,1610,0,1959
6745700150,749000,4,1.5,2130,5000,2,2130,0,1920
9211520410,245000,3,2.5,1460,11593,2,1460,0,1989
3388000040,260000,5,1,1600,7350,1,1600,0,1962
3566800040,490000,3,3,1730,2940,3,1730,0,1985
4221250120,565000,4,2.5,2280,4602,2,2280,0,2003
1402600040,330000,4,2.25,2430,7490,2,2430,0,1983
2720000120,295000,3,1,1380,7575,1,1380,0,1963
3359500665,725000,3,1.5,1790,6000,1.5,1790,0,1903
7732650040,1.135e+006,4,2.5,3370,10602,2,3370,0,1999
2874600040,680000,3,2.25,2920,6300,1,1710,1210,1956
6154900065,490000,2,1,2180,9300,1,1090,1090,1947
3491300180,635000,3,1.75,1480,6985,1.5,1200,280,1926
0619079096,750000,3,2.5,2350,715690,1.5,2350,0,1979
9264920620,330000,4,2.25,2440,8098,2,2440,0,1983
7899800730,270000,3,2.5,1350,1189,2,1080,270,2007
8944750730,340000,3,2.25,1970,3716,2,1970,0,1997
2922703150,413252,3,0.75,1110,3960,1,1110,0,1951
0293610040,600000,4,2.75,2950,5803,2,2950,0,2007
7215720410,726888,5,3,2970,7261,2,2970,0,1999
5550300175,285000,2,1,720,6400,1,720,0,1943
1588600040,365000,2,1,770,5680,1,770,0,1929
7819000040,295000,4,2,1650,7200,1,1650,0,1964
1839920180,460000,3,2.25,1620,7350,1,1170,450,1969
2560803085,230000,3,1.5,1510,10588,1.5,1510,0,1947
6414100133,337000,3,1,1070,6109,1,1070,0,1951
0164000174,300000,3,1,1010,6300,1,1010,0,1957
1118001201,2.3e+006,4,2.5,3370,8402,1,2240,1130,1962
5104510720,360000,4,2.5,2000,5500,2,2000,0,2003
3904910650,585000,3,2.5,2060,10839,2,2060,0,1987
9211500620,182700,3,2.25,1740,6650,1,1240,500,1978
9211500620,305000,3,2.25,1740,6650,1,1240,500,1978
6402710120,309950,3,2.5,1880,7838,2,1880,0,1994
1245001739,550000,3,1,960,12527,1,960,0,1972
6817850040,825000,3,2.5,3280,26413,1,2670,610,1985
9839301165,998500,2,1,1570,4400,1.5,1570,0,1914
1854900410,644500,4,2.5,2990,5342,2,2990,0,2004
2787700180,320000,3,2,1250,8636,1,1250,0,1968
1843130210,266950,3,2.5,1920,4803,2,1920,0,2005
0205000450,633100,4,2.5,2470,33305,2,2470,0,1993
3626039279,395000,2,1,960,6700,1,960,0,1951
3126049261,259250,3,1,940,5904,1,940,0,1947
8658303265,300000,3,1,1260,5000,1,1260,0,1968
2421059009,413000,3,1.75,2280,139392,1,2280,0,1977
3111300040,435000,3,2.25,1740,8491,1,1240,500,1958
1770000330,500000,4,2.75,2630,15000,1,1690,940,1976
4174600264,402000,4,1.75,2430,5481,1,1430,1000,1953
0822039025,777700,3,2.5,2260,251460,1.5,2260,0,1995
9521101065,580000,2,1.5,1220,5000,1,1220,0,1938
3244500158,570000,3,1.75,2580,40392,1,1390,1190,1986
3603000410,174950,2,1,730,6000,1,730,0,1950
7548300441,300000,2,1,760,3001,1,760,0,1913
3034200142,435000,3,1.5,1740,6988,1,1600,140,1950
8651611590,840000,4,2.5,3420,8405,2,3420,0,2000
2978800120,469000,5,2.5,2240,7543,1,1140,1100,1966
7011200515,870000,4,1.75,1920,3600,2,1920,0,1907
7199340620,532000,4,1.75,2020,7029,1,1430,590,1979
7291700065,455000,4,1.5,1880,11400,1,1280,600,1955
2129700142,201000,3,1,1010,25277,1,1010,0,1961
0318300040,649000,5,3.25,3990,13087,2,2400,1590,1991
5101400871,445500,2,1.75,1390,6670,1,720,670,1941
2561360120,475000,3,2,1230,11502,1,1230,0,1984
0293800120,590000,4,2.5,2940,29013,2,2940,0,1992
2595300155,565000,4,1.5,2190,8296,2,2190,0,1935
2853600155,110000,1,1,640,10280,1,640,0,1920
4365200555,375000,3,2.5,1670,7740,1,1130,540,1974
2473100790,255000,3,1.5,1240,8528,1,1240,0,1967
8019200925,315000,5,1.75,1850,14800,1.5,1760,90,1937
6071600450,496600,4,2.25,2020,8400,1,1350,670,1961
5249803036,380000,3,1,1020,4800,1,1020,0,1944
3222069151,338950,3,1.75,1610,22496,1,1610,0,1974
5561400610,542500,5,3.5,2730,42500,1,1530,1200,1989
5700000905,739000,5,2.5,2840,5000,1,1620,1220,1913
3362401935,549000,4,1.75,1290,3060,2,1290,0,1906
2893000610,252000,3,2.25,1670,7881,1,1190,480,1977
7856410411,1.69889e+006,4,4.5,3860,15246,2,2940,920,2004
8156600155,735000,4,1.75,2460,5100,1.5,1450,1010,1909
2560803248,270000,4,2.5,1660,8063,1,1660,0,1978
1118001215,2.25e+006,3,2.5,3420,8700,1,2890,530,1951
1437500035,155000,2,1,1010,43056,1.5,1010,0,1990
2124049229,469000,4,2.5,2240,5624,1,1520,720,1961
7129304225,305000,4,2.25,2340,5250,2,2340,0,1965
7986400180,675000,3,1.75,1920,4500,1,960,960,1924
0809001970,931000,3,2.5,2460,6600,1.5,1560,900,1929
7979900145,385000,3,1,1470,11398,1,1470,0,1950
3299600040,815000,3,2.5,3400,12442,2,3400,0,2001
8651730580,531000,3,2.25,1910,8390,1,1910,0,1979
1250201175,386500,4,1,1400,3600,1,700,700,1901
8651510610,475580,3,1.75,1520,11085,1,1520,0,1983
7017200120,358000,2,1,930,5077,1,930,0,1939
9272201385,677500,5,1,2340,4730,2,1810,530,1918
0518500210,868500,3,2.5,2920,3942,3,2920,0,2008
3260000120,599380,3,1.75,1270,7350,1,1270,0,1967
7504030220,712000,4,2.25,2450,11960,1,2450,0,1979
7972601885,350000,5,1.75,1380,7620,1,1180,200,1955
2331300395,875000,4,2,2520,6000,1,1400,1120,1921
2597710450,365000,3,2.25,2290,7350,2,2290,0,1988
8122600145,452000,4,2,1660,6150,1,850,810,1945
0629000410,915000,3,2.75,2800,9750,1,1400,1400,1957
7202380120,482500,3,2.5,1690,3068,2,1690,0,2005
2926049437,425000,3,1,1180,7200,1.5,1180,0,1949
9550202700,460000,2,1.75,1390,4160,1,790,600,1916
1231000458,666570,4,2,2320,7400,1.5,1620,700,1913
9485930120,390000,3,2.25,2270,32112,1,1740,530,1980
7923100410,650000,4,1.75,2640,8215,1,1500,1140,1966
2571910210,305000,3,2,1680,8487,1,1680,0,1993
3395800155,250000,3,1,990,8100,1,990,0,1949
9558040230,438800,4,2.5,2770,4432,2,2770,0,2004
7129302185,290000,2,1,950,5650,1,950,0,1943
7841300230,324950,4,2,2160,4800,2,1290,870,1929
2768300650,453000,3,2.5,1650,1838,2,1270,380,1991
0546000865,556000,3,1,1800,4005,1.5,1160,640,1929
7708300150,315000,3,2,1660,11135,1,1660,0,1971
3709500180,445830,3,2.5,1870,5449,2,1870,0,2003
9273200145,1.26e+006,3,3.5,3220,3960,2,2760,460,1991
2025700730,287200,3,3,1850,19966,1,1090,760,1992
2215500220,525000,4,1.5,1580,6360,1.5,1290,290,1945
3758900220,1.135e+006,4,4.25,4590,17621,2,3160,1430,2003
7229900925,381000,3,1.75,2700,18246,1,1510,1190,1967
6632900084,360000,3,1.75,1020,7020,1.5,1020,0,1953
7137300040,619000,5,3.5,2950,2932,3,2950,0,2004
0222069029,535000,2,1.75,1780,224769,1,1780,0,1976
7518503685,402000,2,1,710,5100,1,710,0,1905
7701930180,600000,4,3.5,4300,70407,2,2710,1590,1992
5072420040,549950,3,2.5,2080,8690,1,1430,650,1974
4058802300,300000,4,2,2360,7440,1,1180,1180,1955
5127100210,360000,6,2,2210,9870,2,2210,0,1969
6453300306,419000,7,3.25,4340,8521,2,2550,1790,1986
4442800166,510000,3,3,1320,1012,3,1320,0,2009
8078490330,319950,3,2.5,1980,9907,2,1980,0,1991
2322069010,1.18e+006,5,5,3960,94089,2,3960,0,1998
9558021010,381000,4,2.5,2130,6003,2,2130,0,2003
6700390230,256900,3,2.5,1720,3951,2,1720,0,1992
1841400150,346000,5,1,1790,30456,1,1350,440,1964
6873000150,465000,2,2.25,1390,1222,3,1340,50,2009
5710500230,545000,3,2,1900,9975,1,1500,400,1973
9528102060,516000,2,1.75,1640,3090,1,910,730,1925
2490200450,550000,4,2.5,2700,5100,1,1440,1260,1968
4178500580,339950,4,2.25,2200,7150,2,2200,0,1990
4325700085,417000,3,1,1310,8514,1,1310,0,1953
5606000120,906000,4,2.5,2480,5000,1,1480,1000,1951
5451220150,980000,4,2.25,3010,9800,2,3010,0,1973
7954300620,555000,4,2.5,2450,5079,2,2450,0,2001
2591010040,468000,2,1.75,1250,7029,1,1250,0,1986
3321079060,378000,3,1.75,2610,117176,1,1390,1220,1981
7229900145,430000,4,2.5,2010,16020,1.5,2010,0,1962
5710610790,730100,4,2.5,3120,14300,2,3120,0,2003
0937000220,219000,4,1.5,1370,7944,1.5,1370,0,1961
7504001320,570000,3,2.5,2420,11953,1,2420,0,1990
3832710450,262500,4,2.75,1500,7036,1,1060,440,1979
8567450180,525000,5,2.5,2630,9216,2,2630,0,2003
4443801590,520000,2,1,950,3880,1,950,0,1919
7399200770,417400,3,3,2680,12285,1,2680,0,1970
8562740530,788000,4,3.25,3680,5759,2,2840,840,2003
5592900230,320000,3,1,1270,7400,1,1270,0,1956
3693900155,950000,6,1,2330,5000,1.5,2330,0,1920
3782100155,255000,3,1,960,8100,1,960,0,1955
0104550580,260000,4,2.5,1990,6671,2,1990,0,1989
4365200620,394000,3,1,1450,7930,1,1150,300,1923
0226059161,575000,4,2.5,2280,27441,2,2280,0,1996
5316100220,1.25e+006,4,2.25,1830,7200,2,1750,80,1923
1387300760,385000,3,2.25,1650,7800,1,1260,390,1969
2521059042,456000,5,2.75,2720,193406,1,1700,1020,1968
7974200902,637000,4,2.5,1710,5000,1,1110,600,1979
0259600910,485000,5,1.5,1420,9900,1,1050,370,1964
4375700065,315275,3,1.75,1440,8040,1,960,480,1951
2473100330,252500,2,1.5,1280,8710,1,1280,0,1967
1523069095,240000,2,1,1320,24319,1,1320,0,1966
5101402428,790000,4,2.5,2560,12760,1,1760,800,1949
1072100085,310000,3,1,1480,7830,1,1480,0,1952
9322800230,1.25e+006,4,2.5,2960,20240,2,2960,0,1985
2695600455,425000,2,1,1160,5038,1,740,420,1942
8946400210,548000,3,2.5,2110,4099,2,2110,0,2001
1523069197,379880,3,2.5,1650,14054,1,1130,520,1986
8078420230,530000,3,2.5,1950,9906,2,1950,0,1988
2723069052,695000,3,2.25,2600,220300,1.5,2120,480,1977
9297300395,435000,3,1,1270,4000,1.5,1270,0,1928
1428000970,540000,3,1.75,1300,62290,1,1300,0,1983
1774000720,425000,3,2.25,1790,10209,1,1290,500,1967
2826049106,490000,3,2.5,1930,7266,2,1930,0,2005
2113700205,220000,4,1,1200,6000,1.5,1200,0,1923
1036450360,540000,4,2.5,2050,3784,2,2050,0,2001
0714000155,670000,3,1,1710,6195,1,1410,300,1946
0686800065,667500,3,1.75,2130,20423,1,2130,0,1953
5323100120,585000,3,3.5,1700,2197,2,1260,440,2010
8658300455,225000,3,1.5,1390,12500,1,1390,0,1976
2202500150,375000,3,1,1230,9877,1,1230,0,1954
0258100040,335000,3,2,1490,8847,1,1490,0,1967
4027700021,680000,5,3.25,2440,15815,2,1990,450,2014
9828701747,600000,3,1,970,4800,1,970,0,1950
1523049207,161000,4,2,1700,8043,1,850,850,1954
1523049207,220000,4,2,1700,8043,1,850,850,1954
2131701075,420000,3,1.75,1720,5000,1.5,1720,0,1932
1794500870,710000,3,1,1400,2250,1.5,1400,0,1909
6383000790,626000,4,2.5,2570,7221,1,1570,1000,1958
0723049448,279500,3,1.5,1200,8040,1,1200,0,1959
5093300325,1.61e+006,4,3.5,4390,11600,2,3060,1330,1990
7547300120,325000,2,1,1080,5000,1,1080,0,1954
2473000720,380000,4,2.25,1860,7980,1,1860,0,1966
7697800040,470000,4,2.75,2150,9820,1,1220,930,1979
1442860120,363000,4,3,2250,12142,2,2250,0,1986
9542800610,245000,4,2.25,2050,7700,2,2050,0,1977
6003501400,525000,3,1,1010,3520,1,1010,0,1902
5493100366,1.7e+006,5,3.5,5850,22885,2,4670,1180,1978
6681500205,658500,4,2.25,1900,5000,1,1400,500,1963
2594200230,680000,2,1,1020,8442,1,920,100,1941
0624110450,835000,4,2,3390,16025,2,3390,0,1987
2768100180,595000,4,2.5,1990,2175,2,1680,310,2005
9406700180,419000,4,2.5,3190,4980,2,3190,0,2005
2122059077,198900,2,1,1210,18700,1,1210,0,1940
0624110610,1.085e+006,4,3.25,3740,12080,1,2000,1740,1988
3575302245,500000,3,3.5,2150,4368,2,1610,540,1998
2287600040,575000,4,1.75,2440,8100,1,1620,820,1960
2026049183,324950,2,1.5,1230,1516,3,1230,0,2000
0216500040,259000,3,2.5,2740,7980,2,2740,0,1964
6705800040,551000,2,2,2260,9604,1,2260,0,1990
9266701115,488000,2,1.5,1000,5125,1,1000,0,1942
3811000180,635000,4,2.25,2350,46173,2,2350,0,1980
1561900180,395000,3,2.5,2300,8938,2,2300,0,1989
3432500760,370000,3,1,1440,8287,1.5,1440,0,1928
7465900205,675000,4,3,2780,5000,1.5,1710,1070,1919
6629300120,402000,3,1,1200,6825,1,1200,0,1954
3026059011,825000,3,2.75,3040,24192,2,3040,0,1987
0822069029,579000,3,2.75,2660,223027,1,1330,1330,1962
9826701490,455000,5,2,1510,3000,2,1510,0,1983
4137020360,265000,3,2.5,1780,6527,2,1780,0,1989
1115700040,713500,5,2.75,2920,9163,1,1520,1400,1976
1061400180,240000,3,1,1550,12670,1,1550,0,1962
0820079081,570000,4,3,2710,217800,2.5,2710,0,2006
2524069072,243800,3,1,1140,27760,1,1140,0,1981
9521101520,543000,2,1,940,3864,1,940,0,1918
5016002240,1.01e+006,3,2.25,2160,7500,2,2160,0,1982
0424069010,625000,4,2.25,2470,17008,2,2470,0,1979
5104540610,459950,4,2.5,2800,6567,2,2800,0,2006
8567300150,370000,4,2.75,2420,39704,1,2420,0,1985
2976800749,150000,4,2,1460,7254,1,1460,0,1959
7015200790,683500,3,1.5,1820,5756,1.5,1640,180,1946
2770604104,499950,3,2.5,1520,2208,2,1040,480,2007
1624049092,255000,2,1,1320,9967,1,940,380,1919
8078570410,279000,3,2.5,1920,7779,2,1920,0,1989
7974200456,910000,5,3,2640,5096,2,2640,0,2009
0752000035,699000,4,2.5,2650,7945,2,2650,0,2006
3262300322,1.651e+006,4,3.25,3640,13530,1,2570,1070,1924
5412300410,248000,3,1,1420,8800,1,1090,330,1981
4013200145,429000,3,1,1540,37950,1,1090,450,1959
2623039018,685000,4,1,1550,15239,1.5,1370,180,1930
8122100650,316000,2,1,730,5040,1,730,0,1927
1005000220,410000,2,1,2020,7540,1,1010,1010,1921
1023089096,299000,3,1,1200,15843,1,1200,0,1955
1392800035,559000,2,1,1240,6400,1,1060,180,1938
1523069072,575000,3,2.25,2680,100188,2,1580,1100,1978
0519000043,602000,3,2.5,1640,3804,2,1640,0,1998
0475000975,492000,4,2,1640,5000,2,1640,0,1907
4142450040,293500,3,2.5,1610,5024,2,1610,0,2004
2824059043,481000,3,2.75,2290,14810,1,1400,890,1967
8558600085,311100,4,2.25,2130,8078,1,1380,750,1977
8649400410,375000,3,1.75,2140,13598,1.5,1620,520,1970
2523089025,1.075e+006,3,3,4020,435600,1.5,4020,0,1999
9512500720,500000,5,2.5,2030,8400,1,1330,700,1968
2461900760,553000,3,1,1380,6250,1,1380,0,1918
2877104196,760000,3,2,1780,1750,1,1400,380,1927
2493200325,589500,4,1.5,1440,3200,1,960,480,1960
5210200410,840000,5,2.75,2790,20824,1,1680,1110,1959
1954700410,2.546e+006,4,3,4190,8805,2.5,3490,700,1928
9253900210,1.275e+006,3,2.5,3870,46609,2,3870,0,1997
0984000450,260000,3,2.5,1850,7875,1,1250,600,1968
0993002247,430000,3,2.25,1550,1469,3,1550,0,2004
7517500610,781000,3,2.5,1920,1896,3,1920,0,2000
3438500981,280000,2,1,790,13170,1,790,0,1947
2011400021,392000,5,2.25,3740,32481,1.5,2240,1500,1958
4038100360,466200,3,1.5,1340,8856,1,1340,0,1959
2028700360,641000,3,1.75,1620,3975,1,940,680,1926
9144100035,350000,3,1,1680,8010,1,840,840,1951
8665050530,450000,3,2,1610,4364,2,1610,0,1996
5425700205,1.8e+006,4,3.5,4460,16953,1,2550,1910,1962
7399100040,185000,3,1.5,1200,1848,2,1200,0,1966
7809200035,290000,2,1,1250,12507,1,1250,0,1958
1825069072,964000,3,2.5,3630,9475,2,3630,0,1999
2524049318,2e+006,4,3,4260,18000,2,4260,0,2000
7527200360,545000,3,2.5,2180,15693,1,1850,330,1979
3041700035,609950,3,2.25,1760,10350,1,1330,430,1979
0625049318,605000,4,2,1820,7626,1,990,830,1941
6071400360,550000,4,2.5,2120,9163,1,1450,670,1961
8127700720,905000,4,2.75,2730,4268,2,2730,0,2009
1402650360,384200,3,2.5,2430,7613,2,2430,0,1986
3277800845,370000,3,1,1170,1105,1,1170,0,1965
2771603050,717500,3,1,2090,4000,1.5,1890,200,1931
1068000150,1.999e+006,4,3.25,3910,7500,2,2550,1360,1933
0126039213,365500,2,1,1140,15624,1,1140,0,1909
7537300210,580000,2,1.5,1460,5700,1.5,1460,0,1912
0764000155,415000,4,1.5,2700,14760,1.5,2700,0,1940
7454000555,272000,2,1,670,6300,1,670,0,1942
2215500205,600000,3,1.75,1880,6360,1,1040,840,1945
3013300085,744000,4,3,1980,5352,2.5,1980,0,1941
3760500222,830000,3,3,2080,10521,1.5,2080,0,2004
6145601312,322000,3,3.25,1380,1225,3,1380,0,2000
3750605674,270000,3,2.5,1808,19200,1,1808,0,2005
1001200035,272450,3,1,1350,7973,1.5,1350,0,1954
2768300736,605000,3,3,1760,2114,2,1400,360,2008
5255300150,510000,3,1.75,1950,8325,1,1950,0,1962
5015001215,1.125e+006,4,3.5,3170,4000,2,2340,830,1999
4219400580,1.688e+006,4,2.5,3000,7500,2,3000,0,1937
6151800612,162000,4,1,1460,16638,1,1460,0,1975
7893207510,337500,3,1.75,1350,5850,1,1050,300,1973
8899200720,312000,3,2.25,1470,7857,1,1180,290,1973
7167000040,740000,4,3,3350,199253,2,3350,0,2004
7167000040,700000,4,3,3350,199253,2,3350,0,2004
7771300035,328000,4,1,1360,8136,1,1360,0,1948
7967700530,241000,3,1,1020,7538,1,1020,0,1981
6669150790,265000,3,2.25,1840,6750,1,1270,570,1980
1921059213,246000,5,1.75,2030,10200,1,2030,0,1958
0723049533,271000,4,1.75,1490,9112,1,970,520,1940
0797000276,270000,2,1,2060,8398,1,1260,800,1962
6381500720,395000,4,2,2240,7085,1.5,2240,0,1944
3812400789,340000,3,2,1460,5715,1,1460,0,1957
3451000206,340000,3,1.75,2140,13260,1,1240,900,1948
8165501540,335000,2,2.25,1420,1246,2,1420,0,2007
3131201563,435000,2,1,1060,3036,1.5,1060,0,1943
6813600365,527950,4,1.75,1760,3600,1,880,880,1926
1822039138,600000,2,2.25,2320,18919,2,2320,0,1976
4443800555,667000,3,1.75,1770,3880,1,1300,470,1963
0627300145,1.148e+006,10,5.25,4590,10920,1,2500,2090,2008
9133600120,417000,3,2.5,2040,11211,2,2040,0,2000
2354300910,451000,4,1.75,1260,7250,1,1260,0,1943
6917700665,580000,2,1,1650,9780,1,950,700,1943
7214710210,570000,4,2.25,2380,36446,2,2380,0,1977
2649500155,750000,5,3.25,2750,7500,2,2150,600,1937
3343301385,685000,3,2.5,2810,7700,2,2810,0,2001
1237500720,275000,3,2,1340,9764,1,1340,0,1944
1724069043,739888,3,2.5,2420,43177,2,1690,730,1989
8682210650,715000,2,2.5,2160,5581,1,2160,0,2002
2025049025,800000,4,2,2450,4400,1,1450,1000,1913
7883605695,350000,3,1.5,1870,9000,1,1120,750,1923
2120069003,220000,3,1,1000,223462,1,1000,0,1933
7852130720,452500,3,2.5,2240,7791,2,2240,0,2002
3832060120,280000,4,2.5,2200,5893,2,2200,0,2008
4356200120,248000,1,1,790,12000,1,790,0,1918
4073200124,305000,2,1,890,7200,1,740,150,1949
2113700790,435010,3,1,1270,4000,1,1120,150,1954
9274202620,678100,3,1.75,1850,2860,1.5,1210,640,1931
2026049124,325000,3,2.25,1352,1694,3,1352,0,2007
1828000760,529950,3,2,1540,8400,1,1180,360,1968
6187700175,440000,3,1.75,1640,8529,1,1640,0,1951
6371500040,585000,3,1,1350,4800,1.5,1350,0,1928
8929000040,462608,3,2.5,2010,2778,2,1390,620,2014
2970800145,350500,3,1.75,2080,5200,1,1040,1040,1974
8588000610,210000,3,1,1040,8125,1,1040,0,1956
3905080870,510000,3,2.5,1890,5929,2,1890,0,1993
2457200040,280000,3,2.25,1810,7630,1,1810,0,1959
3971700580,385000,3,1.75,1930,14389,1,1130,800,1963
7304300760,349000,3,1,1010,8184,1,1010,0,1947
5561720180,252000,3,2.25,1740,10836,1,910,830,1981
1370801565,1.1e+006,4,2.5,2910,8881,2,1940,970,1932
1822350180,375000,3,2.25,1330,8004,2,1330,0,1985
1310900610,336000,4,2.25,2210,11700,2,2210,0,1967
9285800330,732000,3,3.75,2670,6517,2.5,2020,650,1977
6620400205,200000,2,1,1000,6227,1,1000,0,1949
1644510040,681716,4,2.5,3150,7277,2,3150,0,2006
6151800606,235000,3,1.75,1520,12246,1,1520,0,1971
5245600120,257500,3,1,1690,13825,1,1210,480,1955
8951900065,315000,3,1,1070,9497,1,1070,0,1955
0226039186,299950,3,1,910,8000,1,740,170,1950
3558900450,530000,4,2.25,2130,8640,1,1430,700,1969
3179100790,766500,2,1.75,2230,6930,1,1530,700,1947
9808590210,860000,4,2.5,3560,11119,1,2290,1270,1986
1781500220,690000,3,2.5,2590,4961,2,2590,0,1944
3126049052,551000,4,1.75,2040,6348,1,1020,1020,1962
8677900120,530000,3,2.75,2100,20150,1,2100,0,1955
5408100035,568000,3,1,1340,7260,1.5,1340,0,1953
3827600040,749950,3,2.5,2770,10773,2,2770,0,1992
7504100910,535000,3,2.5,2400,12546,1,2400,0,1983
2068500210,234300,3,1,1140,9779,1,1140,0,1963
2172000035,190000,2,1,930,11450,1,930,0,1946
4039400410,525000,4,1.75,1820,6600,1,1820,0,1960
7519000580,610000,4,1,1390,3708,1.5,1390,0,1926
9828702266,520000,3,2.5,1480,1165,3,1480,0,2006
2770602170,375000,2,1,760,6000,1,760,0,1942
3260100330,600000,3,1.75,1580,7416,1,1150,430,1967
0925059219,664000,4,2.5,1870,16200,1,1250,620,1974
1257201010,698000,2,1,1510,4080,1,1010,500,1923
0476000333,418000,3,2,1250,1306,3,1250,0,2001
1721059218,271675,3,1.75,2140,13068,1,1460,680,1974
6400700220,450000,3,1,1540,9028,1,1540,0,1968
0524069115,759000,3,2.25,2950,78843,1.5,2950,0,2006
8818900155,599950,6,3,2020,4129,1,1230,790,1994
2321300325,810000,4,2.75,2820,5000,1.5,2170,650,1927
2131200925,331292,3,1.75,1660,10000,1,1660,0,1972
3726800220,348000,3,1.75,1830,2417,1,930,900,1919
3488300085,435000,2,1,720,5600,1,720,0,1920
6415100297,530000,3,2.5,2160,9063,2,2160,0,1992
9265400210,227000,3,1.75,1510,9837,2,1510,0,1989
2787000040,285000,3,1.5,1870,42070,1,1870,0,1953
3425059218,740000,4,2.25,2860,26136,1,1640,1220,1977
1591600676,246000,3,1,990,9145,1.5,990,0,1939
2843200085,260000,3,1,1910,8710,1,1080,830,1954
2561320120,366000,3,2,1350,10200,1,1350,0,1977
8835400775,594950,4,3.25,2557,9480,2,2557,0,1948
2767704525,608000,3,2.75,2610,5000,2,1710,900,1946
3343901848,313100,3,2,1720,11875,1,1720,0,1905
7137800085,185000,3,1.75,1170,9085,1,1170,0,1967
1443500925,455000,2,1,1140,11480,1,1140,0,1907
8731800210,235000,3,2.5,2350,9051,1,1570,780,1966
8155000040,230000,3,1,1020,12289,1,1020,0,1967
9279200910,770000,4,2.25,2730,5000,1,1460,1270,1955
7697920150,240000,4,2.25,1830,7614,2,1830,0,1991
7202290620,461000,3,2.5,1690,3026,2,1690,0,2002
5093301285,1.58e+006,4,2.5,2900,10500,1,1450,1450,1963
1524069044,1.8225e+006,4,4.5,6380,88714,2,6380,0,2006
7202340450,452000,3,2.5,1690,4000,2,1690,0,2004
3629921120,765000,4,2.5,2660,5043,2,2660,0,2003
0524069020,1.05e+006,4,4,4550,54013,1,2300,2250,1989
2273600410,546000,3,3,1530,9999,1,1150,380,1983
3186600515,781000,3,2.5,2070,4463,1.5,1780,290,1931
7923000360,538000,4,1.75,1880,7953,1,1880,0,1965
6678900150,790000,4,2.5,2240,8664,1,1470,770,1975
9482700455,696500,4,2.75,2540,4400,1.5,1630,910,1925
3861500330,276000,3,2,1370,8137,1,1370,0,1988
6163901033,269000,2,1,770,8612,1,770,0,1953
2426039123,2.415e+006,5,4.75,7880,24250,2,7880,0,1996
0624069003,829000,4,2.75,2970,59677,1,1610,1360,1973
7454000145,122000,2,1,740,6840,1,740,0,1942
4402700230,352500,3,1.5,1360,7680,1,1360,0,1955
1432701510,249000,4,2,1280,7560,1,1280,0,1959
1115100119,360000,4,2,1920,7803,1,1080,840,1962
2553300120,629500,3,2,2020,10584,1,2020,0,1994
2481630180,1.14e+006,4,2.25,3310,127631,2,3310,0,1924
2525049246,1.55e+006,2,2.25,2950,15593,1,1560,1390,1942
7236300065,275000,3,1.5,1320,7695,1,1320,0,1959
1854900330,697000,4,2.5,3160,6961,2,3160,0,2005
0203101210,379500,2,1,1640,17335,1,840,800,1978
0622100074,720000,3,2.75,2440,76531,1,1640,800,1980
5014600180,675000,4,2.5,3000,5548,2,3000,0,2006
0809002295,1.169e+006,5,2.5,2810,6000,2.5,2810,0,1907
7533800325,1.1e+006,3,2,2390,6888,2,2390,0,1939
5637500180,520000,4,1,2080,3500,1.5,1260,820,1926
3971700981,415000,3,1.75,2650,7500,1.5,1590,1060,1962
2267000453,415000,3,2.5,1060,1536,2,1060,0,2000
5029000120,450000,3,2.25,1940,8312,1,1220,720,1963
3735900325,485000,2,1,1080,4080,1,1080,0,1948
6187100360,294000,3,2.25,1700,9600,2,1700,0,1984
7237500530,1.037e+006,4,3.5,4440,10660,2,4440,0,2003
2207500880,690000,3,1,1580,4000,2,1580,0,1905
7937900220,716500,5,2.75,3630,38461,2,3630,0,2000
2767603615,481000,2,2.25,1290,1137,3,1290,0,2007
8121100325,575000,4,2.75,1960,4635,1,1000,960,1968
8712100720,785000,3,2,2090,5015,1.5,2090,0,1920
1223059081,480000,3,1.75,1960,43995,1,1960,0,1970
9323610180,720000,3,2.25,2120,9297,2,2120,0,1981
2722059275,536000,3,2.75,2290,34548,2,2290,0,1984
1545800205,324900,4,2.5,1880,7965,2,1880,0,2000
4303200555,265000,2,1,770,5160,1,770,0,1943
2267000730,545000,3,2.5,1530,3210,1.5,1010,520,1928
1926049154,465000,2,1.5,1450,27075,1,1450,0,1940
3300790540,292500,3,2.25,1690,7320,2,1690,0,1987
2652501215,860000,4,1.75,1880,3720,1.5,1880,0,1924
2426059124,1.045e+006,4,3.25,4160,47480,2,4160,0,1995
0164000237,495000,4,2.5,2140,7245,2,2140,0,2003
1453602283,342000,2,2,1320,1462,3,1320,0,1997
8081650330,320000,4,2.5,2000,10051,2,2000,0,1997
3797000205,444000,3,2,1460,2610,2,1460,0,1987
8921000040,804100,4,2.5,3070,8086,2,3070,0,2005
6791100410,432000,3,2.5,1660,15000,1,1660,0,1970
7224000450,230000,6,1.5,1810,4838,1.5,1050,760,1905
3303980650,935000,4,3.5,3510,11200,2,3510,0,2001
7589200191,634950,3,3,2180,2650,1.5,1410,770,1930
9547200530,780000,6,4,3300,5720,1,1960,1340,1963
8635751120,611000,4,2.5,2460,4200,2,2460,0,1998
1982201465,475999,4,1.75,1880,4175,1.5,1090,790,1944
8648700450,565000,3,2,2290,9450,1,1670,620,1979
3586501085,630000,4,2.5,2290,26720,2,2290,0,1977
7701990040,840000,4,3.5,3860,18334,2,3120,740,1996
3420069060,790000,3,2.5,2640,432036,1.5,2640,0,1996
1822069052,450000,5,2.5,2850,209523,1,1930,920,1925
4385701285,1.272e+006,4,3.25,3020,4000,1.5,1920,1100,1927
2810600210,520000,3,2,1510,3760,1,930,580,1925
1624049170,446800,4,2,2410,8712,1,1260,1150,1958
0871001085,652000,3,1,1470,6122,1,1200,270,1948
4104500191,1.17e+006,3,2.75,2890,12130,2,2830,60,1987
0098030530,745000,4,3.25,3490,7024,2,3490,0,2006
1025049115,594000,3,2.25,1270,1406,2,1060,210,2014
9331800580,257000,2,1,1000,3700,1,800,200,1929
9826701320,485000,4,1.75,1430,4096,2,1430,0,1900
2426049079,330000,3,1,1060,20040,1,1060,0,1943
0204000175,381000,3,2,1680,8946,1,940,740,1996
0822039004,849900,2,2,2280,641203,2,2280,0,1990
3735900205,793000,4,2.5,2450,4080,1.5,1490,960,1930
0823000174,920000,3,2.25,3650,5353,2,2200,1450,1947
3300701575,455000,2,1,830,4000,1,830,0,1947
4128500210,975000,4,2.5,3490,7494,2,3490,0,2000
1934800142,375000,2,1.5,1050,1046,2,960,90,2007
1189000205,400000,2,2.5,1170,1811,2,1170,0,2001
4040800120,447000,3,1,1220,7200,1,1220,0,1965
1238501099,470000,3,1.75,1310,8600,1,1310,0,1987
6705870040,665000,4,2.5,3130,7582,2,3130,0,2004
7340601063,295500,3,1.75,1590,41550,1.5,1290,300,1933
7212660540,200000,4,2.5,1720,8638,2,1720,0,1994
1426079047,620000,3,2.25,2520,212137,2,1590,930,2005
6817800220,434900,3,2,1520,11067,1,1140,380,1983
1336800065,1.328e+006,4,2.25,3260,4640,2,2360,900,1907
9413900035,1.65e+006,4,3.25,3910,7500,2,3910,0,2006
9113200180,852500,4,2.5,3480,6315,2,2360,1120,2000
4215250220,790000,3,2.5,3040,34670,2,3040,0,1983
8563030330,565000,4,1.75,2030,7350,1,2030,0,1966
5634500688,1.1275e+006,6,3.25,3870,24700,2,2520,1350,1989
1657530450,289950,3,2.5,1870,1436,2,1870,0,2004
1624059219,850000,2,2,2640,13939,1,1640,1000,1963
7942600975,505000,4,1.75,1940,4800,1,1030,910,1922
8835200610,372000,3,2.5,1710,5633,2,1710,0,1981
7524200180,207000,4,2,1690,7728,1.5,1690,0,1967
5451100220,780000,3,1.75,2340,10495,1,2340,0,1967
4047200065,400000,4,1.75,1700,20283,1.5,1340,360,1965
3374900035,440250,3,1.5,1850,8124,1,1850,0,1948
7010700580,585000,2,2,1370,7920,1,950,420,1949
4139440360,850000,4,2.5,2900,9972,2,2900,0,1993
3126049154,570000,3,3,2400,3192,2,2400,0,1991
1331900410,869000,4,3,3740,30884,2,3060,680,1988
3432501395,551000,4,2.75,2170,5988,2,2170,0,2014
8945100530,172380,3,1,970,8378,1,970,0,1962
3121069038,355000,3,2.5,2620,78843,1,1310,1310,1964
4139440730,728935,4,2.5,2980,10194,2,2980,0,1993
9808640040,850000,3,2.5,2340,1919,2,2340,0,1981
0423059077,515000,5,1.75,1880,48787,2,1880,0,1922
8005100571,215000,2,1,1480,5325,1,1120,360,1925
9324320040,220000,4,2.5,2240,9826,1,1370,870,1988
3825310970,845000,4,2.5,2940,7675,2,2940,0,2004
1930301540,390000,1,1,710,4000,1,610,100,1928
0723049158,135000,4,1,1460,18599,1.5,1460,0,1940
6116500366,439000,3,1,1530,19007,1,1290,240,1949
7954300330,585000,4,2.5,2630,6185,2,2630,0,1999
2346800180,620000,5,1,2230,16800,1.5,1700,530,1923
0452001475,477000,3,1,960,3600,1,960,0,1906
0952006783,399500,2,1.5,1180,1722,2,1180,0,2006
2013802060,500000,2,1,1760,27332,1,1300,460,1951
1787600209,432500,3,2.5,1340,8867,2,1340,0,1984
9542100085,940000,4,2.25,2800,18673,1,1650,1150,1965
3025059124,3.16875e+006,5,3.5,4330,11979,1,2090,2240,2008
7504021490,1.08e+006,3,2.5,3720,11610,2,3720,0,1982
8651440230,229999,4,2,1670,5200,1,1030,640,1977
1003400155,233000,3,1,1100,7657,1,1100,0,1955
7852190410,600000,3,2.5,3240,8016,2,2910,330,2004
2968801085,334000,4,1.5,1680,7620,1,1180,500,1965
7771300155,332500,3,1,1030,8164,1,1030,0,1950
9320870040,249900,3,2.5,1630,7700,1,1120,510,1978
0623049047,310000,3,2,2610,12180,1,1670,940,1918
9505100035,200000,2,1,1250,8520,1,1250,0,1928
8114000040,310000,4,1.75,1480,11200,1,1480,0,1969
0424000145,230000,3,1,1390,6000,1,1390,0,1954
7857003953,420000,4,2.5,1940,5414,2,1940,0,1997
3630110220,785000,4,2.5,2960,4750,2,2960,0,2005
0251500330,1.775e+006,3,2.25,4320,19225,1,2160,2160,1972
1900600040,265000,5,1.5,1500,7112,1,760,740,1920
6163901383,295000,2,1,840,10465,1,840,0,1951
4054530210,896000,4,2.5,3560,46644,2,3560,0,1992
5088500210,415000,4,2.75,2390,9968,1,1390,1000,1989
0424500035,250000,3,1.75,1200,5478,1,1200,0,1955
6762700515,1.475e+006,3,2.5,2570,5000,2,2570,0,1984
1562200040,635000,5,2.25,2180,6000,1,1430,750,1966
3401700040,905000,3,2.5,3450,48787,2,3450,0,1987
7202330610,528000,3,2.5,2020,5613,2,2020,0,2003
8835350230,530000,3,2.5,2480,7480,2,2480,0,1992
4057300180,310000,3,1.5,1140,3104,2,1140,0,1988
1023059186,252000,3,1,1530,9465,1,1530,0,1960
6672500040,334500,3,2,1700,8160,1,1120,580,1961
3265300410,370000,3,1,2150,8480,1,1610,540,1951
7549801565,311000,3,2,1190,7840,1.5,1190,0,1918
2114700040,260000,3,2.75,1730,4131,2,1480,250,1975
3375300360,217500,3,1.75,1400,9546,1,1400,0,1984
7237301010,290000,3,2.5,2200,4240,2,2200,0,2003
1245500691,500000,3,1.5,960,4600,1,960,0,1944
1604601225,423500,3,2,1770,6000,1,1100,670,1984
5411600180,715000,4,2.5,2970,5722,2,2970,0,2005
3331001115,299000,3,2.5,1590,3121,2,1590,0,1994
0011300120,635000,3,2.5,3350,4007,2,2550,800,2005
8691310040,806000,4,2.5,3370,9629,2,3370,0,1999
4307350450,289950,3,2.5,1960,3480,2,1960,0,2004
2460700650,280000,3,1.75,1360,6603,1,1360,0,1981
9558050450,479950,3,2.5,2780,6000,2,2780,0,2004
3793500730,394000,4,2.5,3000,9793,2,3000,0,2002
1026069061,682000,4,2.5,3600,203425,2,3400,200,1979
3797002160,409950,2,1,990,3000,1,990,0,1918
1251200155,1e+006,4,3.5,2990,4200,2,2000,990,1925
4319200450,436000,4,1,1200,6600,1.5,1200,0,1908
2762600035,279000,3,1,1530,15975,1,970,560,1952
9269200150,390000,1,1.75,1440,4920,1,720,720,1923
2623029003,635000,3,1.75,1940,167125,1,1480,460,1955
0104560120,304400,4,2.75,2140,8100,2,2140,0,1990
7266200085,780000,5,1.75,2330,3800,1.5,1360,970,1927
2622029072,520000,4,3.5,2734,210201,2,2734,0,1974
5101406375,580000,3,1.75,1950,10633,1,1250,700,1978
2698200210,274000,3,1.75,1440,7198,1,990,450,1981
1328340120,315000,3,2.25,1530,7906,1,1150,380,1980
2380000040,390000,4,1.75,1910,77574,1,1910,0,1971
5490700085,340000,5,2,1750,8220,1,1750,0,1956
1226059101,502000,3,2.25,1600,45613,2,1600,0,1983
1081200360,260000,3,1.75,1750,11180,1,1750,0,1968
0148000450,399000,2,1,940,4800,1,940,0,1911
7831800395,312500,2,1,880,6345,1,880,0,1919
4024101395,370000,3,1.75,1650,8254,1,1060,590,1951
0686550040,1.24e+006,4,3.5,3820,13224,2,3280,540,1990
2337000150,230000,3,1.5,1900,9630,1,1900,0,1967
1068000559,1.275e+006,4,1.75,3720,8448,1,1960,1760,1947
7899800120,294350,3,1,1410,5120,1.5,1210,200,1925
0425000175,208950,3,1,960,5700,1,960,0,1956
8682262260,515000,2,1.75,1930,5570,1,1930,0,2005
5608010650,965000,4,2.5,3420,9575,2,3420,0,1994
5350200870,925000,4,2.75,3010,3400,2,2240,770,1923
1279300085,654500,4,1,1780,5000,1.5,1780,0,1947
1081300450,364000,4,2.5,2080,11050,1,2080,0,1969
8698600395,150000,2,1,1250,5208,1,1050,200,1951
5381000072,349950,5,3,2257,10117,1,1363,894,2005
2877103111,585000,3,1.5,1670,5000,1.5,1670,0,1912
2159800120,801501,4,2.25,2250,13500,2,2250,0,1980
2724079061,610000,3,1.75,1650,221720,1,1650,0,1992
1843100610,382000,5,2.25,2880,11965,2,2880,0,1990
0120069003,495000,4,3,3620,403693,2,3620,0,1980
3226049401,447500,3,1.75,1950,6504,1,1530,420,1953
0259800610,575000,4,2.5,2280,9491,1,1290,990,1966
0635000145,565000,2,1.75,1740,4736,1.5,1040,700,1907
3764800540,348580,3,1,1220,7876,1,1220,0,1966
6672700120,459000,4,1.75,2260,9703,1,1660,600,1978
2126079124,375000,4,2,1790,61419,2,1790,0,1988
2331550120,310000,4,2.5,2440,7093,2,2440,0,1999
2190600243,210000,3,1.5,1400,9600,1,1400,0,1964
7853340330,384205,3,2.75,1810,3292,2,1810,0,2014
3185600040,180000,2,1,1400,4500,1,900,500,1922
3185600040,310000,2,1,1400,4500,1,900,500,1922
0253600180,427500,4,2.5,2010,6294,2,2010,0,2000
7011201475,780000,3,3,2520,2152,1.5,1560,960,1925
2525049266,1.762e+006,3,2.25,3060,16000,2,3060,0,1988
9542830540,339950,4,2.5,2150,4000,2,2150,0,2010
8965400210,820000,3,2.25,2880,9750,2,2880,0,1989
8682291970,398000,2,2,1300,3865,1,1300,0,2006
5561300540,492000,3,1.75,2770,39927,1,1580,1190,1978
2722049092,240000,4,1.5,1780,14810,1,1180,600,1950
5469502380,599950,4,3.5,3730,15029,2,2440,1290,1991
2023049218,105500,2,1,930,7740,1,930,0,1932
2023049218,445000,2,1,930,7740,1,930,0,1932
1920079103,390500,2,1.75,1460,426450,1,960,500,1966
7760400210,255000,3,2,1310,8454,1,1310,0,1994
8078390150,675750,4,2.5,2770,10274,2,2770,0,1989
3528900401,1.64e+006,3,3.25,3140,5445,2,2240,900,1913
5104520720,353500,4,2.5,1770,9239,2,1770,0,2004
8146100580,765000,3,1,1220,7585,1,1220,0,1954
7852020620,563500,4,2.5,2190,4944,2,2190,0,1999
5249803010,439000,4,2,1800,5465,1,900,900,1942
5459500145,975000,5,2.75,3100,10014,1,1660,1440,1973
7853302110,469900,3,2.5,2270,4399,2,2270,0,2007
7304300905,252000,3,1,1300,8184,2,1300,0,1947
6119200085,495000,3,2,1769,9300,1,1769,0,1955
0622049106,570000,6,2.5,3370,15625,1,1770,1600,1964
1624049275,327000,4,2.5,1630,5361,2,1630,0,1999
5035300871,898000,2,2.25,2470,7658,1,1480,990,1954
1329500120,300000,4,2.5,2600,8572,2,2600,0,2003
7504400620,418500,3,2,1800,12440,1,1220,580,1978
8029550180,450000,4,2.5,2240,4616,2,1840,400,2001
5072200040,403000,3,2,1960,13100,1,1650,310,1957
6141100330,440000,3,1,1710,6556,1.5,1200,510,1926
7131300063,350000,4,1.75,2140,4959,1,1080,1060,1965
2807100155,240000,3,2,1400,6200,1,700,700,1948
1819800286,460000,2,1,890,2100,1,760,130,1919
2663000580,825000,4,1,1820,4000,2,1820,0,1923
7749500970,267500,3,2.25,1860,12000,1,1860,0,1976
3599600150,201000,3,1,1220,22443,1,1220,0,1972
7853310720,479500,3,2.75,2300,4637,2,2300,0,2008
4239410220,210000,2,1,1520,4700,2,1520,0,1978
9136103027,445000,2,1,1440,3225,1,960,480,1915
3432501415,265000,3,1.75,1170,8148,1,1170,0,1952
3432501415,399000,3,1.75,1170,8148,1,1170,0,1952
1026069044,785000,4,2.25,3200,53357,2,3200,0,1972
1152600220,831500,5,2.5,4470,35124,2.5,4470,0,1984
9478500770,360000,4,2.5,2570,4557,2,2570,0,2009
6388920410,655000,3,2.5,2370,7916,2,2370,0,1990
3579800180,449950,4,1.5,1800,10150,1.5,1800,0,1958
8860300220,612000,5,2.5,2300,7000,1,1290,1010,1975
1823069287,575000,3,2.5,3240,33661,2,3240,0,2001
8854000410,557000,3,2.5,2280,18241,1,960,1320,1995
3344500183,375000,4,1.75,1870,12500,1,1030,840,1943
2891400410,369000,3,2.25,1820,99752,1,1820,0,1969
7129800063,330000,5,2.75,2390,6282,1,1290,1100,1966
3179100220,1.031e+006,4,1.75,2110,6708,1,1410,700,1941
1931300815,550000,2,1,980,4800,1,980,0,1910
6163900333,338000,3,1.75,1250,7710,1,1250,0,1947
4389201075,1.9e+006,4,2.5,3680,13351,2,3680,0,1946
2122700120,235000,3,1,2230,8163,1,1230,1000,1966
2291401115,349950,1,1,1230,9300,1.5,1230,0,1918
7229100040,300000,5,2.5,2093,10350,1.5,2093,0,1963
3204800040,431000,3,1.75,1660,12865,1,1660,0,1967
8092700220,280000,5,2.5,1630,20750,1,1100,530,1975
7503800210,295000,4,2.5,1677,7209,2,1677,0,2011
2781250150,445000,4,2.5,2990,6383,2,2990,0,2003
2024089011,550000,5,1,2150,262231,1.5,2150,0,1900
2427910040,515000,4,2.5,2890,15067,2,2890,0,2003
3123059107,555000,3,2.5,3050,158558,1,3050,0,1987
7211400506,265000,3,2.5,1410,2500,2,1410,0,2006
8129700085,597000,4,2.5,2280,2432,2,1520,760,1921
3271301175,661000,2,1,1260,5800,1,1260,0,1939
7203101970,362764,3,2,1460,4350,2,1460,0,2008
1787600146,427000,4,2.5,1600,14000,1,1310,290,1950
5255200220,405000,3,1.75,2020,8531,1,2020,0,1965
0937000330,157000,3,1.5,1170,11530,1,1170,0,1960
0937000330,246500,3,1.5,1170,11530,1,1170,0,1960
6817800730,386500,2,1.5,1280,11071,1,850,430,1984
1898900040,300000,4,2.5,2680,15508,2,2680,0,1999
9264901510,240000,3,1.75,1770,8571,1,1270,500,1978
3343301490,818500,5,3.5,4790,12957,2,3110,1680,2005
1645000097,249000,3,1.75,1300,8500,1,1300,0,1964
2923501020,580000,4,2.25,2610,7700,1,1700,910,1977
4139900180,2.34e+006,4,2.5,4500,35200,1,4500,0,1988
2621760360,333000,4,2.5,2100,7366,2,2100,0,1997
5702380730,230000,2,2,1340,7605,1,1340,0,1992
1604601855,360500,3,1,970,6180,1,970,0,1974
6777800150,265000,3,1.75,2200,7200,1,1270,930,1962
1563103040,490000,2,1,990,5000,1,990,0,1941
7550800736,600000,2,1.75,1180,5000,1,880,300,1925
1138000410,307500,3,1,980,6530,1,980,0,1969
7555220150,670000,4,2.25,2370,9636,1,1660,710,1976
3021059197,247200,3,1.5,1910,10583,1.5,1910,0,1922
2923500230,2.6e+006,4,4.5,5270,12195,2,3400,1870,1979
4039500610,440000,3,1.75,1430,8400,1,1430,0,1961
3904910610,700000,4,2.5,2490,7694,2,2490,0,1987
2489200230,756100,4,2,2000,8317,1.5,2000,0,1917
2600100180,555000,4,2.75,2600,19275,1,1620,980,1978
6909200355,830000,5,3.5,2880,3750,2,2270,610,2001
7575500040,180000,3,1,1010,8863,1,1010,0,1990
6192400180,775000,5,3.5,3290,5600,2,2670,620,2004
5125400385,220000,4,1.75,1530,18400,1.5,1530,0,1938
7811100230,650000,4,2.75,2020,15810,1,1620,400,1967
6608500220,410000,3,1.75,1340,9975,1,1340,0,1961
0705730180,339995,4,2.5,2180,5367,2,2180,0,2000
4039700870,1.16e+006,5,1.75,2870,9680,1,1440,1430,1966
0238000201,440000,3,2.75,2070,9697,2,1330,740,1929
4365700330,275000,2,1.75,930,7080,1,930,0,1923
4249000230,766000,3,2.5,2270,9822,2,2270,0,1988
1099750610,231500,3,2.25,1630,7900,1,1130,500,1973
3123089010,472000,3,2,2770,89298,2,2770,0,2004
9578050120,1.325e+006,4,2.5,4010,37076,2,4010,0,1990
1423049029,265000,4,1.75,1970,8390,1,1140,830,1955
1703900155,325000,2,1,790,6000,1,790,0,1948
1397300120,364500,3,1.75,1740,8424,1,1040,700,1954
7304301085,322500,2,1,1130,8184,1,1130,0,1947
0603001020,338900,3,1.75,1180,4000,1,1040,140,1929
5332200530,910000,5,2.5,2350,4000,2,2350,0,1993
5332200530,1.015e+006,5,2.5,2350,4000,2,2350,0,1993
4475800065,459950,3,1.75,1850,6869,1,1100,750,1919
4305500180,584950,4,3,3220,6224,1.5,3220,0,2009
9269750220,252000,3,1.75,2050,11313,1,1520,530,1987
6802210330,270000,3,2.5,1430,8470,1,1190,240,1992
0098020220,750000,4,2.5,3210,8938,2,3210,0,2005
6837700175,775000,3,1.75,3520,12350,1,1530,1990,1960
1895450230,325000,3,2.5,2260,8120,2,2260,0,2004
1853080180,810000,5,3.25,3290,6422,2,3290,0,2012
3582750120,409000,2,2.25,1640,2128,2,1640,0,1974
3319500385,400000,4,1.75,1580,5340,1,1130,450,1947
2783100230,530000,4,2.25,1940,8270,2,1940,0,1962
1238501098,580000,3,2.25,1580,8506,2,1580,0,1987
8562900180,491300,3,1.75,1750,11340,1,1300,450,1987
7140200450,272000,4,2.75,1810,7350,1,1200,610,1980
0220069106,599950,3,2.5,1970,106722,1,1970,0,1985
3905040040,464000,3,2.5,1770,5146,2,1770,0,1992
3797000330,471001,3,1.75,1800,6000,1,900,900,1905
6669150530,230000,3,1.5,1500,11616,1,1100,400,1980
3298200620,358000,3,1,940,6695,1,940,0,1959
8024202170,510000,3,2.25,2340,6183,1,1210,1130,1929
1788900230,86500,3,1,840,9480,1,840,0,1960
1788900230,199950,3,1,840,9480,1,840,0,1960
3220200040,1.7125e+006,3,3.25,2940,5432,3,2440,500,1978
7645900355,850000,3,2.75,3180,3680,2,2190,990,1918
0458000065,542000,4,2.5,2020,3440,1.5,1480,540,1928
0123039604,102500,2,1,820,4320,1,820,0,1937
1223089077,718000,3,1.75,4060,136290,1,2810,1250,1995
4039800180,625000,4,2.25,2660,22194,1,2180,480,1977
7304301005,350000,3,1,1010,11244,1,1010,0,1947
7899800915,216000,2,1,710,5120,1,710,0,1918
0164000271,340000,3,1,980,7228,1.5,980,0,1946
7010700976,505000,3,1,1100,5400,1.5,1100,0,1908
6699300330,372000,5,2.5,2840,6010,2,2840,0,2003
8732020770,263850,4,2.25,2300,7524,2,2300,0,1978
1795800040,1.35e+006,4,3.25,5370,20388,2,5370,0,1990
5104450720,325000,4,2.5,2280,9899,2,2280,0,1987
2113200065,289000,2,1,1010,7740,1,890,120,1924
4027700799,364000,3,2.25,1420,6600,1,1160,260,1987
3902310210,610000,4,2.5,2100,8800,1,1250,850,1980
9283800230,531500,4,2.75,3110,49765,1,3110,0,1958
0114100234,402500,3,2.25,2160,9540,2,2160,0,1979
7625703065,375000,2,1,820,6250,1,820,0,1922
0427000065,537500,5,2.5,4340,9108,1,2170,2170,1979
7844200040,375000,3,1.75,2100,9066,1,1440,660,1962
9315300230,293550,4,1.75,1250,8840,1,910,340,1979
1774200230,585000,6,3,3870,43787,2,2700,1170,1976
2781250530,225000,2,2.5,1360,2693,2,1360,0,2003
7796600085,185000,4,1,1400,8684,1.5,1400,0,1957
3205400150,402000,3,1.5,1450,7375,1,1010,440,1968
2207200455,585000,5,1.75,1880,16617,1,960,920,1963
9523100458,549000,2,2.5,1380,953,3,1380,0,2006
5035300325,1.81e+006,3,2.25,2910,15626,1.5,2510,400,1923
3840700593,345000,3,1.75,1380,10529,1,1380,0,1967
1683800120,302500,3,2.25,3100,11985,1,1790,1310,1963
2722059183,218500,4,1.75,1400,25500,1,1400,0,1964
4083305870,705000,2,2,1650,6840,1.5,1650,0,1916
8651400730,191000,3,1,840,5525,1,840,0,1969
7302000120,695000,3,2.5,2550,45254,2,2550,0,2001
0797000258,350000,2,2.75,2820,11770,2,1630,1190,1947
9100000040,480000,3,1.75,1710,4080,1,1130,580,1979
8651441520,220000,3,1,820,5200,1,820,0,1977
6843310120,535000,4,2.25,2620,33578,2,2620,0,1977
3585900150,1e+006,2,1.75,2430,23400,1,2430,0,1951
9144100206,592000,3,1.75,1560,7424,1,1560,0,1940
2871000360,775000,4,2.5,3060,6826,2,3060,0,2004
4307330120,320000,3,2.5,1680,4584,2,1680,0,2003
6117900120,760000,3,3.25,3320,15022,2,3320,0,1989
1939120540,640000,3,2.5,2390,8315,2,2390,0,1990
0421000455,253200,3,1,1360,5840,1,1360,0,1953
6600790210,228000,2,1,1800,9236,1,1800,0,1954
1771000540,325000,3,1,1160,9525,1,1160,0,1968
5561300730,530000,4,3.25,4160,35654,2,2760,1400,1973
9542830210,300000,4,2.25,1660,3200,2,1660,0,2011
0263000155,418000,3,2,1410,6030,1.5,1410,0,1930
4058801575,415000,4,1.75,2230,9625,1,1180,1050,1955
7852150120,384000,3,2.5,1700,4000,2,1700,0,2003
2095500040,325000,3,2.5,2070,8337,2,2070,0,1997
8832900120,600000,3,1.75,2300,12682,1,2300,0,1955
9542850580,760000,4,2.25,3040,9690,1,1940,1100,1978
3530430155,168000,2,1.5,1220,3568,1.5,1220,0,1976
2225039081,405000,3,1,960,3960,1,960,0,1943
7923300230,479000,3,1,1480,10094,1,1480,0,1956
8021701115,549000,3,2,1560,5130,1,1150,410,1915
5515600087,215000,3,1.5,1100,33600,1,1100,0,1967
0952006680,550000,2,1.5,900,5750,1,900,0,1940
6411600043,389000,4,1.75,2400,7700,1.5,1500,900,1927
1523089266,447500,3,2.5,2320,15024,2,2320,0,1990
0866400040,540000,5,3,2570,5590,1,1580,990,2009
8092500150,273500,4,2.75,1300,9638,1,1300,0,1983
5637200450,257000,5,2.75,2930,10148,2,2930,0,2002
5126400230,199000,2,1,720,7200,1,720,0,1943
7137950720,339100,4,2.5,2350,10655,2,2350,0,1992
1473120230,435000,4,2.5,2940,7590,2,2940,0,1991
1604600085,400000,3,2.5,2020,3000,1,1010,1010,1910
0123079023,356000,2,1,1430,365904,1,1010,420,1991
0705000120,395000,3,1,950,6951,1,950,0,1950
1930300410,575000,2,1,1250,4320,1,850,400,1911
9393700065,515000,3,1.75,1300,5120,1.5,1300,0,1925
6814600355,618250,4,3.25,2520,3360,1.5,1550,970,1931
9477100620,245000,3,1.5,1330,7125,2,1330,0,1968
6788203060,690000,3,2.75,2480,3240,1.5,1890,590,1929
5706200360,465000,5,2.25,3020,10010,1,1510,1510,1959
8732130730,280000,3,1.75,1770,8240,1,1240,530,1978
4202400395,285000,3,1.75,1930,6533,1,1230,700,1960
0705700210,320000,3,2.25,1650,7047,2,1650,0,1994
2817100040,355000,4,3,2580,9601,2,2130,450,1992
0686300880,670000,3,2,2570,10078,1.5,2570,0,1965
8122100355,550000,1,1,2880,7560,1,1440,1440,1925
3797000145,765000,4,2.75,2660,4500,1.5,1860,800,1909
1704900180,430000,3,1,1560,5225,1.5,1260,300,1927
9241900150,950000,3,2.5,3080,8448,2,3080,0,2000
5249803185,525000,4,1.75,2540,7200,1,1270,1270,1947
1598600209,300000,6,2.5,3080,8163,1,1580,1500,1985
3260810580,345000,3,2.75,2190,7258,2,2190,0,2000
2423059060,838000,3,3.75,2930,150945,2,2930,0,1972
5461300150,1.795e+006,5,2.75,2880,20274,1,1660,1220,1959
3422059010,390000,3,1.75,2160,98445,2,2160,0,1978
6795100330,1.15e+006,3,2,2110,18815,2,2110,0,1979
1776420150,295000,4,2.25,1830,5720,2,1830,0,2003
3735900770,775000,4,4,3180,7650,2,2530,650,1920
4123840210,380000,3,2.5,1880,6047,2,1880,0,1993
5076700145,550000,3,1,1140,8180,1,1140,0,1959
2482500040,199900,5,1.75,1798,11232,1,1798,0,1967
2589300065,329900,3,1.75,1670,5209,1.5,1670,0,1908
2332700081,898000,3,2.25,2580,11060,1,2580,0,1964
9201000610,875000,4,2.25,3720,12384,1,1860,1860,1970
2822049254,375000,4,2.5,2790,7956,2,2790,0,2005
2310110120,365000,3,2.5,2190,5091,2,2190,0,2004
2887700995,530000,4,2.75,2280,2850,1.5,1540,740,1930
8651410120,225500,3,1,1100,5200,1,1100,0,1969
7399000580,318000,4,2.25,2180,7000,1,1680,500,1969
7524950210,910000,4,2.5,2770,9798,2,2770,0,1986
1021049057,207000,3,1,1980,18730,1,1280,700,1943
0824059042,1.8867e+006,5,3.5,4180,17935,2,4180,0,2004
7525410120,624500,6,3,3030,31920,1,1670,1360,1980
2770600841,640000,3,2.5,1690,1553,2.5,1690,0,2007
2423069164,500000,3,2,1990,65340,2,1990,0,1986
3876000120,390000,5,1.75,2250,8970,1,1500,750,1966
3705000120,284000,3,2.25,2080,2050,1.5,1550,530,2003
0323069158,620000,3,2,2460,41343,1,2460,0,1988
6669240230,306000,3,2.5,2588,5702,2,2588,0,2008
7504400120,495000,4,1.75,2570,12039,1,1910,660,1978
1038000040,499950,3,2.5,2370,12753,2,2370,0,2001
9238450330,330000,3,1,1070,10563,1,1070,0,1969
1982200330,665000,3,2,1940,5820,1.5,1150,790,1944
1732800175,850000,3,2.5,2650,2387,2,1830,820,1920
8078350220,599950,4,2.5,2290,6318,2,2290,0,1988
3990200065,360000,4,2.5,2050,9143,2,2050,0,1992
3825311210,699000,3,2.5,2680,5497,2,2680,0,2001
1862400087,475000,3,1.75,1520,8100,1,760,760,1945
3522029124,575000,3,2,2690,435600,2,2690,0,1992
1250200418,345000,2,1.5,1180,844,2,990,190,2005
7967900150,367950,4,2.5,3030,9500,2,3030,0,1989
5631501073,374500,3,2.25,1400,11400,2,1400,0,1984
2826049197,607500,4,2.5,3000,8100,2,3000,0,1992
1775920210,374000,3,1,1200,9800,1,1200,0,1971
5272200035,390000,3,1,1000,6947,1,1000,0,1947
9525100040,705000,4,3.25,2740,5339,2.5,2740,0,2004
7853221010,467000,3,2.5,1990,4978,2,1990,0,2004
2500600297,243500,3,3,2110,7794,1,2110,0,1981
8562791010,593000,3,2.75,1830,1850,2,1690,140,2011
3550800040,223000,3,1,940,7980,1,940,0,1961
8857640210,574000,4,2.5,2980,10179,2,2980,0,2003
8898700120,400000,3,2,2260,11305,1,1130,1130,1986
1242700035,772000,4,2.75,3470,70131,1,1750,1720,1962
7200001005,593777,3,1.75,1510,10450,1,1510,0,1964
4174600072,539500,4,3.5,2710,5722,2,2040,670,1997
3630060150,550000,3,2.5,2080,2625,2,2080,0,2006
3348401490,265000,2,2,1860,10856,1,1260,600,1952
7214810150,428000,3,1.75,2120,9350,1,1280,840,1979
1566100450,505000,3,2,1110,8375,1,1110,0,1951
7851990120,925000,5,5.5,5190,12637,2,5190,0,2001
8937500040,230000,3,1.75,1520,15344,1,1520,0,1968
1149600120,695000,4,2.5,2650,9990,2,2650,0,1990
7853240040,700000,4,2.75,3350,7857,2,3350,0,2004
7517500085,712500,3,1.75,1770,2800,1.5,1770,0,1914
9527310180,480000,3,2.5,2200,4692,2,2200,0,2005
3558900580,470000,3,2.5,2000,8424,1,1300,700,1968
4046500180,335000,3,1.75,1730,15003,1,1150,580,1980
6386300120,270000,3,1.5,1300,7907,1,900,400,1970
3395350210,810000,5,3.25,2950,67475,1,2530,420,1981
9578080040,589000,3,3,1720,954,3,1460,260,2006
5683500085,415000,2,1,880,4558,1,880,0,1951
8645500360,197000,4,2.25,1790,13200,1,1220,570,1979
4222310220,235500,3,1.5,1380,7600,1,790,590,1971
2394600157,460000,3,2.25,1530,1840,2,1240,290,2008
9238900085,572500,5,1.75,2330,4947,1,1380,950,1955
2739200040,302000,5,2,1540,9629,1,1540,0,1960
3893100456,870000,3,2.5,3210,8630,2,2530,680,1990
1370803940,485000,3,1,1130,5758,1,960,170,1939
4222200120,240000,3,2,1460,7526,1,1460,0,1968
9477000120,383000,3,1.75,1410,7215,1,1410,0,1967
7228501065,750000,4,2.75,1750,5080,1.5,1750,0,1903
9266701085,409950,2,1.75,1370,5125,1,1370,0,1944
0985001082,246000,3,1.5,1780,23819,1,1780,0,1953
8815400410,860000,4,1.75,1890,4500,2,1490,400,1937
2459500210,339950,3,2.25,1630,12295,2,1630,0,1985
1219000043,315000,5,1.75,2320,8100,1,1160,1160,1956
4379400580,698000,3,2.5,2580,4636,2,2580,0,2006
2159900120,419000,2,2.5,1470,2034,2,1470,0,1985
1243100191,372000,3,1,2298,10140,1,2298,0,1969
7852150530,425000,3,2.5,1960,4709,2,1960,0,2003
7508700085,386500,3,2.25,2950,8036,1.5,1950,1000,1963
8820903370,348000,2,1,670,7312,1,670,0,1942
1923000150,754000,5,3.5,3020,15305,2,2230,790,1978
3920900220,269950,4,3,2390,7309,2,2390,0,1944
8835700330,891500,3,2.5,3090,20785,2,3090,0,1991
7338402160,349950,4,1.75,1780,5000,1,890,890,1903
3223059141,360000,2,1,1420,81892,1,1180,240,1956
0524059052,975000,4,2.25,2420,15482,2,2420,0,1925
6145600865,449250,4,2,1480,3844,1.5,1480,0,1928
2325400330,350000,4,2.25,2190,3850,2,2190,0,2006
9530100085,790000,4,1.75,1820,6137,1.5,1690,130,1911
3024059044,990000,3,1.75,1810,24586,1,930,880,1983
5015000596,834000,3,2.25,2550,4089,2,2550,0,1983
4443801285,466950,3,1,1360,3880,1,1060,300,1963
3751606606,262500,3,1.75,2259,26831,1.5,1491,768,1908
1829300210,762300,4,2.5,3880,14550,2,3880,0,1987
2767601085,733000,6,2.75,2730,5000,1,1780,950,1962
8832900155,439000,4,2.5,2800,17279,1,1560,1240,1957
8805900065,1.16e+006,5,3.25,4290,7019,2.5,3590,700,1927
8635760040,420000,3,2.5,1770,3993,2,1770,0,1999
8651540040,549000,3,2.25,1920,10961,2,1920,0,1981
9818700455,518000,4,2.5,2320,4000,1.5,1510,810,1905
0924069210,695000,4,2.5,2961,12146,2,2961,0,1998
1954430180,485000,3,2.5,1680,7385,2,1680,0,1988
5111400081,280000,3,1.75,1590,27200,1.5,1590,0,1926
5559200065,306500,2,1,1420,16400,1.5,1420,0,1943
1266200120,720000,2,1,1370,9460,1,1370,0,1950
8141310180,277500,3,2.5,2620,4558,2,2620,0,2010
6102400166,649000,3,2,1810,17006,2,1810,0,1913
3126059023,3.395e+006,4,3.5,4730,47870,1,2940,1790,1954
0408100150,267800,2,1,700,6000,1,700,0,1949
3905081520,625000,4,2.75,2390,6979,2,2390,0,1993
9324800220,600000,4,2.5,2070,8127,1.5,1590,480,1924
3996900555,395000,4,2,1780,8149,1.5,1780,0,1948
9456200450,212000,4,2.5,1900,21780,1.5,1900,0,1940
9165100330,425000,2,1,1040,4040,1,940,100,1928
2877103615,870000,4,1.75,2370,5000,1.5,1770,600,1919
7853210210,420000,3,2.5,1970,3667,2,1970,0,2004
7524950540,800000,4,2.25,2120,9921,2,2120,0,1981
0200500410,575000,3,2.5,1960,9535,2,1960,0,1989
9103000365,915000,3,3.25,2660,4000,2,2170,490,2003
6076500220,400000,3,2.25,1180,14258,2,1180,0,1987
1818800144,750000,3,2.5,2390,6550,1,1440,950,1955
2569600150,235000,3,1,1250,7592,1,1250,0,1961
3448000344,599950,5,3,2600,13674,1,1300,1300,1967
7170200085,481203,2,1,940,3800,1,940,0,1929
4094800120,1.815e+006,5,3,3880,13000,2,3880,0,1972
2591010180,379000,3,2.5,1530,2913,2,1530,0,1986
3052701135,626000,3,1.75,2430,5000,2,1760,670,1945
0625049281,535000,2,1,1030,4841,1,920,110,1939
5427110040,1.225e+006,4,2.5,2740,16007,2,2740,0,1984
9528103443,410000,2,1.5,1180,1034,2,1120,60,2001
7855800730,940000,4,2.5,3090,9238,1,1680,1410,1967
0395300650,326250,3,1,1060,9663,1,1060,0,1967
7812800995,200000,2,1,790,5985,1,790,0,1944
9541600355,880000,4,2.5,3070,8250,1,2100,970,1958
0774100355,370000,2,2,2100,58488,2,2100,0,2005
2781280150,190000,2,2.5,1100,1737,2,1100,0,2006
7338000150,160000,2,1,1070,4200,1,1070,0,1983
6977000040,625000,4,3,2190,12825,1,1520,670,1989
9558050230,590000,4,3.5,3450,6873,2,2750,700,2004
1241500155,575000,3,2.5,2070,3599,2,2070,0,1999
9266700256,470000,2,1,1190,5200,1,1190,0,1912
2354300456,130000,2,1,600,1500,1,600,0,1900
7789000120,229000,3,1,940,8400,1,940,0,1958
3210200395,279900,3,1,1280,12928,1.5,1280,0,1942
8658303065,307000,3,1,1370,7500,1,1370,0,1960
4046601010,399950,3,1.75,2450,15001,1,1980,470,1989
0526059183,405000,4,2.25,1970,15743,1,1370,600,1962
5056500210,539950,4,2.75,2910,9000,1,2130,780,1966
6146600175,129000,2,1,760,5240,1,760,0,1949
6057700120,340000,3,1.75,1270,8422,1,1270,0,1967
8651442060,214950,3,1.75,1570,4875,1,1310,260,1977
7129301445,450000,4,2.75,2310,5650,1,1330,980,1952
7881500330,515000,3,1.75,1900,5000,1,950,950,1925
1336800880,1.4e+006,4,2.25,3780,5160,2,2510,1270,1907
7147600220,230000,3,1,1060,9946,1,1060,0,1956
2600030210,681000,3,1.75,1880,10032,1,1880,0,1984
6303400150,255000,3,1,1160,8636,1,1160,0,1923
9136103136,580000,2,1,860,4013,1,860,0,1925
8898700880,295000,2,2,1590,8000,1,910,680,1984
4318200360,286000,2,1,1170,6543,1,1170,0,1913
6798100610,425000,3,1.5,1190,8100,1,830,360,1947
7466900220,170000,2,1,1300,11400,1,1300,0,1961
7435500085,380000,3,2,1660,8281,1,1660,0,1949
7977200995,506000,3,2,1160,6120,1,1160,0,1947
1862900360,315000,3,2.5,1950,9618,2,1950,0,1992
7852040210,449950,4,2.5,2470,3811,2,2470,0,1999
3343901961,255000,3,1,1430,12420,1,1430,0,1964
3874010220,289000,3,2.5,1970,9607,2,1090,880,1988
2724069103,389000,3,1.75,1400,10018,1,1400,0,1962
1520069052,327000,3,1.5,1510,344124,1,1510,0,1964
5316101075,2.885e+006,7,3,5350,14400,2.5,5020,330,1910
8113100150,210000,3,1,920,6612,1,920,0,1948
3459900230,1.68e+006,4,3.75,7620,29536,2,5980,1640,2005
3955900150,360000,4,2.5,2490,4751,2,2490,0,2001
7701960210,875000,4,2.5,3030,16000,2,3030,0,1990
0686450210,550000,4,2.25,1650,7200,1,1650,0,1967
3451000442,257500,3,1.5,1210,12500,1,1210,0,1962
5700003221,1.075e+006,4,2.75,2990,7389,1.5,2090,900,1923
8651402700,202950,2,1,1060,5144,1,1060,0,1969
3526039101,622000,4,1.75,2680,6120,1,1340,1340,1959
1136100072,455000,4,1.75,1790,45738,1,1410,380,1976
2050100210,805000,3,2.5,2690,17461,2,2690,0,1997
9141100210,257000,2,1,770,9497,1,770,0,1950
1153000150,744500,5,2.5,2700,16570,1,1750,950,1967
1245000438,885000,4,2.5,2620,9157,2,2620,0,1996
1498300775,355000,2,2.25,930,747,2,630,300,2007
4051100230,240000,3,1,1340,7000,1,1340,0,1978
0121039038,169000,3,1.5,1470,18459,2,1470,0,1916
1523550220,639900,3,2.5,2330,4160,2,2330,0,1992
1622059095,292000,3,1.75,1730,11325,1,1730,0,1972
7853220210,563500,4,2.5,2780,7838,2,2780,0,2004
8682291510,389000,2,2,1200,7131,1,1200,0,2006
7397300220,2.75e+006,4,3.25,4430,21000,2,4430,0,1952
3764500230,661000,3,2,1820,4418,2,1820,0,1994
8682260870,344000,2,2,1300,4659,1,1300,0,2005
0369000365,510000,1,1,680,6600,1,480,200,1916
9238901020,289000,2,1,780,4132,1,780,0,1942
3343901641,365000,3,2.25,2430,7614,1.5,1900,530,1979
3024079057,410000,3,1.5,1750,32500,1,1750,0,1966
7518507330,535610,3,1,1610,5100,1.5,1010,600,1901
2968801510,397950,4,1.75,2120,7620,2,2120,0,1971
2822100175,284000,3,1.75,1430,4850,1,930,500,1978
3826000385,201000,4,1.5,1360,8100,1.5,1360,0,1962
2301400540,734000,4,2.25,2530,5000,1.5,1690,840,1925
2111010760,357500,5,3,3270,9146,2,3270,0,2002
0023500220,550120,5,2.5,2620,8050,1,1520,1100,1975
8001600150,300000,3,1.5,1810,8232,1,1810,0,1988
9149000180,374950,3,2.5,2120,9653,2,2120,0,1992
7525420150,602500,4,1.75,2190,41000,2,2190,0,1980
1003000175,221000,3,1,980,7606,1,980,0,1954
2902200874,920000,5,3,2230,4400,2,1730,500,1913
7131300032,235000,4,2,1540,9279,1,1540,0,1955
3581100330,375000,3,1,980,7296,1,980,0,1967
3629970870,599000,4,2.5,2120,3640,2,2120,0,2005
2561360210,562100,3,2.25,2090,12112,2,2090,0,1983
9828702245,640000,3,2.5,1620,1377,2,1100,520,2009
8687800150,294000,3,2,1650,11256,1,1250,400,1957
3825310760,714000,4,2.5,3230,7766,2,3230,0,2005
7284900385,970000,4,3.25,2790,5420,1,1130,1660,1963
5702380770,280000,4,2.25,1600,7916,2,1600,0,1991
2095600150,260000,4,2.5,1790,4358,2,1790,0,1993
4166600230,294000,3,1.5,2060,15050,1.5,2060,0,1938
3521059042,255500,4,1,1370,41194,1.5,1370,0,1900
3625059043,3.3e+006,5,4.75,6200,13873,2,4440,1760,1989
1926069054,450000,3,2,1510,43560,1,1510,0,1954
9238450150,368000,3,1,1280,9898,1,1280,0,1968
8146200150,830000,4,2.25,2180,11056,1,1370,810,1963
3841600220,282500,2,1.75,1440,11210,1,1130,310,1935
0943100683,335000,3,2.25,1580,16215,1,1580,0,1978
0952001765,558000,2,2,1580,5750,1,790,790,1910
3744600704,270000,4,1.5,1730,8505,1.5,1730,0,1961
1822059057,152000,2,1,700,13500,1,700,0,1920
2126059219,493000,4,1.75,2030,18295,1.5,2030,0,1975
4139400910,740000,4,2.5,2500,10330,2,2500,0,1992
9808630210,789800,3,2.5,2605,2216,2,2090,515,1979
2920700220,275000,2,1,910,4191,1,910,0,1910
1338800365,1.5e+006,6,2.5,3560,6480,2.5,3560,0,1914
1175001135,424000,3,1.75,1140,3395,1,620,520,1925
3867400180,715000,2,1,1000,3513,1,1000,0,1914
7954300220,600000,4,2.5,3010,7953,2,3010,0,2000
7784400035,802000,2,1.75,2110,8700,1,1760,350,1960
4435600330,165000,3,1,910,8700,1,910,0,1943
5016001285,750000,4,3.25,2050,5000,2,1370,680,1987
6817800330,405000,2,1,1090,10481,1,780,310,1981
8680500220,521900,3,2.5,2100,12338,2,2100,0,1997
3211600650,275000,3,1,1000,8018,1,1000,0,1969
4008400035,600000,5,3.25,4410,58157,2,2330,2080,2001
2473002060,442500,3,1.75,1800,10200,1,1800,0,1967
4059400515,229950,2,1,920,7716,1,920,0,1944
2916610150,274950,3,2,1410,7265,1,1410,0,1983
8887001215,407185,3,1.75,1860,48076,1.5,1860,0,1929
3876313040,468000,4,2.5,2100,8400,1,1240,860,1976
6021501320,450000,2,1,1030,4365,1,1030,0,1942
2372800145,219950,2,1,940,8997,1,940,0,1955
7120000210,275000,2,2.5,1340,5995,2,1340,0,1989
1180003175,229950,2,1,850,6000,1,850,0,1924
2902200915,675000,3,1.75,2130,4400,1,1430,700,1922
2473530150,412950,4,2.5,2430,6796,2,2430,0,1993
2366400150,670000,5,2.25,2290,39000,2,2290,0,1979
4040800360,420000,3,1.75,1230,10005,1,1230,0,1963
1269200150,358000,3,1.5,1150,27319,1,1150,0,1976
9510970530,680000,3,2.5,2120,3600,2,2120,0,2005
3856904825,380000,2,1,980,3400,1,980,0,1923
0326069101,515000,3,2.5,2130,219978,2,2130,0,1986
0254000175,325000,2,1,1050,4800,1,1050,0,1969
8086000201,875000,3,2.5,1820,6848,1,1820,0,1953
9284800085,426000,3,2.5,2210,5750,2,1710,500,1914
2287000330,868500,5,2.5,2490,9639,1,1610,880,1959
2025760210,657500,4,2.75,4140,24190,2,4140,0,2002
3330500085,366000,2,1,1210,3090,1,860,350,1926
1231001225,385000,2,1,1010,4000,1,1010,0,1911
0984000650,300000,4,2,2050,8750,1,1300,750,1967
1962200145,810000,3,1.75,2060,3300,2,1500,560,1918
4074300150,460000,4,1.75,1560,7200,1,860,700,1943
8665050220,459000,3,2.5,1780,4000,2,1780,0,1995
2212700180,260000,3,1.75,1460,10000,1,1460,0,1967
8077200360,557865,4,2.5,3030,6813,2,3030,0,1987
8850000180,295000,4,1,980,3000,1.5,980,0,1914
1643500072,375000,4,2.25,1450,7245,1,1450,0,1950
6065300330,2.11e+006,3,2.25,3230,17833,2,3230,0,1973
6149700191,307300,2,2,1520,1020,3,1520,0,1999
1555200180,225000,4,1,1410,7000,1.5,1410,0,1963
9407100720,290000,3,1.75,1390,13200,2,1390,0,1979
5700000515,690000,4,2,2230,5000,1.5,1510,720,1922
5451200530,825000,4,2.25,2110,12653,2,2110,0,1972
0868000530,645000,3,1.75,2270,11472,1,1370,900,1956
1777600210,590000,4,2.25,2530,10611,1,1320,1210,1977
7174800760,667000,5,2,1900,5470,1,1180,720,1930
8635750330,664000,4,2.5,2390,8432,2,2390,0,1998
4058800925,452100,4,2.5,3160,6540,1,1580,1580,1959
0272000620,290000,2,1,900,2728,2,900,0,1998
7779200355,950000,3,3,3610,17483,2,3610,0,1954
0510000641,662500,3,2,2070,4200,1.5,1670,400,1906
8835200230,475000,4,2.5,1850,5444,2,1850,0,1981
8718500555,450000,3,1.5,1440,9711,1,1140,300,1956
1722049154,538250,3,2.25,2590,15229,2,2590,0,1984
6450304130,329950,2,1,1140,5250,1.5,1140,0,1949
6908200155,1.10399e+006,4,3.5,2760,5040,2,2760,0,1955
1773101020,307000,5,1.5,1310,4800,1.5,1110,200,1929
1105000571,433000,3,1.75,1870,7189,1,1270,600,1959
5153200666,212000,3,2.25,1900,18000,1,1280,620,1968
7660100085,750000,5,2.75,2860,6000,2.5,2380,480,1902
1843130530,279000,3,2,1640,5650,1,1640,0,2003
7010700905,476000,3,1,1140,5500,1.5,1140,0,1908
6790600790,368000,5,1.75,2590,9394,1,1390,1200,1963
8651442520,228950,4,3,2160,5200,1,1320,840,1978
2722059010,568450,5,3.5,3260,58806,2,3260,0,1969
6884800210,619000,4,1.75,1660,3800,1.5,1660,0,1926
7349600230,275000,3,2.25,1640,6044,2,1640,0,1996
6699300210,321500,4,2.5,2620,5457,2,2620,0,2003
7883607520,230000,3,1.75,950,6000,1,790,160,1939
1450000210,179500,3,1,900,8100,1,900,0,1959
1387301430,460000,3,2.25,1650,7313,1,1220,430,1975
2517010230,286000,3,2.5,1800,3980,2,1800,0,2006
9828201020,427500,3,1,1480,4200,1.5,1480,0,1925
2461900175,400000,3,1,1040,6250,1,1040,0,1942
8682250330,675000,3,3.5,2300,5611,1,2300,0,2004
3031200230,350000,3,1,2480,8906,1,1240,1240,1969
3824100166,385000,4,1.75,1970,10358,1,1540,430,1977
7011201445,525000,2,1.75,1530,3503,1,830,700,1916
7262200150,315000,2,1,970,18557,1,970,0,1939
1623069023,820000,4,2.5,2920,252648,2,2920,0,2002
7523700210,205000,3,1,970,7700,1,970,0,1959
2915200210,500000,2,1,680,5250,1,680,0,1922
3904990210,599000,4,2.5,2640,6738,2,2640,0,1989
1333300145,2.225e+006,3,4,4200,30120,2,3600,600,1933
7461400360,299000,1,2.5,1980,7521,1,1180,800,1979
7631200085,947500,3,2.75,2980,27144,1.5,2180,800,1917
6145600040,385000,3,3.25,1630,1677,3,1630,0,2007
6372000155,639950,2,1.75,1780,4520,1,890,890,1925
6821600145,824000,2,1,1210,8400,1,780,430,2000
7983100150,199950,3,1,1010,7245,1,1010,0,1969
0723000150,1.005e+006,3,2.5,2570,5000,1,1480,1090,1940
2493200155,950000,4,2.25,2770,5320,2,2440,330,2013
2592210150,822000,3,2.5,2290,9158,2,2290,0,1984
2595300210,473600,4,1.5,1780,8400,1,1080,700,1969
3902100150,490000,5,2,2150,4500,1.5,2150,0,1938
3329520410,245000,3,1.75,1920,9306,1,1000,920,1984
4013800206,199000,4,1,1220,11730,1,1220,0,1960
1370803460,1.34e+006,3,3,2960,5500,2,2440,520,1937
4046600220,418000,3,1.75,1500,19113,1,1500,0,1984
6190701484,450000,7,3.5,2830,8625,1,1830,1000,1957
8016200530,280000,3,2.5,1580,7000,2,1580,0,1992
6802210210,273000,3,2.25,1230,11601,1,910,320,1992
4305600040,549000,4,2.5,2910,6338,2,2910,0,2008
7856570150,913888,5,2.25,2370,15512,2,2370,0,1981
7576200040,689888,4,2.25,1930,3500,1.5,1540,390,1916
6300500183,305000,4,2,1780,5043,1,870,910,1993
3204950120,602500,4,2.5,2760,6850,2,2760,0,1999
7857004225,355000,2,1.75,1620,3640,1,900,720,1929
7732400360,756000,3,2.5,2160,7525,2,2160,0,1986
4388000120,289950,4,2.25,2190,6906,1,1040,1150,1977
8653900150,800000,3,2.5,3240,7857,2,3240,0,1994
3362400472,403000,2,1,720,3255,1,720,0,1905
8857100180,350000,3,2.25,1410,1340,2,1370,40,1967
8156600210,1.285e+006,5,3.5,2980,5100,2,2370,610,2015
4038700720,525126,5,2.25,1950,8025,1,1150,800,1960
2634500085,241450,3,1,1100,8138,1,1100,0,1949
1077100035,320000,3,1.5,1400,9087,1,1400,0,1954
5466700360,234000,4,2,1710,7455,1,1030,680,1975
1250201165,441000,5,2.5,2000,3600,1,1150,850,1987
1250201165,474500,5,2.5,2000,3600,1,1150,850,1987
4083301120,705000,3,1,1440,2618,1.5,1440,0,1906
3905100610,517500,4,2.5,1520,3370,2,1520,0,1994
4330600360,142500,4,0.75,1440,13300,1,1440,0,1948
0345700150,310000,2,1.5,1010,10005,2,1010,0,1981
7732100150,749500,4,2.5,2440,9727,2,2440,0,1987
5379800862,360000,5,3,2480,7200,1,1560,920,1999
4396000180,267500,3,1,1090,22080,1,1090,0,1967
1447600410,290000,3,1,1480,32700,1,1380,100,1942
3325059177,850000,5,2.5,2800,11325,1,1400,1400,1970
2652500155,815000,4,1.75,1820,4500,1.5,1820,0,1921
0824059305,2.2e+006,5,4,5840,11652,2,4410,1430,1988
5318101565,1.625e+006,4,3.25,2980,3600,2,2150,830,1999
2460600040,175000,3,1.5,1220,7300,1,1220,0,1973
9527000040,429950,3,1.75,1830,9758,1,1300,530,1977
2909300150,675000,4,2.5,2900,5505,2,2900,0,2002
8078600330,580000,3,2.25,1940,5980,1,1520,420,1987
4338800720,240000,4,2,1750,7800,1,1750,0,1944
4016800120,374000,3,2.5,1850,17808,1,1210,640,1982
2021201085,862500,4,2.5,3220,4400,2,2180,1040,1937
1922059010,140000,2,1,1080,6052,1,1080,0,1908
1133000385,740000,5,3.75,3990,18897,2,3090,900,1937
2397100155,589000,3,1.75,920,3600,1,820,100,1904
7461420210,275000,3,1.75,1290,9760,1,1290,0,1979
6204050040,489900,4,2.5,2090,4196,2,2090,0,2006
4099100210,545000,3,2.5,1900,3366,2,1900,0,1996
0316000145,235000,4,1,1360,7132,1.5,1360,0,1941
3331000455,230000,3,1,1000,4000,1.5,1000,0,1915
9839300775,655000,4,2.25,2170,4080,2,1920,250,1980
2320069107,185000,2,1,820,16030,1,820,0,1923
2599001010,196000,3,1,1090,7400,1,1090,0,1962
2193340120,572000,3,2.25,1830,7897,1,1290,540,1986
7954310210,615000,4,2.5,3010,6903,2,3010,0,2001
2425049107,1.95e+006,4,3.75,4150,17424,1,3130,1020,1963
1338300555,1.225e+006,6,2.25,2930,4320,2,2130,800,1913
8944310330,375000,3,2.5,1520,5649,2,1520,0,1989
2551500180,295000,3,1.75,1250,9486,1,1250,0,1971
9212900180,760000,4,2.5,2760,6000,2,2230,530,1942
2473460650,347000,3,1.75,1330,7848,1,1330,0,1978
2856101755,712000,3,2,1700,5100,1.5,1500,200,1924
3080000040,495000,4,2,2050,4000,1.5,1210,840,1941
1224049080,925000,4,2,3140,10437,1,2040,1100,1959
9547200835,775000,3,1,2030,4080,1.5,1840,190,1908
4363700365,429000,4,2.5,2100,7920,1.5,1400,700,1916
7683800212,229000,3,1,1010,12705,1,1010,0,1959
1324079054,400000,4,1.5,1980,113691,1,1980,0,1962
2141330360,625000,4,2.25,2100,8290,2,2100,0,1978
6450302546,130000,2,1,840,6654,1,840,0,1951
7972600676,349000,3,1.75,1690,5080,1,1190,500,1976
0922059161,365000,3,2,2140,26600,1,2140,0,1983
2770601461,487500,3,2.5,1810,1988,2,1350,460,1997
8079010230,475000,3,2.5,2600,7210,2,2600,0,1989
5458800620,685000,3,1.75,1650,8400,1,1470,180,1959
5318101075,960000,3,1.75,2460,4800,1,1230,1230,1938
5430300120,1.1e+006,5,2.25,4320,7620,2,2880,1440,1973
1442700360,428000,3,2.25,2600,15000,2,2600,0,1978
5651010150,435000,3,2.5,1930,5790,2,1930,0,1988
6908200021,769950,3,2,2190,5400,1,1260,930,1952
2201500555,385000,3,1,1420,10980,1,1200,220,1954
0255550150,352000,3,2.5,2090,3002,2,1670,420,2005
0524069011,622500,3,2.5,2290,14374,2,2290,0,1983
7504010760,660000,3,3,2470,11900,2,2290,180,1976
1788800610,105000,3,1,840,8400,1,840,0,1959
7192800145,420000,2,1,2100,4480,1,1400,700,1908
5566100145,499950,3,1.5,1360,11250,1,1360,0,1955
2024059052,975000,6,3,3420,22421,1,2270,1150,1948
2436700540,665000,3,2.75,1930,2960,1.5,1490,440,1929
7200001608,540000,4,2.5,2180,10140,1,1180,1000,1968
5612100065,400000,4,2,1670,12056,1,1670,0,1955
7785380150,469950,4,2.75,2720,6427,1,1650,1070,2008
4178310040,777000,4,2.5,3170,9900,2,3170,0,1979
1708400555,346500,2,1.75,1610,6300,1,1010,600,1941
3629760330,685000,3,2.5,2370,4950,2,2370,0,2003
5469501830,396500,3,2.5,2590,18980,1,2590,0,1976
9829201058,783500,3,2.5,2850,7130,2,1990,860,1980
1931300175,575000,4,2,1660,4800,1.5,1660,0,1922
7237500360,1.5e+006,4,4.25,5550,12968,2,5550,0,2005
0923000120,515000,3,1.5,2200,7620,1,1130,1070,1942
1446800995,300000,3,2.5,2020,6628,1,1250,770,1963
8732000410,272000,3,1.5,1760,9600,1,1760,0,1966
7303100210,355000,4,2.25,1810,4970,2,1810,0,2003
3348401622,223000,3,2,1310,8440,1,1310,0,1951
3793501400,397000,4,2.5,3000,8584,2,3000,0,2003
2872100385,460000,2,2,1080,5000,1,1080,0,1923
1689400150,848000,3,2.75,2170,2738,1.5,1550,620,1930
2887701251,392800,2,1,740,4275,1,740,0,1924
3528000040,1.69e+006,3,3.25,5290,224442,2,4540,750,1988
3528000040,1.8e+006,3,3.25,5290,224442,2,4540,750,1988
3787000120,577000,3,2.25,2370,7878,2,2370,0,1985
5693500760,570000,3,1,1890,3330,1.5,1390,500,1901
8892900180,250000,3,1.75,1160,6134,1,1160,0,1998
5458800330,645000,4,1.75,1550,7350,1.5,1550,0,1958
1560930450,567500,3,2.5,3090,67082,2,3090,0,1990
6699930360,337000,4,2.5,2610,5240,2,2610,0,2004
1423900580,280000,3,1.75,1230,8250,1,1230,0,1966
7338000730,167000,3,1.5,1280,5547,2,1280,0,1985
4364700730,280000,2,1,1880,7560,1,940,940,1919
7305300760,317500,2,1.5,1220,8409,1,1220,0,1948
2488200455,405500,2,2.75,1350,1252,2,1120,230,2006
0318900120,495000,4,2.5,2370,15336,2,2370,0,1995
7504110330,691000,4,3,3040,11651,2,3040,0,1987
2222039011,480000,5,1.75,2080,217800,1,2080,0,1963
6021502300,549010,2,1.75,1560,4141,1,880,680,1942
3630110360,750000,5,3.5,2980,5809,2,2980,0,2005
1529300410,365000,2,1,870,5689,1,870,0,1948
2426049154,412500,3,1.75,1660,10716,1,1100,560,1988
6204420180,425000,3,2.25,1870,9000,1,1440,430,1978
8085400410,920000,3,1,1410,9656,1,960,450,1953
8731980880,340000,4,2.25,2180,8000,1,1630,550,1975
0626049115,405000,4,2.5,2620,8960,1,1520,1100,1955
6388910040,537100,3,2.5,2450,7051,1,1870,580,1990
1748800120,353500,4,2.5,3250,4650,2,3250,0,2007
4077800582,522000,3,1,1150,7080,1,1150,0,1952
7202260210,710000,4,2.75,2780,6978,2,2780,0,2001
5095600360,329950,3,1.75,1360,13320,1,1360,0,1985
2607801120,830000,5,2.5,2810,14207,1,1540,1270,1979
9542200610,800500,4,2.5,1780,11130,1,1780,0,1962
8092000330,168500,3,1,1100,10125,1,1100,0,1969
7852020790,490000,3,2.5,2230,5348,2,2230,0,2000
6379500227,579000,3,2.5,1710,1904,2,1140,570,2003
6790200180,600000,4,2.5,2620,9873,2,2620,0,1987
1781500155,445000,4,1.75,1990,4725,1.5,1190,800,1944
3424069154,362500,4,1.75,1450,8450,1,1450,0,1960
1683500180,234000,4,2,1630,9010,1,1050,580,1975
1523300180,321500,1,1,730,1942,1,730,0,2008
1868901120,660000,3,1.75,1980,3300,1.5,1140,840,1926
0822059101,319000,4,1,1730,36356,1.5,1730,0,1954
3421069020,314000,3,1.75,1350,217852,1,1100,250,1953
2769602710,517950,3,2,1410,5000,1,740,670,1908
6071300180,525000,5,2.5,2360,10081,1,1180,1180,1961
3211101010,319500,3,1,1190,8450,1,1190,0,1961
9471201175,1.58e+006,4,3.25,3760,10920,1.5,2400,1360,1950
2009003136,325000,1,1,1220,12426,1,1220,0,1946
7574910220,795000,4,2.5,2920,32219,2,2920,0,1995
1370801465,850000,2,1.75,1590,5136,1.5,1320,270,1927
1245500730,1.01e+006,5,3.25,3510,10930,2,3510,0,2013
2767603591,475000,3,2.5,1320,1310,3,1320,0,2006
8718500665,375000,3,1,1610,11250,1,1090,520,1975
0106000395,405000,3,1,1410,8053,1,1410,0,1951
5538300120,420000,4,2.5,2170,10500,1,1570,600,1962
9405800040,775000,4,1.75,1890,4800,1.5,1390,500,1906
3630180450,800000,4,2.75,3260,5000,2,3260,0,2007
8126300610,436800,3,1.75,2080,12714,2,1540,540,1984
0546000910,620000,3,1.75,2040,4005,1.5,1740,300,1930
2268000180,230000,3,1,1250,9035,1,1250,0,1970
3333002450,165000,1,1,850,8050,1,850,0,1906
3333002450,490000,1,1,850,8050,1,850,0,1906
6072000910,480000,3,1.75,1600,8400,1,1600,0,1963
4113800330,570000,3,2.5,2400,6975,2,2400,0,1993
3764500180,615000,3,2.25,1870,4894,2,1750,120,1992
1326049170,280000,3,1,1720,9605,1,860,860,1969
9238450210,326000,3,1,1030,9834,1,1030,0,1969
2436700666,550700,2,2.25,1190,1499,2,1100,90,2004
3043200035,600000,2,1,910,2002,1.5,910,0,1900
1424069044,450000,3,1,1290,47044,1,1150,140,1968
3037200141,546000,2,2.25,1530,1324,2,1280,250,2010
1323089107,585000,3,2.5,2330,33750,2,2330,0,1983
8024201714,489000,3,1.75,2090,7667,1,1200,890,1952
9829200325,765000,3,2,1570,7000,2,1050,520,1971
0723039189,519000,3,1.75,1560,26099,1,1560,0,1973
1352300120,262000,2,1,1500,4120,1.5,880,620,1928
5101404351,550000,4,2.75,2160,5005,1,1430,730,1987
7211401485,285000,2,1,780,5000,1,780,0,1943
5631500967,476000,4,1.75,2340,17541,1,1360,980,1956
2425049061,2.2e+006,3,2,3570,30456,1,2070,1500,1946
7518503065,335000,1,1,720,5100,1,720,0,1907
1796000120,510000,4,2,2990,102366,1,2990,0,1974
1922059197,291000,3,2.25,1860,13939,1,1860,0,1961
7849201020,335000,4,1.75,1950,13440,1.5,1950,0,1931
1126049103,415000,3,1.5,1860,9003,1,1490,370,1955
0065000085,430000,3,2,1550,6039,1,830,720,1942
9211510410,270000,3,1.75,1610,6205,1,1210,400,1979
2301400325,760000,3,2,1810,4500,1,980,830,1906
7132300540,450000,2,2,1730,4248,2,1730,0,1905
0323059103,425000,3,2.5,1230,23522,1,1230,0,1978
4083306705,725000,4,2.5,2130,3420,1.5,1730,400,1916
1245001216,700000,3,2.75,2190,11060,1,1610,580,1973
0293760210,998000,5,4.5,4130,10404,2,4130,0,2004
3782400040,396000,3,2.25,1680,9766,2,1680,0,1989
2726049164,547000,3,2.5,1480,8381,1,1480,0,1968
9183701085,302000,4,1.5,1790,10200,1,1210,580,1963
1623300325,999000,5,3.5,2810,2700,2,1900,910,1910
7987401010,633000,4,2.5,2360,10000,1,1980,380,1977
2131200065,265800,3,1.75,1460,7361,1,1460,0,1982
6141600065,530000,3,2.25,2160,8114,1,1460,700,1960
1562100220,605000,6,2,2610,9132,1,1320,1290,1965
7853300970,489000,4,2.5,2170,4587,2,2170,0,2006
8687800065,305000,2,1,2160,12960,1,1360,800,1968
1504800097,513000,4,2.75,2020,7070,1,1010,1010,1958
3630160610,765000,4,2.5,2980,5000,2,2980,0,2006
6852700477,550000,2,1.5,1300,2970,1,990,310,1903
2592220040,974350,4,2.5,3090,10730,2,2420,670,1985
7524950730,653675,4,2.25,2280,7229,2,2280,0,1984
1545807920,245000,3,1.75,1260,8614,1,1260,0,1985
3213200180,700180,2,1.75,1530,4387,1,1020,510,1952
3577300040,510000,3,2.5,1830,8133,1,1390,440,1996
2064800610,390000,3,2.5,1610,10292,1,1190,420,1969
7215730120,606500,3,2.5,2170,5500,2,2170,0,2000
0629800540,1.5e+006,4,4.25,5020,26319,2,5020,0,1998
7575610760,290000,3,2.25,1620,7772,2,1620,0,1988
0104500730,115000,3,1.75,1080,7942,1,1080,0,1981
8137500730,500000,3,2.5,1940,37565,1,1940,0,1987
9543000205,139950,0,0,844,4269,1,844,0,1913
3543900418,580050,3,2.5,2360,4638,2,2360,0,1996
8929000230,550000,3,2.5,2010,2261,2,1390,620,2014
2856100360,465000,3,1,800,3060,1.5,800,0,1903
6413600276,354950,3,1,970,5922,1.5,970,0,1949
8562720230,980000,4,3.25,3720,7150,2,3720,0,2007
3579000410,500000,3,2.25,2010,7447,2,2010,0,1985
3856904655,667750,4,1,1430,4080,1.5,1430,0,1924
8832900360,735000,3,1.75,2250,11520,1,2250,0,1956
4058200040,361000,3,1.75,2130,8742,1,1330,800,1955
4178501020,276750,3,2,1620,12482,1,1290,330,1989
8562790730,760000,4,3.25,3140,3680,2,2310,830,2009
0455000841,475000,2,1,870,7975,1,870,0,1946
2154900330,234000,4,2.5,1820,8217,1,1120,700,1987
8159610150,234950,3,2,1510,9153,1,1510,0,1974
1545800730,269950,2,1.75,1320,7540,1,1320,0,1968
3904980360,495000,3,2.5,1800,7318,2,1800,0,1989
5100403321,438000,2,1,1120,6380,1,1120,0,1942
1326069151,260000,3,1.75,2160,22702,1,2160,0,1981
0629410180,697000,4,2.5,3220,6399,2,3220,0,2004
7452500815,212625,2,1,960,5000,1,960,0,1951
6840701135,593000,5,2.5,2640,4400,1.5,1840,800,1925
5104512060,410000,4,3,2430,7243,2,2430,0,2003
2917200365,445434,2,1,1470,7137,1,1020,450,1941
5151600040,200126,3,2.5,2040,15463,1,1340,700,1968
2025700790,290700,3,2.5,1670,6666,2,1670,0,1992
7686204675,248000,4,1,1010,7515,1,1010,0,1955
0126039305,345000,1,1,540,10125,1,540,0,1961
1930300915,525000,3,1,1240,4800,1,800,440,1951
9477100330,400000,3,1.75,1510,8385,1,1510,0,1968
0513000665,532000,3,1,1820,5750,1,1120,700,1918
8581400450,159995,2,1,1000,5026,1,760,240,1915
1061500360,287000,5,1.5,2040,11772,1,1030,1010,1963
1373800330,1.115e+006,4,2.5,3690,11191,1,2190,1500,1951
2597520790,765000,3,2.5,2310,11993,2,2310,0,1988
2525300540,185000,3,1.5,1090,9605,1,1090,0,1969
3797000035,430000,3,1,1150,3000,1,1150,0,1906
3709600180,346000,4,2.5,2100,3916,2,2100,0,2009
3902300210,607000,4,2.75,2150,16728,1,1240,910,1982
2113700620,417000,3,1.5,2500,6000,1.5,1730,770,1941
5700003705,930000,5,2,3530,9385,1.5,3530,0,1925
0034001540,573300,2,1.75,1290,6600,1,870,420,1951
2976800145,260000,4,1.75,2010,10816,1,1410,600,1955
7549801385,280000,1,0.75,420,6720,1,420,0,1922
9103000360,825000,4,2.5,2180,4000,2,2180,0,1920
7304300720,307000,4,1,1150,8184,1.5,1150,0,1947
1254200835,595000,4,1.75,2000,5100,1,1130,870,1949
8562700410,528000,5,1.75,2780,7786,1,1390,1390,1966
7558800620,600000,2,1.75,1550,7764,1,1550,0,1965
2122049038,275000,2,1,2180,12875,1,1480,700,1959
2397101075,782000,2,1.5,1570,3600,1.5,1320,250,1906
7695470120,610000,3,2.5,2260,33042,1,1660,600,1986
4083304700,488000,3,1,1600,3200,1.5,1600,0,1909
7857001225,320000,3,1,1630,5000,1,930,700,1954
4356200210,153500,3,1,890,4810,1,890,0,1910
3840700205,414500,3,1,1350,9450,1,1350,0,1979
7739100155,750000,5,1.75,2850,11860,1,2850,0,1951
1720069029,349990,3,1,1350,165092,1,1350,0,1925
0921049141,645000,3,2.25,3280,79279,1,3280,0,2001
6909700205,425000,2,1,1090,6000,1,1090,0,1922
2725069164,785000,4,2.5,2990,9374,2,2990,0,2003
3523069060,290000,3,1.75,1340,63597,1,1340,0,1963
3523069060,415000,3,1.75,1340,63597,1,1340,0,1963
4302200790,248500,2,1,720,5160,1,720,0,1949
8899210610,325000,3,2.5,2330,8627,1,1480,850,1980
5631500905,272925,2,1,1280,5728,1.5,1280,0,1941
2770601530,500000,2,2.25,1570,1269,2,1280,290,2015
7831800411,250000,4,1.75,1510,5500,1.5,1510,0,1920
0326049103,470000,4,2.5,2470,8536,2,2470,0,2002
1231001115,440000,2,1,1190,3400,1,990,200,1917
1041440360,299999,4,2.5,1981,4828,2,1981,0,2013
5001700040,255000,3,1.75,1590,7810,1,1590,0,1959
4037200665,415950,3,1.75,1150,7700,1,1150,0,1957
5249802520,402000,5,2.75,2160,7200,1.5,1220,940,1955
3585300410,729000,3,1.5,1770,30689,1,1770,0,1953
1624049087,635000,2,2.5,2470,8840,2,1780,690,2001
8121200530,479000,3,2.5,1710,8998,2,1710,0,1982
6705120540,462370,2,2.25,1860,2670,2,1860,0,1986
3353402390,171500,3,1,1150,6480,1.5,1150,0,1946
6190000035,925000,5,3,3850,9457,2,2910,940,1963
1313000220,675000,5,3,3410,9600,1,1870,1540,1968
0921059161,320000,4,1.5,1890,43560,1,1890,0,1974
1823069279,499950,5,3.5,3200,43560,2,3200,0,1989
0826059152,435000,5,1,2170,65340,1.5,1670,500,1930
4136930360,359800,4,2.5,2390,6426,2,2390,0,1999
7697870530,239900,3,2,1410,7566,1,1410,0,1985
1024000109,295000,2,1,740,4459,1,740,0,1915
5112800234,380000,3,2.5,2150,25705,1.5,2150,0,1980
8122101115,435000,4,2.5,2180,6500,2,1410,770,1945
6933600540,508000,2,1,820,5040,1,820,0,1953
6169900790,2.4e+006,6,4.5,5480,10800,2,4430,1050,1999
8001210120,234500,4,2.5,1960,7875,1,1220,740,1978
1931300870,355000,2,1,1270,3200,1,960,310,1920
8651441210,230000,3,2,1710,5200,1,1030,680,1977
1217000481,345000,3,1.75,1930,9000,1,1150,780,1951
7925100271,430000,3,1.75,1200,4500,1,1200,0,1906
1233100366,500000,3,1.5,1680,17409,1,1680,0,1962
9250900124,378000,4,1,1300,6075,1,1300,0,1954
7852050220,345000,3,2.5,1540,3237,2,1540,0,1999
9297301520,410000,2,1.75,870,4000,1,870,0,1941
8615800325,750000,2,2.25,1890,5400,2,1610,280,1905
9512500610,485000,4,1.75,2050,8913,1,1330,720,1968
4311700120,105000,3,1,880,18109,1,880,0,1970
1930301325,1.025e+006,3,2.75,2780,4000,2,1960,820,1904
3888100133,360000,3,1,1160,10988,1,1160,0,1965
9510900610,294000,5,2.75,2300,7600,1,1400,900,1969
5469502060,400000,4,2.5,3140,12792,2,3140,0,1977
2946002914,325000,3,1.75,2300,6200,1,1150,1150,1970
7856640180,770000,3,2.5,2900,23550,1,1490,1410,1987
6204200180,443000,3,2.25,1920,8223,2,1920,0,1989
5145100180,325000,3,1,1150,7486,1,1150,0,1970
3905090410,760000,4,2.5,3120,8792,2,3120,0,1992
5363200180,640000,4,2,2560,7798,1,1890,670,1947
8806900040,415000,3,2,1410,4303,1.5,1410,0,1900
3674400035,156000,3,1,970,8580,1,970,0,1959
6648150150,996000,3,3.25,3620,8131,2,2730,890,1988
9266700175,415000,2,1,880,5100,1,880,0,1941
3678900450,615000,3,1.75,1900,3783,1.5,1110,790,1927
9526600210,717000,4,2.5,2540,4241,2,2540,0,2009
0631000040,548000,4,1.75,1690,7794,1,1090,600,1968
2026049122,425000,3,1.5,1120,6653,1,1120,0,1937
7523850150,325250,4,2.75,2130,9339,1,1330,800,1991
2326059080,1.225e+006,3,2.5,3420,79279,2,3420,0,1990
3211700035,557500,3,1.75,1900,11165,1,1900,0,1959
9365700385,1.2605e+006,4,2.5,3730,16950,2,3730,0,1990
2734100736,249950,3,3,1790,2003,2,1480,310,2006
5029460180,260000,4,2.75,2250,7345,1,1320,930,1984
0632000065,1.989e+006,3,2.5,2880,13500,1,1520,1360,1950
6821101765,442900,4,1.75,1780,2788,1,890,890,1943
7525050150,475000,3,2.25,1580,12177,1,1200,380,1981
2591780180,365000,5,2.75,3260,9253,2,3260,0,2004
4027700666,780000,4,2.5,3180,9603,2,3180,0,2002
4083300620,930000,3,1.75,2460,4240,1,1230,1230,1925
2303900035,2.888e+006,5,6.25,8670,64033,2,6120,2550,1965
6300500515,350000,3,1,1020,4980,1,850,170,1941
6163900952,357500,3,1.75,1630,9403,1,1630,0,1983
5631500369,520000,4,2.5,3290,11446,2,3290,0,1992
9558010230,330000,4,2.5,1940,3784,2,1940,0,2003
9407102245,310000,3,2,1350,11150,1,1110,240,1995
1430800191,279000,3,1,1110,6060,1,1110,0,1949
7635801371,540000,4,1.5,2993,19400,2,2233,760,1921
2215450150,322000,4,2.5,2280,7200,2,2280,0,1994
7146400040,380000,5,3.25,3800,15500,1,2490,1310,1965
7635800180,320000,2,1,850,8400,1,850,0,1941
0114100297,400000,3,1.75,1560,8456,1,1560,0,1970
6145601510,412000,3,1,1000,3844,1,900,100,1928
9550200155,887200,3,1,1400,5100,1.5,1400,0,1900
8122100905,395000,4,1.75,1540,5120,1,770,770,1943
2025069025,895000,4,3,3570,10273,1.5,2630,940,1935
5595900210,195000,2,1,800,5280,1,800,0,1918
3157600325,390000,3,1,1160,3750,1.5,1160,0,1910
1432400120,165000,3,1,1010,7690,1,1010,0,1958
1432400120,255000,3,1,1010,7690,1,1010,0,1958
3811000230,589000,4,2.25,2390,57599,2,2390,0,1981
8665050770,505000,3,2.5,1610,4611,2,1610,0,1996
2976800360,335750,3,3,2400,7260,1,1440,960,1955
0871001484,719000,3,1.75,1800,5816,1,900,900,1947
9528104910,796000,4,3.25,2110,3000,2,2110,0,2001
6929602721,95000,2,1,960,7000,1,960,0,1918
7203600530,525000,3,3,2600,5238,1.5,1890,710,1989
2206500395,417000,3,1.5,1340,10224,1,1340,0,1956
9277200180,410000,3,1,1410,5000,1,980,430,1925
6672900220,984000,4,2.25,2390,12292,1,2390,0,1962
1139000072,325000,2,1.5,1180,834,3,1180,0,2009
7229900975,314950,3,1,1040,16986,1,1040,0,1968
5631500594,350000,3,2.25,1840,9929,1,1200,640,1987
6861700156,1.045e+006,4,2.25,2630,4000,2,1810,820,1909
6388930620,657000,4,2.5,2640,25038,2,2640,0,1995
2887970040,234950,2,2.5,1720,3132,2,1720,0,1999
0726049213,410000,4,1.75,2320,7500,1,1220,1100,1955
0442000210,625000,3,1.75,1840,5664,2,1270,570,1948
5525400530,706000,5,2.5,2890,15891,2,2890,0,1990
6093000065,485000,3,1.75,2200,7706,2,2200,0,1908
7519000085,685000,4,2.75,1660,5150,1.5,1280,380,1928
2525310220,242050,3,2.5,2170,9900,1,1690,480,1980
3630120970,770000,3,3.25,3310,5000,2,3310,0,2006
1232001985,557000,2,1.5,1450,3840,1,950,500,1947
3422049158,246000,3,1.75,1440,11325,1,1440,0,1966
2501600150,194000,4,2,1760,7700,1,1760,0,1962
3326059254,720000,3,2.5,3170,7187,2,3170,0,2005
2624049103,449000,2,1,1250,4576,1,1040,210,1925
1525069095,925000,4,2.5,3280,209088,2,3280,0,1994
4077800455,570000,4,3,2460,10401,1,1700,760,1947
0968000120,395000,3,2,1470,10125,1,1470,0,1962
0629000704,1e+006,4,2,1780,15648,1.5,1780,0,1918
7129300175,406000,4,1,1580,8475,1.5,1580,0,1928
2887703186,574800,3,1.5,1630,2946,1.5,1630,0,1932
3832500790,309000,4,2,2240,9240,1,1120,1120,1968
2423069170,770000,3,2.5,2430,54059,2,2430,0,1987
0225039029,525000,3,1.5,1940,5625,1,1440,500,1941
7852180650,419000,3,2.5,1970,4058,2,1970,0,2004
5422500220,479000,4,2.5,2050,6705,1,1230,820,1973
8649400790,160000,3,1,1340,18552,1.5,1340,0,1935
2473001210,333000,4,1.75,1880,9880,1,1880,0,1967
9485700175,310000,2,1,860,12160,1,860,0,1921
7694800180,666000,3,2.5,2140,2868,2,1770,370,2007
7936500109,2.23e+006,3,3,3620,28064,2,2370,1250,1977
0104560540,310000,4,2.75,2370,7320,2,2370,0,1989
8161000220,350000,3,2.5,1860,21876,2,1860,0,1992
2487200775,610000,4,3,2110,5000,1.5,1640,470,1930
3905030330,564800,3,2.25,1990,8501,2,1990,0,1991
2881700522,438000,3,2.25,1820,9150,1,1320,500,1961
7856620870,855000,3,2,3120,9400,1,1820,1300,1978
0179001046,229000,3,2.5,1190,3000,2,1190,0,2002
7562100065,260000,3,2,1170,5450,1,1170,0,1902
6891800360,609000,3,2.5,2630,10131,2,2630,0,1989
7211400760,277000,4,1,1450,6250,1,990,460,1964
0123039207,283000,4,2,2100,8160,1,1200,900,1959
3426049124,334000,2,1.75,1680,8367,1,840,840,1914
4222500410,267000,4,1.75,2000,7350,1,1100,900,1963
6716700325,385000,3,1,1030,3000,1,830,200,1924
0431500155,640000,5,1.75,2020,6565,1,1120,900,1956
0626059220,532500,4,2,2220,23750,1,2220,0,1963
1328340540,335000,4,2.5,1750,8476,1,1240,510,1983
9269200120,415000,3,2.5,1710,4920,2,1710,0,1990
2225059170,1.098e+006,6,3.25,3560,107362,1.5,2760,800,1963
8835900220,1.4425e+006,2,2.5,2720,16637,1,2160,560,1953
3192000085,180000,3,1,1010,10215,1,1010,0,1955
5104520610,335000,4,2.5,1830,4500,2,1830,0,2004
3530210180,835000,4,3,4480,42717,2,4480,0,1987
6840701225,592500,4,1.5,2080,4400,1.5,2080,0,1925
7979900210,418900,3,1.5,1470,11112,1,1470,0,1954
3343901183,340000,3,1,1600,7324,1,1600,0,1958
5249804825,545000,3,2,1340,7200,1.5,1340,0,1923
1234000704,1.378e+006,5,3.5,3680,8680,2,3680,0,2003
0646910150,183750,3,2.5,1770,3451,2,1770,0,2004
9407001320,295000,4,2,980,10640,1,980,0,1978
9527000180,625000,4,3,2530,5625,1,1470,1060,1976
7225000155,290000,4,3,2390,4500,2,2390,0,1974
3622069103,760000,4,2.5,3600,155509,2,3600,0,2004
3345100286,560000,4,2.5,3270,24750,1,1690,1580,1979
0203100910,475000,5,2.5,2300,28480,2,2300,0,1994
1257201530,620000,3,1,1710,4050,1.5,1710,0,1909
3083000365,330000,4,2,1170,4000,1,1170,0,1955
1245000865,620000,3,2.25,1990,6256,1,1390,600,1960
5104220120,320000,4,1.75,1710,10480,1.5,1710,0,1969
9828701608,525000,3,2.5,1740,2350,2,1120,620,1996
0098020410,802500,4,3.75,3320,8030,2,3320,0,2005
3416601021,569500,4,1,1960,3194,2,1960,0,1907
3052700610,850000,6,3.5,2820,5400,1,1620,1200,1958
8818400155,630000,3,1,1590,4080,1.5,1590,0,1922
8562901830,454800,4,2.25,2490,10720,1,1400,1090,1979
8651430870,177000,3,1,870,5200,1,870,0,1969
0721049207,275000,3,1.75,1860,15681,1,1860,0,1971
3463400330,460000,3,2,2930,29136,2,2240,690,1990
6003500995,729000,3,1,1580,3840,2,1580,0,1908
4139430910,935000,4,3.25,4110,15488,2,4110,0,1995
1232000915,481450,3,2,1410,4800,1,1410,0,1940
1954700365,860000,3,2,2090,4190,1.5,1490,600,1930
8074200175,274000,3,1.75,1400,8364,1,1400,0,1958
6821101762,499000,3,3.5,1690,1432,2,1360,330,2008
1774230180,696500,5,2.25,3210,61419,1.5,3210,0,1979
2051200506,390000,3,1,1190,85226,1.5,1190,0,1935
7851200040,265000,3,1,960,9748,1,960,0,1922
4027701326,470000,4,2.25,2380,17199,2,1530,850,1979
0923049110,168500,2,1,1020,7742,1,1020,0,1935
3329500730,220000,3,1.75,1290,8250,1,1290,0,1983
5476800201,295000,3,2,1830,17321,1,1100,730,1948
4139910180,1.475e+006,5,4,4770,31570,2,4770,0,1990
7278100515,1.295e+006,2,2.5,2910,19449,2,1940,970,1985
9353300220,285000,3,1,950,10723,1,950,0,1959
5253300173,294950,3,1,1160,8950,1,1160,0,1968
0098000150,1.465e+006,4,4,4930,22093,2,4930,0,2004
8608900205,565500,3,1.75,1780,5850,1,980,800,1944
2895200150,230000,3,2,1410,10625,1,1410,0,1980
0621069057,569950,4,3.5,2700,443440,1.5,2700,0,1948
8712100760,721000,2,1.5,1790,4250,1,920,870,1915
0255520180,565000,3,2.5,4040,8653,2,2900,1140,2006
1025059186,438000,3,1.75,1990,9885,1,1030,960,1978
0797000330,369900,3,1.75,2150,19127,1,1650,500,1978
6403510410,405000,4,2.5,1850,9136,2,1850,0,1997
4324210120,282000,3,2.5,1680,15711,1,1240,440,1994
6381500450,380950,2,1,1430,7819,1,1110,320,1944
7609700065,349810,3,1,960,8855,1,960,0,1958
6192410760,690000,4,2.5,2700,8810,2,2700,0,2004
0441000065,653000,2,1.5,1290,5141,1,1050,240,1947
9238510220,526500,3,2.5,1860,43170,2,1860,0,1986
0293760150,1.04e+006,4,3.5,4320,8490,2,3280,1040,2005
3331001765,335000,3,1,2130,3825,1.5,2130,0,1917
1423069077,570000,2,1.75,2870,102366,2,1770,1100,1994
8123450450,1.08e+006,5,3.5,3740,11340,2,3740,0,2013
1795910360,475000,3,2.5,2130,8022,2,2130,0,1985
7883603965,315000,4,2,1210,4250,1,1210,0,1941
7937600087,405000,6,2,2800,29985,1,1400,1400,1954
3396820150,562000,5,2.25,3040,8111,2,3040,0,1984
3654800040,295000,3,2.5,1570,6932,2,1570,0,1993
8039900360,383000,3,2.25,2090,15000,1,2090,0,1961
3876540410,242000,3,2.25,1690,7292,1,1250,440,1985
7230300610,352500,3,1.5,1470,17577,1,1470,0,1967
1180005280,239950,4,1,1460,6000,1,730,730,1941
0714000210,998000,4,2.5,3030,6820,2,2530,500,1947
3902100205,515000,3,1.75,1190,4500,1,1190,0,1922
9285800790,590000,5,1,1840,6710,1.5,1840,0,1920
1922000180,1.16e+006,4,3.75,3560,13959,2,3560,0,1972
6121800065,289000,3,1.75,1580,9750,1,1580,0,1954
4427100145,424000,3,1.5,1230,7200,1,1230,0,1953
7227800065,199000,4,2,1440,9477,1,1440,0,1943
7853220330,730000,4,3.5,4420,7902,2,3350,1070,2004
1430800258,244000,3,1,910,5250,1,910,0,1971
7454001075,240000,2,1,670,10920,1,670,0,1942
4038500210,797000,4,2.75,2650,8610,2,2650,0,1959
2310040230,350000,4,2.25,2220,6953,2,2220,0,1999
1727500230,415000,3,1.75,1640,6435,1,1190,450,1972
3874900205,378510,2,1,770,5185,1,770,0,1947
0269000085,1.195e+006,4,3.5,3960,6654,2,2850,1110,2006
7972602510,379900,2,1.5,1140,7620,1,1140,0,1925
7202340720,620000,3,2.5,2480,9041,2,2480,0,2004
1254201106,524500,3,1.5,1580,3172,1,900,680,1946
7349650330,270000,4,2.75,1990,7252,1,1270,720,1999
9211520150,236000,4,2.25,1830,9485,1,1200,630,1989
3438501020,308500,2,2,840,14564,1.5,840,0,1942
5460900120,989900,5,2.25,3320,11350,1,1660,1660,1963
7459810210,299000,4,2.25,2050,26000,2,2050,0,1977
4032500035,295000,2,1.75,1560,43748,2,1560,0,1967
8018600880,110000,2,1,800,15000,1,800,0,1927
2807100156,295950,2,1,1190,6200,1,1190,0,1948
2112700845,270000,3,1.75,1300,4127,1,650,650,1918
3022079087,712000,4,2.5,3400,247421,2,3400,0,2001
2767603577,475000,2,1.5,1170,1250,3,1170,0,2000
3955900220,410000,4,2.5,2510,5258,2,2510,0,2001
3761100276,588000,4,2.25,2510,19550,1,1810,700,1977
6979970150,420000,3,2.5,2390,3903,2,1970,420,2006
8857640410,355000,4,2.25,2200,3404,2,2200,0,2005
6052400175,446000,2,1,2550,21675,1,1610,940,1958
2525059077,765000,4,2.25,2560,12100,1,1760,800,1976
5040800120,967500,3,3.75,3250,5797,2,2370,880,1951
8682262380,381000,2,2,1340,4447,1,1340,0,2004
2521059060,490000,3,2.25,2840,107157,2,2840,0,1983
7526800040,716000,4,2.25,2480,9780,1,1900,580,1975
4104900150,605000,5,3.5,3060,8862,2,3060,0,1989
5409800120,312200,4,2.5,2910,8596,2,2910,0,2004
2423039122,327000,4,1,1900,9000,1,1290,610,1948
6143600555,229950,4,1.75,1300,21000,1,1300,0,1969
5029451010,160000,3,1.5,1480,7000,1,1000,480,1980
6649500040,255000,3,1,1250,9472,1,1250,0,1972
2922700155,530000,4,2.5,2000,4700,1.5,1220,780,1944
0422049203,239000,3,1.5,1330,6540,1,900,430,1971
5412200180,285000,3,2.25,1840,6214,1,1270,570,1983
6338000032,537000,4,2,1560,7104,1.5,1140,420,1945
8161000210,530000,3,2.5,3150,21893,2,3150,0,2006
5028600360,213675,3,2.25,1560,6013,2,1560,0,1990
1952000150,530000,5,2.5,2910,9636,1,1690,1220,1964
9510920040,780000,3,2.5,2940,15875,2,2940,0,1994
9834200411,390000,3,1,950,3621,1,950,0,1947
2960900040,450000,2,1,1200,4000,1,1070,130,1940
1112000035,420000,2,1,1000,5375,1,1000,0,1953
1982200790,550000,3,2,1490,3880,1,1490,0,1959
3361401011,110000,2,1,600,6120,1,600,0,1943
1695900150,700000,2,1.75,2320,5500,1.5,1720,600,1925
1240100065,807500,4,2.5,3190,24170,2,3190,0,2002
0421049254,179000,2,1,990,8760,1,990,0,1977
9412400220,1.6125e+006,4,2.75,5470,18200,2,3730,1740,1992
1726069060,655000,4,2.75,2890,46609,2,2890,0,1981
6150200040,472500,3,2,1790,6800,1,1240,550,1964
7300400150,299000,4,2.5,2350,6958,2,2350,0,1998
2621730220,740000,4,2.5,3430,10157,2,3430,0,2000
4122700040,860000,3,1.75,2600,15064,1,1700,900,1967
9161100730,620000,4,3,2130,6325,1,1440,690,1948
9357001010,410000,3,1.75,1660,5987,1,960,700,1982
8643000210,343000,5,3.5,2473,9282,2,2473,0,1963
9828701739,465000,2,2.75,1430,1425,2,995,435,2006
3204400040,273950,3,2.25,1570,3109,2,1570,0,2002
3342103282,825000,2,1,1240,42247,1,1240,0,1915
2420069604,255000,3,2.5,1720,6200,2,1720,0,2014
8078050040,250000,3,2,1140,11161,1,1140,0,1998
7663700150,635000,4,3.25,2690,7200,2,1720,970,1978
4167700210,240000,3,1.75,1520,9600,1,1520,0,1966
2423020180,670000,4,2.25,2040,7031,2,2040,0,2012
2824600180,713414,3,2.5,2830,6000,1,1730,1100,1954
2013801086,245000,3,1.5,1340,7391,1,1340,0,1966
4022900150,600000,4,2.5,2520,10850,1,1680,840,1968
3295710150,270000,3,2.5,1660,5550,2,1660,0,2002
9476200035,190000,2,1,880,6900,1,880,0,1943
1937300180,435000,3,2,980,5000,1,980,0,1940
4226900211,560000,4,1,1360,5814,1.5,1360,0,1900
0424069018,998000,3,3.75,3710,34412,2,2910,800,1978
6684500040,725000,3,1,940,8377,1,940,0,1952
8948500065,210000,2,1,970,8874,1,970,0,1968
1972201960,513000,3,2.25,1500,1312,3,1500,0,2007
7436200040,290000,5,2.5,2780,9652,1,1390,1390,1967
3835502815,1.26e+006,3,2.5,3110,9930,1,1640,1470,1954
8856960540,330000,3,2.25,1860,11227,2,1860,0,1995
1432400065,189000,3,1,1010,7560,1,1010,0,1958
4370700065,907500,3,2.25,2850,6281,2,1900,950,1947
1725079047,410000,3,2.25,2280,200811,1,2280,0,1978
7855000325,1.05e+006,4,3,3080,10757,2,3080,0,1961
2826049098,622100,4,2.5,2280,14290,1.5,1510,770,1942
3750603685,250000,3,1.5,2030,14400,1,1310,720,1969
1797500230,1.18e+006,4,3,2570,4000,2,1750,820,1909
3459600330,925000,3,2.75,3640,10300,1,2060,1580,1979
0546001020,554000,3,2,1760,4046,1,960,800,1931
7227502507,545000,3,2.5,2760,17377,2,2760,0,2002
0326049060,660000,3,2.5,2650,11250,2,2650,0,2005
1525059261,1.9e+006,5,4.5,5160,44315,2,5160,0,1996
7399300120,260000,4,2,1480,8625,1,1480,0,1974
7812801590,219900,3,1,860,6664,1,860,0,1944
6699930530,373500,4,2.5,2610,4978,2,2610,0,2004
1523069151,380000,2,1,1470,81021,1,1470,0,1949
7525950180,1.06e+006,4,2.5,4570,16015,2,4570,0,1990
3623500408,2.6e+006,3,3,3410,16015,2,2220,1190,1973
7312200120,450000,3,2.25,1760,10013,2,1760,0,1983
4123810210,379950,3,1.75,2040,12065,1,2040,0,1987
3902600150,834800,3,3.5,3470,4171,3,3470,0,2008
9126101201,365000,2,1,680,4800,1,680,0,1917
2423029009,465000,2,2,1494,19271,2,1494,0,1943
3300701285,452000,3,1.5,1250,4000,1,1250,0,1955
2391601445,840000,3,3,3570,6250,2,2710,860,1985
7625701175,465000,4,2,2000,6250,1.5,1480,520,1930
1843130360,295000,3,2.5,2030,4867,2,2030,0,2003
6150700264,396000,3,1,1390,6160,1,1390,0,1949
3226049080,397000,2,1,1030,12350,1.5,1030,0,1942
7889602020,240000,3,1,1280,9000,1.5,1280,0,1954
3613600150,300523,3,2.5,2370,6840,2,2370,0,1987
3599600276,215500,3,2,1380,9000,2,1380,0,1946
2193320210,552500,5,3,2320,7229,1,1370,950,1986
9117100040,375000,5,1.5,2050,9360,1,1520,530,1968
0522039106,160000,3,1,1210,103237,1,1210,0,1918
2424059018,1.07e+006,4,2.5,3270,35445,2,3270,0,1989
1959700540,952000,3,2.5,2450,4400,2,1800,650,1922
2767900355,523460,5,1.75,1890,5000,1.5,1090,800,1906
1310820150,305950,4,2.5,2007,4968,2,2007,0,2009
6802200230,220000,3,2.5,1430,9044,2,1430,0,1991
3421049044,289000,2,1.75,2056,52333,1,1048,1008,1980
4036400040,648000,5,2.5,2210,10772,1,1430,780,1964
1193000450,825000,5,1.75,2330,6000,1.5,2080,250,1937
3819800580,400000,4,2,2070,10800,2,2070,0,1982
6873000120,420000,2,2.5,1480,1369,3,1480,0,2009
9830200230,389000,2,1.75,1160,4848,2,1160,0,1949
2301400276,865000,4,2.5,2520,4950,2,2520,0,1906
5153200150,345000,2,1,1770,16660,1,1220,550,1957
1465400120,700000,3,2.5,3110,123710,2,2430,680,1995
8121200620,550000,3,2.5,1680,10455,2,1680,0,1982
0324000530,201500,3,1,1320,5000,1.5,1320,0,1912
0324000530,459000,3,1,1320,5000,1.5,1320,0,1912
1328320760,327000,3,2.5,1810,7350,1,1310,500,1984
3626039268,540000,1,1,1140,6700,1.5,1140,0,1920
3585900665,805000,5,2.5,4600,19831,1,2300,2300,1956
7625701830,521000,3,2,1840,6000,1,1840,0,1908
3524049042,375000,3,1.5,2000,7294,1,1520,480,1965
9211500150,235000,3,1.75,1480,6592,1,1080,400,1978
7760400880,240000,4,2.5,2040,11841,2,2040,0,1994
0686450330,575000,4,2.25,2060,12155,1,2060,0,1968
2617900035,1.52e+006,6,3.5,3720,11690,2,3720,0,2003
7936800150,394500,4,2.5,3002,6042,2,3002,0,2004
8651441750,174950,3,1,1060,5200,1,1060,0,1970
3664500133,383000,4,2,1830,21183,1,1060,770,1966
1823069213,249950,3,2,1550,15040,1,1550,0,1958
7525211520,431000,3,2.5,1690,2752,2,1690,0,1979
4034900065,459900,3,1.75,2580,11000,1,1290,1290,1951
2558690150,475000,5,2.5,2510,8050,1,1490,1020,1977
5016001325,605000,3,2.25,1290,2500,2,1290,0,1987
1311800220,234950,4,2,1450,7560,1,1450,0,1967
4128000020,419000,4,2.5,2690,7947,2,2690,0,1993
1125059071,910000,4,3.25,3340,10890,1.5,2240,1100,1963
3274850130,392000,4,2.5,2600,8921,2,2600,0,1991
1925069099,915000,3,2.5,3140,9808,2,2500,640,2001
3395050050,630000,3,3.25,3800,13995,2,3800,0,1983
4058800500,416100,4,1.75,2320,5490,1,1160,1160,1956
1311600020,285000,4,2.5,2360,7350,1,1440,920,1965
8679400130,353000,4,1.5,1100,9600,1,1100,0,1960
9485760050,297950,3,2,1390,5127,1,1390,0,1990
4055700920,750000,2,2,2180,21392,2,2180,0,1934
8673400177,525000,3,3,1730,1074,3.5,1730,0,2006
3500100089,495000,5,1.75,2760,18112,1,1510,1250,1968
8730600050,710000,3,1.75,2430,11448,1,1620,810,1949
3755100005,310000,3,2,2010,12950,1,2010,0,1953
8651442880,205000,5,1.75,1730,5200,1,1050,680,1978
1720069075,530000,3,3,2450,211266,1.5,2450,0,2004
4309700190,725000,4,2.5,3300,28433,2,3300,0,1998
3972300169,195000,2,1,720,9520,1,720,0,1947
6817810190,401000,3,2,1240,11172,1,1000,240,1984
7855400630,1.03e+006,5,2.5,3050,8200,1,1650,1400,1962
1163400020,251000,3,1.5,1590,21600,1.5,1590,0,1971
7214400095,667500,3,2,2040,4841,1,1020,1020,1949
6799300130,300000,4,2.5,1840,5550,2,1840,0,2004
4376800010,610000,4,2.25,1960,9021,2,1960,0,1973
2125059163,1.04203e+006,4,5,4110,43560,2,4110,0,1978
1770000460,430000,3,2.25,1830,19965,1,1400,430,1976
1125079088,455000,2,1,1330,92782,1,1330,0,1950
1842300050,600000,5,2,2190,9072,1,1110,1080,1965
9828702156,638000,3,3.25,1720,1587,2.5,1410,310,2004
7625702155,561000,3,1.75,1710,5000,1,1360,350,1918
0585000095,625000,3,2.5,2180,5000,1,1240,940,1977
3903200050,263950,3,1.75,1700,11613,1,1180,520,1977
8563080020,740000,3,2.5,2960,9350,2,2960,0,1978
5379805475,234999,3,1,1330,8912,1,1330,0,1948
9558050780,380000,4,2.5,1940,3200,2,1940,0,2004
3782400190,329500,3,2.25,1500,9656,1,1170,330,1989
1423069063,464950,4,2.5,2230,64438,1,1230,1000,1978
2926049504,500000,3,2.25,1700,9008,1,1340,360,1985
0126039252,415000,4,1.5,1840,11367,1.5,1840,0,1950
2622029073,437500,3,2.25,2100,205603,2,2100,0,1983
9187200345,599000,7,2.5,2580,5750,1,1880,700,1901
2621760480,367000,4,2.5,2350,8182,2,2350,0,1997
7986401205,530000,2,1,760,3000,1,760,0,1922
4447300137,989000,5,3.5,3280,4000,2,2440,840,2003
2147300050,462600,3,2,1320,4000,1,1020,300,1940
4458300190,875000,3,2.5,1690,10592,1,1690,0,1973
3751606785,335000,3,2.25,2060,47318,1,1600,460,1976
4287400005,393000,4,2,1450,5456,1,1450,0,1951
6613000715,1.34e+006,4,3,2760,4905,2,1840,920,1938
7702010050,590000,3,2.5,2830,5788,2,2830,0,2001
2770602360,671000,4,2.75,1890,1475,2,1200,690,2015
9551201155,925000,3,3.25,2610,4500,1.5,1660,950,1909
1823049242,245000,3,2.25,1900,7250,1,1250,650,1967
1513800170,392500,3,1,930,6572,1,930,0,1952
4027700396,505000,4,2,2730,12000,1,1410,1320,1998
7203210170,702000,4,2.5,2650,6240,2,2650,0,2013
3013300895,337000,2,1,1010,4000,1,1010,0,1947
5608010050,920000,4,2.5,3550,10233,2,3550,0,1996
6370000005,495500,3,1.75,2130,6360,1,1720,410,1959
1922059102,245000,2,1.75,1840,7230,1,1570,270,1938
6738700005,395000,2,1,1320,1824,1.5,1320,0,1909
1138020020,335000,3,1,990,6315,1,990,0,1970
5437820250,187000,2,1.75,1020,10346,1,1020,0,1983
7923700020,450000,4,2,1570,7320,1,1570,0,1960
0293600080,280000,4,2.25,1930,7207,1,1360,570,1988
3627800050,1.375e+006,5,4,3760,22763,1,1910,1850,1969
4047200950,265000,2,1,1000,31505,1,1000,0,1960
5458800425,795000,3,1.75,1930,9600,1,1930,0,1958
2887700826,510000,3,1.5,2240,3800,2,1370,870,1929
7856700920,699900,4,2.5,2190,11500,1,1430,760,1972
0627300190,839000,4,2.75,2400,12469,1,1760,640,1958
5634500182,396000,4,1.75,1970,12409,1,1220,750,1968
2472950170,365000,3,2.25,2860,8458,2,2860,0,1983
9557300190,440000,3,2.25,1900,7225,1,1220,680,1970
2314300170,405000,4,2.5,2090,6667,2,2090,0,1997
7547300050,295000,3,1.5,850,2500,1,850,0,1986
7985400089,275000,4,2.5,1840,1562,2,1400,440,2004
0322059049,295000,2,1,820,288367,1,820,0,1930
2344300170,1.5e+006,5,3.5,4370,12240,2,3270,1100,1990
0011501330,795000,3,3.5,3190,10223,2,2560,630,1994
7300200290,650000,5,3.5,3480,36615,2,2490,990,1983
4331000595,260000,3,1,1690,13184,1,1690,0,1959
7853340660,382000,2,2.5,1650,2710,2,1650,0,2008
7525570020,790100,4,2.5,2590,9341,2,2590,0,1985
6306100190,220000,4,2.5,2160,8005,2,2160,0,1993
1424059142,799000,4,3.5,3500,8547,2,2500,1000,1994
5700003810,1.48e+006,4,2.25,3920,7200,2,3120,800,1928
2595650170,367300,4,2.75,2190,14937,2,2190,0,1993
9530100225,805000,4,2,1890,4500,1.5,1490,400,1907
3856901760,730000,2,1,1860,3400,1,1010,850,1920
1387301350,402000,3,2,1720,7704,1,1160,560,1969
7974200822,750000,4,2.75,2600,4674,1,1560,1040,1976
8039900130,458000,3,1.5,1570,12196,1,1570,0,1972
4139460290,898000,3,2.5,3530,9753,2,3530,0,1997
8078520280,308000,4,2.5,1960,5642,2,1960,0,1998
8691510290,385000,3,2.5,2230,8296,2,2230,0,2004
4217400680,1.02e+006,4,3,2720,4800,1.5,1790,930,1928
1336800670,1.425e+006,5,3,2840,6240,2,2440,400,1905
1545801850,240000,3,1.75,1260,7362,1,1260,0,1984
6386600170,217000,3,1.5,1860,8505,1,1860,0,1967
1373800170,972000,4,1.75,2010,6300,1,1610,400,1937
1394300005,361280,2,1,820,6400,1,820,0,1944
7011201087,385000,3,1.75,1220,1450,1,620,600,1905
1623069071,475000,3,2.5,2220,60984,2,2220,0,1987
1982200480,724950,4,2.5,2860,3638,1.5,1720,1140,1924
8089510170,935000,5,4.5,4230,9701,2,4230,0,1999
5560000480,169950,3,1,840,8470,1,840,0,1961
6308000010,585000,3,2.5,2290,5089,2,2290,0,2001
6308000010,585000,3,2.5,2290,5089,2,2290,0,2001
4136960010,480000,5,3.5,3480,12821,2,2890,590,2004
8665900168,635000,4,2.5,4260,36360,1.5,4100,160,1935
8691510170,368750,3,2.5,2230,5717,2,2230,0,2004
9187200095,432500,6,2,3080,5500,2,3080,0,1900
4221260050,589000,3,2.5,2250,4337,2,2250,0,2004
8562740480,840000,4,3.25,3160,6327,2,2280,880,2004
6806100250,316500,3,2.5,1770,3873,2,1770,0,2005
7853300280,536000,4,2.5,2880,8833,2,2880,0,2006
6446200190,563750,4,2.75,2690,25000,1,1750,940,1978
4222310010,152500,4,1,1730,7350,1.5,1730,0,1970
4222310010,267950,4,1,1730,7350,1.5,1730,0,1970
4054550010,1.64e+006,5,4,4780,118047,2,4780,0,1994
1440700190,269950,4,2.5,2540,8400,2,2540,0,1977
5569620050,731688,4,3,2630,5772,2,2630,0,2006
1840200080,240000,3,1.5,1890,9000,1,1190,700,1959
9268200585,555950,2,1,1220,5040,1,1220,0,1961
7454000585,289000,2,1,710,6300,1,710,0,1942
7504021310,525000,3,2.5,2970,11985,1,1770,1200,1995
7504021310,745000,3,2.5,2970,11985,1,1770,1200,1995
8024201795,397000,2,1,1000,7664,1,1000,0,1939
8638500170,233000,3,1,1980,8505,1,1030,950,1965
5437400630,625000,4,2.25,1920,8259,2,1920,0,1979
9264000010,535000,3,2,2740,23505,2,2740,0,1988
3832600080,270000,3,2.25,1740,7345,1,1380,360,1973
9477001350,360000,3,1.75,1300,7770,1,1300,0,1967
0809001060,1.105e+006,4,1.5,2740,4000,2,1930,810,1905
2771604120,970000,4,1.75,4060,4000,2,2890,1170,1953
9541800190,915000,5,2.5,3490,18850,1,1840,1650,1958
4038400130,412000,4,1.75,1430,10500,1,1130,300,1960
1253200290,265000,4,1.75,1860,9112,1,1110,750,1963
2558650130,426000,4,2.25,2120,7700,1,1490,630,1976
8732190170,266000,4,2.25,1860,12693,1,1140,720,1978
1703400585,325000,3,2,2330,4950,1.5,1430,900,1900
1250202115,615000,3,1.75,1670,5100,1,990,680,1954
9264911150,310000,3,1.75,2130,7140,1,1580,550,1979
7696300080,340000,4,1.75,1900,7313,1,1900,0,1973
1931300010,562500,2,1,1170,2800,1.5,1170,0,1905
2771602425,447000,2,1,980,1600,2,980,0,2010
2210500010,2.45e+006,7,4.25,4670,23115,2,4670,0,1992
1253200170,250000,4,1.5,2500,6300,1,1500,1000,1961
6646200420,633000,4,2.5,2020,8044,2,2020,0,1990
8822901024,310000,3,2,1290,886,3,1290,0,2004
1323089056,439000,2,1.75,1620,113862,1.5,1620,0,1995
3629950010,470000,3,3.25,1710,2381,2,1360,350,2003
7889100020,270000,3,2.5,1720,8550,1,1720,0,1968
7212680020,299500,3,1.75,1820,8813,2,1820,0,1994
2222049108,227000,3,1,1130,10018,1,1130,0,1954
7129303070,735000,4,2.75,3040,2415,2,3040,0,1966
6744700424,537000,3,3,2410,7479,2,2410,0,1942
1727000680,699000,4,2.5,2440,14470,1,1660,780,1970
3226049134,330000,2,1,800,4533,1,600,200,1929
1760600009,229000,3,1,1030,7800,1,1030,0,1954
3352400351,200000,3,1,1480,5600,1,940,540,1947
8563000250,522500,3,1.75,1710,9707,1,1710,0,1966
1370800680,1.295e+006,3,2.75,3450,5350,1.5,2590,860,1925
2726049034,2e+006,3,3.25,2610,16387,2,2610,0,2006
3623059027,200000,2,0.75,780,55764,1,780,0,1945
3205500020,352000,3,1.75,1260,7200,1,1260,0,1971
8924100305,855000,4,3,2590,6250,2,2240,350,1964
7524300020,267000,3,2.5,1580,12250,2,1580,0,1993
2436200715,484000,2,1.75,1660,6000,1,1160,500,1942
5469501850,402000,4,2.75,2950,15540,1,2120,830,1974
9187200275,905000,4,2.25,2240,5000,2,1770,470,1900
0274000020,274000,4,1.75,1940,7500,1,1720,220,1966
6151800225,475000,3,1.75,1850,26445,1,1850,0,1962
8924600020,1.535e+006,4,4.5,5770,10050,1,3160,2610,1949
4003000285,628000,4,2,2280,6010,1,1140,1140,1900
0290000095,675000,6,1.75,2740,6360,1,1370,1370,1953
1565930130,429900,4,3.25,3760,4675,2,2740,1020,2007
6123000225,260000,3,1.5,1580,8184,1,1140,440,1954
4385700285,690000,3,1.75,1600,4400,1,1030,570,1941
2469000010,1.081e+006,4,2.25,2100,12172,1,2100,0,1961
5205000020,360000,4,2.5,2610,7333,2,2610,0,1988
0461002890,499000,3,1.75,1840,5000,1,920,920,1910
1823059030,159000,3,1,1320,6534,1,1320,0,1952
8848400020,430000,3,1.75,1540,8100,1,940,600,1947
4122500095,1.05e+006,5,2.75,2520,18625,1,1660,860,1959
2597300020,725000,5,2.5,3780,20000,1,1890,1890,1978
2788400020,150000,3,1,1200,9527,1,1200,0,1959
7856610130,840000,4,2.25,2720,8712,2,2720,0,1976
3303860460,499000,4,2.5,3100,5700,2,3100,0,2011
2112700920,285000,3,1.75,1630,4000,1,1100,530,1968
6880210020,340000,4,2.5,1910,7201,1,1210,700,1987
6139100101,405100,4,2,1580,7300,1,1580,0,1955
7202330920,464000,3,2.5,1690,4898,2,1690,0,2003
8146300020,723000,4,2.25,1960,8680,1,1290,670,1959
7418000130,430000,8,3.25,4300,10441,2,2800,1500,1979
9276200635,645000,3,1.75,1840,4255,1,940,900,1907
0251610020,1.58e+006,4,2.75,3480,19991,2,2630,850,1979
8825900020,925000,5,3,2710,4200,2,1890,820,1919
3856903495,759000,4,1.75,2100,4750,1,1340,760,1975
6382500020,690000,4,2,1760,7800,1,1760,0,1954
0522059352,358800,4,2.5,2155,8140,2,2155,0,1996
1778500595,683000,5,1.5,1720,4000,1.5,1520,200,1925
4083300595,650000,3,1,1430,4240,1.5,1430,0,1924
2100200020,288000,5,2.75,2790,4807,1.5,2140,650,1949
2597500840,209950,3,1.5,1180,7300,1,1180,0,1968
7935000595,939000,3,3.5,2450,9248,2,1960,490,1933
7857003318,320000,3,1,1330,5850,1,930,400,1954
9211520020,283748,3,2.25,1940,9560,2,1940,0,1989
1460000080,370000,3,2.25,1600,7620,1,1280,320,1987
3444120130,399950,4,2.75,3210,41689,1,1610,1600,1989
0908000010,360000,5,2.5,2880,6902,1,1680,1200,1976
3123800080,365000,2,1.5,1160,8060,1,1160,0,1950
8641500345,396900,3,2,1360,3120,2,1360,0,1989
3717000250,321000,3,2.5,2014,4500,2,2014,0,2005
7697860130,245000,3,2,1440,7008,1,1440,0,1985
9169100130,502000,2,1,1570,4704,1.5,1570,0,1931
2944500470,257000,4,2.75,2330,7642,1,1800,530,1990
7424110130,423000,4,1.75,1880,7303,1,1010,870,1976
4037000635,485000,4,2.25,1850,9911,1,1850,0,1957
2141500020,500000,4,2.5,2230,8560,2,2230,0,2002
0952000725,442000,2,1,990,4313,1.5,990,0,1917
9550204620,475000,3,1.75,1720,3825,1.5,1720,0,1925
6891800250,625000,4,2.25,3230,9935,2,3230,0,1986
7812801850,194000,3,1,1180,6050,1,820,360,1944
7504180170,410000,3,2.25,1450,19206,2,1450,0,1989
0686800080,1.0345e+006,4,2.5,2370,10858,2,2370,0,2003
7853300290,490000,4,2.5,2570,6157,2,2570,0,2006
7905380380,348500,4,1.75,1870,7575,1,1480,390,1972
1972202320,380000,3,1,1220,3000,1.5,1220,0,1901
1710400007,660000,3,2,1770,2150,3,1770,0,1999
2985800225,525000,3,1,1500,6800,1,1500,0,1943
1721059069,235000,3,2,1110,8724,1,1110,0,1990
7852160170,1.21e+006,4,3.75,4980,18069,2,4980,0,2006
0626049102,397950,4,1.75,2360,8116,1,1180,1180,1916
7349660050,268000,3,1.75,1600,7711,1,1600,0,1999
1231000660,525000,3,1,1450,4000,1,950,500,1948
9558900010,549950,3,2.5,2680,5860,2,2680,0,2001
3897100170,370000,3,1.75,1150,6600,1.5,1150,0,1970
1150700170,299000,4,2.25,1870,6693,2,1870,0,1996
2769600305,715000,6,2.75,3400,5000,2,2860,540,1977
3876001330,430000,4,1.5,1810,7200,1,1810,0,1966
0984220290,345000,3,1.75,1860,7191,1,1260,600,1975
3616600250,1.6e+006,3,3.25,3790,19000,2,3790,0,1985
1529200480,534640,3,2.5,2130,3500,1,1210,920,1994
2533300680,1.225e+006,3,2.5,2860,4500,2,1980,880,1915
6752600130,351000,4,2.5,2370,7274,2,2370,0,1997
9332800020,745000,4,2.25,2290,10409,2,2290,0,1972
1121000095,320000,2,1,1120,5329,1,750,370,1929
6751500285,555700,3,2,1810,12420,1,1810,0,1957
1310370020,690000,4,2.5,3220,35400,2,3220,0,1991
4019300680,449000,3,1.75,1660,9697,1,1660,0,1952
4408100095,308500,2,1,850,6174,1,850,0,1950
8944460020,340000,4,2.5,2665,5868,2,2665,0,2006
8824900020,937750,4,2.75,2580,3560,1.5,1710,870,1917
7135520780,725126,4,2.5,3200,12369,2,3200,0,1998
0179001101,135000,3,1,840,3000,1,840,0,1943
4177100005,635000,4,2.5,2970,7961,1,2020,950,1969
0910000104,245500,2,1,790,7500,1,790,0,1950
3353400840,230000,6,1.5,2140,36509,1.5,2140,0,1903
8964800050,1.77e+006,3,2.5,2580,14603,1,2580,0,1951
0726049217,425000,5,2.5,2180,7875,1,1200,980,1955
2926049376,220000,2,1,1060,10423,1.5,1060,0,1965
5589300715,370000,3,2,1860,9100,1.5,1860,0,1939
7229900285,390000,3,2,1840,16815,1,960,880,1972
2722059215,239000,3,1.75,1340,16480,1,1340,0,1968
2473372040,345000,4,2.25,2320,7350,2,2320,0,1973
3546000630,289000,3,2.5,2110,8304,1,2110,0,1985
7888400500,285000,5,1.5,1840,8050,1.5,1840,0,1962
1823049182,147400,3,2,1080,9225,1,1080,0,1955
8712100020,600000,2,1,1290,4636,1,1290,0,1924
7961500010,245000,3,2.25,2210,10794,1,1540,670,1967
7961500010,520000,3,2.25,2210,10794,1,1540,670,1967
2424400130,352500,3,2.25,1410,14110,1,1170,240,1987
9406510130,448000,5,3.5,3740,24684,2,2760,980,1998
3832700250,270000,4,2.75,2440,7150,1,1200,1240,1963
0809000525,872500,3,2.5,2040,6000,1,1840,200,1951
1370800225,2.1525e+006,4,3.25,3840,6214,1.5,2590,1250,1939
3388100020,225000,3,1.5,1660,7221,1,980,680,1962
2770604615,735000,4,2,1640,6000,1.5,1640,0,1911
3754700420,375000,3,1,1310,8400,1,1310,0,1972
6669020290,169000,3,1.75,1720,9775,1,1720,0,1978
6669020290,279950,3,1.75,1720,9775,1,1720,0,1978
5493110020,1.95e+006,4,2.75,4020,18745,2,2830,1190,1989
6064800470,310000,3,2.25,1960,2345,2,1750,210,2003
9304400010,975000,4,2.5,3240,35083,2,3240,0,1978
5566100170,650000,10,2,3610,11914,2,3010,600,1958
3025049028,930000,2,1.5,1800,4500,1,1000,800,1942
2848700095,412000,4,1.5,1960,5000,1,980,980,1912
2172000894,225000,3,1,1250,10200,1,1250,0,1965
3034200660,507000,3,2.5,2120,7201,2,2120,0,2003
3304700130,1.755e+006,4,4,3860,67953,2,3860,0,1927
6661200080,230000,3,2.5,1340,3011,2,1340,0,1995
8835800480,316000,1,2,1780,188465,2,1780,0,2001
7853430660,616200,5,3.25,3920,4832,2,3030,890,2014
7511200020,509900,3,1.75,1690,53578,1,1690,0,1984
2597670080,370000,4,2.5,2570,7753,2,2570,0,1987
2423010130,619100,3,1.75,1870,7030,1,1870,0,1977
2927600415,805000,3,2.25,2860,11250,1,2290,570,1956
2770604665,612125,2,1.5,1670,6000,1,1090,580,1950
0425049181,350000,2,1.5,1070,937,3,1070,0,2003
3223059217,225000,2,1,940,15000,1,940,0,1960
6669240130,335000,3,2.5,2588,5701,2,2588,0,2008
3303960080,972800,5,3.25,3500,10457,2,3500,0,2001
2413910190,500000,3,1.75,1690,48096,1,1690,0,1973
9185700285,2.2e+006,4,3.75,3790,7200,2,2530,1260,1931
4040800050,415000,3,1.5,1090,8400,1,1090,0,1966
3438500742,399000,3,3,2240,10479,2,1710,530,1950
2326300010,376000,2,1,1150,4000,1,1150,0,1947
4322200050,340000,3,2,1870,3378,1,1120,750,1913
6403510130,490000,5,2.75,2990,7200,2,2990,0,1997
4307340130,374000,4,2.5,2580,6260,2,2580,0,2004
7237600130,852000,4,1,2220,3588,1.5,1470,750,1927
5706300020,473000,3,2.25,1620,12309,2,1620,0,1987
6446200050,540000,3,1.75,2590,25992,1,1970,620,1968
7744500020,431000,2,2,1390,12530,1,970,420,1959
3971700635,435000,4,3,2270,7245,1,1410,860,1979
3625059109,1.051e+006,4,3,2920,33976,1,1460,1460,1964
6379500216,450000,3,2.75,1250,892,2,1040,210,2010
1123049027,157500,3,1,1100,27008,1,960,140,1935
1938400010,244000,3,1.75,1500,7475,1,1500,0,1976
3204900010,550000,3,2.5,2800,10603,2,2800,0,2001
6979900010,975000,4,2.5,3420,183387,2,3420,0,2000
1422069069,426500,4,2.75,2100,88426,1,2100,0,1990
9834200305,350000,3,1,1790,3876,1.5,1090,700,1904
9834200305,615000,3,1,1790,3876,1.5,1090,700,1904
3396820010,542000,3,2.25,2220,12056,2,2220,0,1985
1929300415,710000,4,1.75,2000,6000,1,1000,1000,1956
8001600130,289950,3,2.5,1770,9450,1,1770,0,1988
3835500585,1.9e+006,4,2.75,4280,12668,2,3900,380,1947
7518505910,528000,2,1,1260,5100,1.5,1120,140,1925
7518505610,471000,2,1,840,5100,1,840,0,1949
5412100920,250000,4,2.75,1830,6643,2,1830,0,2001
2329700440,155000,3,1.5,970,8400,1,970,0,1966
0923000413,515000,4,1.5,1740,8160,1.5,1400,340,1946
9406521150,336600,3,2.25,1654,8464,2,1654,0,1995
0810000080,915000,3,2.25,2390,2750,2,1580,810,1925
3762900130,350000,2,1.75,1080,7242,2,1080,0,1984
1651800010,1.3e+006,4,1.75,2610,21600,1,2610,0,1966
3876500290,175000,3,1,1070,6164,1,1070,0,1967
4443800545,545000,2,2,1430,3880,1,1430,0,1949
9218400050,475000,4,3,2400,5400,2,1600,800,1965
1023059108,390000,2,1,670,11505,1,670,0,2003
2787250190,645000,4,2.5,2860,14000,2,2860,0,1995
4019301205,410000,3,1.5,2270,8187,1,1420,850,1954
2607760190,480000,4,2.5,2180,9861,2,2180,0,1997
1250203135,725000,3,1.75,1860,6000,2,1860,0,1959
1424069069,1.15e+006,6,4.5,6040,219542,2,4100,1940,1996
7304301300,300000,2,1,1010,11919,1,1010,0,1947
8835400290,752000,4,2.5,2570,8178,1,1710,860,1961
3630030440,585000,4,2.5,1950,3720,2,1950,0,2004
1088000050,678700,3,1.75,1970,10548,1,1300,670,1973
7504010480,603000,4,2.25,2110,11155,2,2110,0,1975
8644500010,715000,3,1.75,1650,7276,1.5,1150,500,1928
1326059142,1.395e+006,4,3,3520,128502,2,3520,0,1981
3754501205,1.085e+006,3,2.5,2840,7500,2,2840,0,1997
7625701900,467500,2,1.75,1490,4800,1,750,740,1918
1926049398,359000,3,2.25,1650,7218,1,1230,420,1985
6372000190,745000,4,2,1960,4520,1,960,1000,1922
3622059088,450000,3,2.25,2450,42180,1,2450,0,1978
0809003105,935000,3,2,1720,2000,1.5,1060,660,1910
8956000250,615000,3,2.5,1980,3128,2,1890,90,2009
1241500351,1.031e+006,3,2.5,4110,35741,2,4110,0,1976
7457400250,283500,4,2.5,1990,5577,2,1990,0,1999
6154900130,340000,2,1,860,7102,1,860,0,1947
1853500130,370000,4,2.5,2320,9264,2,2320,0,1994
1854750010,1.15e+006,3,2.5,4190,9624,2,4190,0,1999
9320500080,265000,4,1,1940,9533,1,1080,860,1962
7228500415,480000,4,2.25,2520,2370,2,1690,830,1908
3142600130,667500,3,2,1880,3800,1,1030,850,1927
0629000605,1.398e+006,3,2.5,2910,10044,2,2910,0,1989
5536100005,2.3e+006,7,4.75,5310,8816,2,3650,1660,2013
3990000050,465000,3,2.25,2670,7500,1,1640,1030,1966
1320069249,192500,1,1,470,63737,1,470,0,1924
9357000635,345000,3,1,1060,5600,1,760,300,1943
2207200635,439800,3,1.5,1120,6900,1,1120,0,1956
3798000130,468000,4,1.75,2250,8580,1,1330,920,1958
2680700010,775000,4,2.5,2070,8473,1,1250,820,1976
3066200440,684680,4,2.25,2370,9360,2,2370,0,1979
3293400020,910000,4,3.5,3570,27699,2,3570,0,1990
2425049063,3.6409e+006,4,3.25,4830,22257,2,4830,0,1990
0114101426,375000,3,1.75,1160,22470,1,1160,0,1976
0100500020,250000,3,2.5,1610,6600,2,1610,0,1994
1732800780,3.065e+006,5,3,4150,7500,2.5,3510,640,1909
7955050250,442500,4,2.25,1840,7575,1,1390,450,1973
3521059134,900000,3,3.5,4080,217697,1.5,4080,0,2000
6908200006,699000,3,2,1820,4080,2,1820,0,1937
4012800010,360000,4,2,2680,18768,1,2680,0,1965
0629800660,1.675e+006,4,4.75,4790,25412,2,4790,0,1999
0425059024,675000,5,2,2420,21000,1.5,2420,0,1966
8911000425,345000,2,1,1130,8081,1,1130,0,1921
3438502066,229000,4,1,1320,5000,1.5,1320,0,1928
3022039069,300000,3,1,1290,12415,1.5,1290,0,1908
1862400471,392500,3,3.25,1600,1289,3,1600,0,1998
7518505851,552000,3,1,1120,2300,1,820,300,1912
5101408678,457000,2,1.75,2060,7192,1,1420,640,1940
3296900130,518000,4,2.5,2830,13760,2,2830,0,1993
9513900050,237000,3,2,1210,6634,1,1210,0,1985
2624089022,399950,3,2.25,1560,11997,1,1260,300,1988
4024100670,605000,3,2.25,2260,17114,2,2260,0,1990
1862910050,295000,4,2.5,1850,8198,2,1850,0,1993
8651720420,513000,4,2.5,1930,8040,1,1380,550,1978
2619920170,772500,4,2.5,3230,4290,2,3230,0,2004
2619920170,765000,4,2.5,3230,4290,2,3230,0,2004
0225039069,696950,4,2.75,2450,5376,1.5,1550,900,1920
3878900525,329000,3,1,1200,5650,1.5,1200,0,1928
7137970130,339999,3,2.5,2360,8093,2,2360,0,1995
6632300122,364500,3,1,1060,9506,1,1060,0,1959
2770602135,607500,5,1.75,2220,6000,1.5,1420,800,1923
3584800010,550000,3,1,880,6664,1,880,0,1961
8950500250,479900,4,2,2510,9750,1,1630,880,1960
7011201306,1.12028e+006,4,4,2530,1774,3,2100,430,2013
4438400020,192000,2,1,700,10540,1,700,0,1953
8651440250,250000,3,2,1500,5200,1,1060,440,1977
0203900920,340000,3,2,1130,9879,2,1130,0,1996
2458400345,340000,3,2,1420,6060,1,830,590,1942
6664000130,635250,3,2.25,2210,22040,1,1510,700,1976
2685600005,324800,2,1,1170,5043,1,880,290,1949
0040000362,78000,2,1,780,16344,1,780,0,1942
3582700130,400000,4,1.75,1770,12875,1,1770,0,1988
3013300980,640500,3,1,1070,4505,1,1070,0,1919
2597000130,570000,3,2,1930,10929,1,1260,670,1964
6169900545,1.33e+006,3,1.5,1940,2885,1.5,1940,0,1900
1328340630,330490,3,2.75,1440,7350,1,1040,400,1980
0705730280,325000,3,2.5,1740,5267,2,1740,0,1999
0705730280,335000,3,2.5,1740,5267,2,1740,0,1999
5379805910,314000,5,2.75,2210,13500,1,1460,750,1963
2887700091,625000,4,2,2190,3622,1.5,1990,200,1925
7732410420,809000,3,2.5,2590,7720,2,2590,0,1988
7806500290,535000,3,2.5,2790,19485,2,2790,0,1990
1565600130,275000,5,1.75,2180,9178,1,1140,1040,1963
2473100280,358000,4,2.75,2580,11900,1,1620,960,1967
3826000460,297975,3,2.25,2820,8100,1,1720,1100,1947
1823069088,492000,2,1.75,1300,22239,1,1300,0,1945
1901600095,210000,2,1,720,8040,1,720,0,1943
9285800020,622500,3,2.5,2260,4550,1.5,1380,880,1928
3383900048,550000,3,2.5,1550,1092,3,1390,160,2004
1423700680,190000,3,1.75,1390,7700,1,1390,0,1965
9264930980,340000,4,2.5,2380,9362,2,2380,0,2000
3825311190,678000,3,2.5,2640,5964,2,2640,0,2003
9122500080,275000,5,2,2260,11970,1,1250,1010,1962
1189000130,493000,3,2.75,1720,6720,1,1270,450,1947
3347400525,147000,3,1,1070,14000,1,1070,0,1960
8091411100,334000,3,2.25,2000,7225,2,2000,0,1985
4384000020,605000,4,2.5,2800,10786,1,1420,1380,1970
0321059132,365000,3,1.75,1450,61419,1,1450,0,1976
1016000080,345000,3,1,1620,10610,1,1620,0,1958
3585900305,999000,3,2.5,2710,23292,1,2080,630,1956
2922701305,470000,2,1.75,1520,4220,1,840,680,1910
8123500050,599000,5,2.75,2730,22572,1,2080,650,1968
5547500050,255000,3,2.25,1740,10378,1,1740,0,1977
5469700020,295000,4,1.75,1800,28650,1,1800,0,1975
9358400080,550000,4,3.5,4150,16197,2,4150,0,2006
1257200050,1.305e+006,5,3.5,3270,4080,2,2180,1090,2011
1180005220,225000,2,1,1070,6000,1,1070,0,1922
9536600010,520000,4,0.75,1960,8277,1,1320,640,1923
6140100022,345000,3,3.25,1600,1882,2,1360,240,2000
6140100095,475000,4,1.75,1650,7775,1,1150,500,1950
4037800020,497500,5,1.5,2170,8610,1,1230,940,1959
0322069180,649500,3,3,3730,383328,1.5,2230,1500,1990
9348700020,734500,4,2.75,3280,6845,2,3280,0,2003
7414200010,276000,3,1,870,8040,1,870,0,1953
7849200635,235000,2,1,900,28800,1,900,0,1928
1524800005,325000,2,1,1400,10800,1,1400,0,1974
8045600130,425000,4,2.75,1680,9545,1,1080,600,1979
5559200170,307000,4,2,2390,23972,2,1720,670,1949
5700000275,635000,3,2.5,2300,5500,1.5,2000,300,1921
3224900130,223000,3,1.75,1340,7473,1,1340,0,1973
4397010480,425000,3,2.75,2600,10874,2,2600,0,1994
2310000250,190000,3,2.25,1640,7730,1,1220,420,1989
8731902340,275000,4,1.75,1960,6177,1,1960,0,1967
3630000080,450000,3,2.5,1480,1961,2,1480,0,2005
4139900050,1.468e+006,4,3.25,5010,34460,2,5010,0,1988
9191200380,550000,4,2,1540,5000,1.5,1540,0,1913
0930000415,835000,4,2.75,4030,10240,2,3310,720,1943
5450300020,900000,6,3,3020,13783,2,3020,0,1952
8898700440,290000,2,2,1590,9375,1,910,680,1983
1238501188,1.035e+006,4,2.5,2910,9131,2,2910,0,2014
0644210020,780000,4,2.5,3020,15164,1,1730,1290,1976
3066200460,572500,3,2,2290,11200,2,2290,0,1979
3422049088,389000,3,1.75,2180,9220,1,1090,1090,1938
6433000050,350000,4,1.75,2740,10086,1,1440,1300,1972
7215410430,476000,4,2.5,2740,33158,2,2740,0,1993
5316100255,1.04625e+006,2,3,2330,3600,2,1870,460,1927
2413300980,287000,3,2.25,2300,7200,1,1550,750,1978
1175000280,707500,4,4,1550,6596,1.5,1550,0,1907
7304300420,464500,4,2.5,1750,11381,1,1610,140,1947
0059000250,720000,3,1.5,2180,5000,1,1090,1090,1941
1441300130,319000,3,2.5,1610,8544,2,1610,0,1994
1075100050,330000,3,1,1570,9136,1,1570,0,1953
7972000010,120750,3,1.75,1140,9628,1,1140,0,1969
7972000010,195000,3,1.75,1140,9628,1,1140,0,1969
5113400364,650000,4,1.5,2480,6383,1,1380,1100,1946
5076900010,530000,3,1.75,1690,8190,1,1690,0,1958
3526039193,825000,4,3,2910,8027,1,1800,1110,1970
7905380280,436000,4,2,1600,15044,1,1600,0,1972
7936500221,658000,2,1,1010,14244,1,1010,0,1926
5100404761,547500,3,2,1850,9570,1,950,900,1940
0510000050,762000,3,1.75,2150,2527,2,1400,750,1906
7148700050,340000,3,1.75,2650,7378,1,1460,1190,1952
3271800185,880000,4,1.75,2510,5800,1,1830,680,1953
2652501470,1.22e+006,4,2.5,3240,3600,2,2060,1180,2008
1568100920,1.95e+006,4,2.5,3440,14554,2,2170,1270,2012
7738500185,382500,3,2,1150,6249,1,1150,0,1952
9133600130,344500,3,1.75,1890,9535,1,1210,680,1976
3298720010,375000,4,2.75,1430,7403,1,1030,400,1982
2856101479,276000,1,0.75,370,1801,1,370,0,1923
5710610250,500000,5,3.25,3130,12087,2,2180,950,1975
0163000010,330000,4,2.5,2105,6093,2,2105,0,2003
1062100095,328000,3,1,890,5965,1,890,0,1950
1437900020,450000,3,1.5,1340,7200,1,1340,0,1972
8073000585,840500,4,2.25,2290,12174,1,1490,800,1948
3342700491,679000,3,2.5,2770,9350,2,2770,0,1957
3395800305,270000,3,1.5,1890,9450,1,1090,800,1957
2923500010,757500,5,2.25,3160,8065,2,3160,0,1977
3629970680,524950,2,2.5,1830,2856,2,1830,0,2005
2408800130,424900,4,2.75,2950,49658,1,2950,0,1960
2204500480,551100,3,1,1430,8640,1,1430,0,1954
7708000010,421000,3,2,1420,12655,1,1420,0,1968
2639400020,635000,4,1.75,2460,7560,2,2460,0,1952
7883604095,255000,3,1,1340,6120,1.5,1340,0,1920
3055800020,419950,4,1,1530,7920,1,1030,500,1955
7195800009,325000,6,3,2650,12870,1,2650,0,1977
8946750170,281000,4,2.25,1677,3600,2,1677,0,2012
5603700095,655275,3,1.75,2050,11856,1,1460,590,1962
8819900170,861000,3,2,2520,3959,1,1270,1250,1931
3999300290,850000,3,3.5,2620,11148,2,2060,560,1977
2791500280,246000,3,2.5,1650,6675,1,1290,360,1990
8820903560,380000,2,1,700,4836,1,700,0,1926
4401200460,813000,4,2.5,3430,7508,2,3430,0,1998
3394100020,990000,4,2.5,3140,11049,2,3140,0,1988
2880100795,650000,3,2.5,2350,3750,2,1740,610,2003
0104560280,273000,4,3,1990,6180,2,1990,0,1990
2133010290,398000,4,2.5,2050,14724,2,2050,0,1989
1723049008,200000,2,1,930,8665,1,930,0,1938
8146100095,839000,3,1,1230,12305,1,1230,0,1955
7715800430,502000,3,2.5,1870,9135,1,1250,620,1984
9510900630,305000,3,2.25,2110,7665,1,1360,750,1973
9414610020,574950,5,3.25,3160,10000,2,3160,0,1980
1160000255,311000,3,1,1120,8631,1,1120,0,1942
0777100005,1.65e+006,3,2.25,2750,6203,1,1620,1130,1959
3205100130,387000,3,1,1230,9568,1,1230,0,1962
2929600020,375000,3,1.5,1190,20672,1.5,1190,0,1948
2420069242,175000,2,1,740,3434,1,740,0,1920
5009600010,248000,4,2.5,1770,5855,2,1770,0,2003
2414600255,336750,4,2.25,1720,7803,1,1350,370,1955
9359300250,685000,4,2.5,2770,45514,2,2770,0,1989
3629980920,645000,4,2.75,2330,3917,2,2330,0,2004
6679001060,279000,3,2.5,1660,7388,2,1660,0,2003
1702900664,479000,2,2.5,1730,1037,3.5,1730,0,2008
0928000020,466000,3,2.25,1880,7279,1,1280,600,1962
0705710290,361500,4,2.75,2190,6740,2,2190,0,1995
8155830020,404000,3,1.75,1720,7202,1,1720,0,1995
9378700190,319000,4,3.25,2360,8344,2,2360,0,1990
5104200420,320000,3,1.5,1490,10132,1,1490,0,1969
9550202140,1.311e+006,4,3.75,3490,5625,2,2610,880,2014
7855300460,1e+006,3,2.75,2370,8900,1,1670,700,1971
9346960050,660000,4,2.5,2290,9120,2,2290,0,1977
2254501440,546000,4,3,1790,3600,1.5,1790,0,1901
3732800525,300000,4,1.75,1820,5015,1,1190,630,1926
2525059134,500000,2,1.5,1760,12000,1,1760,0,1964
8562891100,381500,4,2.5,2430,5556,2,2430,0,2003
4094800380,990000,3,2.25,2630,12899,2,2630,0,1966
5104530680,278226,4,2.5,2390,4639,2,2390,0,2006
2917200675,340000,2,1.75,1500,4158,1,1220,280,1947
8732030440,305000,4,2.5,2510,12000,1,1520,990,1977
7779200275,760000,4,2.5,2420,10285,1,1700,720,1958
6121800050,195000,4,1.5,2170,9948,2,2170,0,1952
5652601155,564000,4,1.75,1960,6138,1,1260,700,1960
3261020080,539500,4,2.25,2280,8550,1,1660,620,1977
4060000020,299980,4,1.5,1580,10230,1,790,790,1945
5468730280,290000,4,2.5,1850,5674,2,1850,0,1993
7304301045,257000,2,1,770,11084,1,770,0,1947
4077800507,518500,4,3,2120,5520,1.5,1420,700,1985
1041500020,657000,4,2.75,3060,35380,1,1810,1250,1982
1423089134,590000,3,2.25,2680,41250,2,2680,0,1984
3992700048,526000,4,1.75,2220,6350,1,1110,1110,1959
2172000285,254500,2,1,1150,11250,1,1150,0,1920
8813400345,575000,2,1,980,3663,1,980,0,1909
5487300020,464550,3,1.5,1690,10500,1,1690,0,1967
7201800280,409950,3,1.75,1320,6030,1,1320,0,1969
8856000545,100000,2,1,910,22000,1,910,0,1956
0567000380,365000,2,1.5,820,1270,2,820,0,2009
1450100020,208000,3,1,1300,7420,1,1300,0,1960
7950302995,497950,4,2.5,1950,3000,2,1550,400,1998
1446110020,405000,5,3.5,3672,9742,2,3006,666,2006
8914100080,568000,3,2.5,2740,22499,2,2740,0,1994
3333000655,334000,2,1,890,6000,1,890,0,1941
8019201061,235000,3,2,1090,8400,1,1090,0,1961
8570900328,295000,2,1,1170,10621,1,1170,0,1963
5631500947,610000,4,3,2600,29539,1,2600,0,1994
0254000020,453500,4,1.75,2000,6032,1,1300,700,1959
1929300305,1.22e+006,4,3.75,3520,3944,1.5,2200,1320,1913
4202400078,175000,2,1,1410,7000,1,1410,0,1968
4202400078,335000,2,1,1410,7000,1,1410,0,1968
2968800010,275000,3,1.5,1950,7620,1,1010,940,1956
2880100675,400000,2,1,980,2130,1,860,120,1918
1024000050,915000,3,2.75,3390,7000,1,1740,1650,1979
6072400280,619850,4,2.5,2270,9247,1,1500,770,1972
2329600280,225900,3,1,1510,8800,1,1010,500,1963
6822100050,525000,2,1.5,960,7200,1,960,0,1910
1420400130,215000,4,2.25,1900,9600,1,1900,0,1967
7732400280,802000,3,2.5,2580,13096,2,2580,0,1986
4397000500,330000,4,2.5,2340,11784,2,2340,0,1997
9560700010,549800,3,2.25,1580,11680,1,1580,0,1958
6131600285,195500,4,1,1230,8636,1.5,1230,0,1954
8956500020,338000,3,2.5,1590,7819,2,1590,0,1992
0624069108,3.2e+006,4,3.25,7000,28206,1,3500,3500,1991
1727500280,480000,4,2.25,1770,7000,1,1770,0,1972
4029400080,383000,4,2.5,1850,8310,1,1200,650,1962
2873000920,257000,3,1.75,1430,7210,1,1430,0,1975
1402900460,335000,4,2.75,2190,9209,2,2190,0,1996
8125200480,422000,4,2.5,2310,6650,2,2310,0,2012
1087900050,560000,3,1.75,2000,10182,1,1400,600,1963
7937900280,680000,4,2.75,3620,35429,2,3620,0,2006
1096100010,320000,2,1,1210,7040,1,1210,0,1952
2050100250,665000,3,2.5,2330,15536,1,2330,0,1996
8691370500,751000,3,2.5,2840,6854,2,2840,0,2002
7147600225,320000,6,2.75,2410,10763,1,1310,1100,1957
4021100095,290000,4,1.75,1820,22043,2.5,1820,0,1918
7524000280,250000,4,2,1470,7412,1,1470,0,1967
3205200430,423000,3,1.75,1100,10005,1,1100,0,1964
7922720250,601002,4,2.5,2050,8094,1,1050,1000,1976
3644100095,352900,2,1.5,1240,1892,2,1240,0,2002
3425079088,509950,3,2.5,2210,70567,2,2210,0,1995
8730000250,360000,2,1.75,1340,1050,3,1340,0,2009
2581900235,1.075e+006,4,2.75,2580,8100,2,1780,800,1964
3793500920,349950,3,2.5,2390,6441,2,2390,0,2002
2472920780,395000,4,2.5,2250,6840,2,2250,0,1987
8860200010,273500,3,1.5,2000,15265,1,1540,460,1967
6823100225,700000,4,1.75,1870,6000,1,1670,200,1949
6669070080,699000,3,2.5,2370,10968,2,2370,0,1985
7214810050,537000,4,2.25,2640,8800,1,1620,1020,1980
3791500050,405000,3,1.5,1240,9975,1,1240,0,1977
4340610080,269500,2,1,800,1200,2,800,0,1999
7686203620,260000,4,2.5,2050,12500,1,1300,750,1965
2013800095,266750,3,2.25,1650,10000,2,1650,0,1988
4030100005,1.8e+006,5,3.75,4320,39094,2,4320,0,1938
8931100095,779000,2,2.25,2130,5920,1,1830,300,1950
1954630080,500000,3,2.5,2840,48716,1,1870,970,1994
3361402066,365000,4,1.75,3080,32997,1.5,3080,0,1950
0579000595,724000,2,1,1560,5000,1.5,1560,0,1942
7701960250,890000,4,2.75,3220,15467,2,3220,0,1994
1250200595,431000,4,2.5,1450,3600,1.5,1250,200,1902
2632000080,242000,2,1,960,21850,1,960,0,1947
9323000010,415000,4,2.5,2670,8279,2,2670,0,1999
3052700225,727160,7,3.75,2310,5000,2,2310,0,1984
3459900305,1.11e+006,4,3.25,3520,19354,1,2010,1510,1978
3530410020,265000,2,1.75,1090,3272,1,1090,0,1970
0461005435,519000,3,1.75,2000,5680,1,1080,920,1903
8851500050,262000,4,1.5,1840,9009,2,1840,0,1965
4094800190,1.19e+006,4,2.5,3160,13194,2,3160,0,1965
2025701190,295000,3,1.75,1520,6559,1,1170,350,1992
0226059120,615000,3,1.75,2110,56192,1,1480,630,1978
1818800235,1.1e+006,4,2.75,3410,7750,1,1710,1700,1958
3905080250,575000,4,2.5,2630,6247,2,2630,0,1992
3126049415,388000,3,1.75,1350,2325,3,1350,0,1999
1245000500,750500,4,2.5,2860,9159,1,1530,1330,1989
2924069132,527500,3,1.75,2310,78844,1,1760,550,1977
0922069169,503000,3,2,2590,108900,2,1980,610,1988
5015000346,1.047e+006,4,3.5,3500,4000,2,2560,940,2000
8122101440,325000,2,1,800,7260,1,800,0,1953
6413600285,402000,3,1.75,1580,6127,1.5,1580,0,1947
6145601995,370000,3,1.5,1560,6774,1,1060,500,1927
1214000080,329950,3,1,1750,7800,1,1150,600,1956
3361400980,135000,2,1,600,6120,1,600,0,1943
2826049260,482500,4,3,1630,7626,1,1110,520,1990
1001200050,259000,4,1.5,1260,7248,1.5,1260,0,1955
8732130680,210000,3,2.25,2140,9775,1,1470,670,1978
1310430130,459000,4,2.75,2790,6600,2,2790,0,2000
2380000190,375000,3,1.75,2530,35150,1,1800,730,1977
0123039626,295000,3,2.25,1330,7200,1,900,430,1974
1257200290,910000,3,2,2700,6120,1,1350,1350,1962
0318900080,470000,4,1,1740,37238,1.5,1740,0,1932
8118600080,565000,4,2,2070,7980,1.5,2070,0,1940
2023049372,339950,4,2.25,2670,9040,1,2170,500,1955
0126059005,547000,5,3,2200,103237,1,1160,1040,1971
6303401150,125000,2,1,810,8382,1,810,0,1942
1732801150,2.3e+006,4,4.75,3970,9778,2,3390,580,1928
7893800250,348000,3,2.5,2370,7500,1,1620,750,1979
1922059298,175000,3,1,1460,11880,1,1460,0,1961
2391600950,439950,3,2.5,1770,2875,2,1770,0,1990
3623029034,230000,3,1,1120,32250,1,1120,0,1934
0013001991,207000,3,2.5,1520,2550,2,1520,0,2005
1156000250,320000,5,2.5,3020,21441,1,1510,1510,1978
1326059182,1.089e+006,5,3.25,5600,107157,2,3440,2160,1988
3755500080,510000,4,1.5,1320,14250,1,1320,0,1954
5042300095,730000,4,1,1870,4992,1.5,1670,200,1940
7772800020,750000,3,3.75,2460,7630,1,1940,520,1976
3629000080,237000,3,1.5,960,7400,1,960,0,1962
5126210280,560000,3,2.5,3440,103672,2,3440,0,1990
3062600050,745000,3,2.75,3010,12432,1,1890,1120,1970
5493110080,1.825e+006,3,3.75,6030,39317,2,4440,1590,1991
2560801222,180000,3,2.25,1990,6350,2,1990,0,1967
2560801222,309950,3,2.25,1990,6350,2,1990,0,1967
2660500095,715000,4,1,1710,6050,1.5,1410,300,1913
4083800345,620000,4,2.25,1890,4300,1.5,1350,540,1918
0587800130,330000,3,2.5,1990,9995,2,1990,0,1996
8901000585,525000,4,1.75,1600,7400,1,1210,390,1973
8650000250,611000,6,2.5,3820,53173,1,2040,1780,1974
4137050130,294000,4,2.5,2210,8465,1,1490,720,1990
3288300920,463000,3,1.75,2020,11095,1,1480,540,1975
3374500290,320900,3,2,1770,7251,1,1770,0,1990
1137400420,369950,4,2.5,2050,4502,2,2050,0,2005
3222059130,565000,4,2.75,3130,139392,2,3130,0,1981
3959400345,589500,4,1.5,3520,4933,1.5,2270,1250,1929
3971701990,400000,4,1.75,1810,9750,2,1810,0,1977
0686530170,458000,3,2.25,2150,9900,1,1450,700,1977
0808300470,436000,4,2.5,2495,5751,2,2495,0,2002
7129303180,310000,3,2,1290,6150,1,1290,0,1950
8944460290,398000,5,2.5,3004,5700,2,3004,0,2006
2128000050,625000,4,2.25,2070,7200,1,1390,680,1977
4139910170,1.005e+006,5,3.25,4050,35600,2,4050,0,1990
8122100235,435000,2,1,960,6250,1,740,220,1940
1117000050,250000,3,2.25,1900,9990,1,1300,600,1961
5361700020,430000,3,1.5,1450,7316,1,1450,0,1961
1315300095,790000,4,3.5,2720,3000,2,2250,470,2014
5093300280,1.681e+006,5,5.25,4830,18707,2,3930,900,1952
3438503214,250000,4,2.75,1920,7102,1,1130,790,1992
2346800461,1.12e+006,5,1.5,2540,6660,2,2340,200,1954
1826049408,383900,3,1.5,1600,8040,1,1050,550,1965
5468780020,330000,4,2.5,2210,5929,2,2210,0,2004
1126059091,624000,3,2.5,2510,47044,1,1910,600,1975
3010300415,383000,5,2,2280,5750,1,1140,1140,1951
0619079016,687000,4,3.25,4400,186846,2,4400,0,1993
3449800010,558000,4,3.25,3160,8876,2,2460,700,1997
1231000500,275000,3,2,1380,3500,2,1380,0,1971
4191500130,687500,5,2.75,3320,10500,1,2020,1300,1963
0104550660,275000,3,2.5,1870,6821,2,1870,0,1989
1769600066,700000,3,3.5,3030,11550,2,3030,0,1971
3762900020,342500,2,1.75,1210,7507,1,1210,0,1982
1626069253,483500,4,2.5,2740,45732,2,2740,0,1995
3904100089,190000,3,1.75,1350,7370,1,1350,0,1912
3904100089,300000,3,1.75,1350,7370,1,1350,0,1912
1797500780,540000,3,2,1470,1691,2,1000,470,2007
7614100080,140000,3,1.75,1270,8991,2,1270,0,1981
0087000006,275000,4,1.75,1680,19405,1,1560,120,1959
8074200185,370000,3,2.75,2120,7650,1,2120,0,1958
9310300185,227000,2,1,1040,9100,1,1040,0,1937
1433100010,312000,4,1,1730,8706,1,1010,720,1962
7129302555,260000,2,1,1410,5650,1.5,1410,0,1918
0809002705,797000,3,2.5,1370,1911,2,1370,0,1907
3026079005,640000,6,2,2840,228690,1.5,2720,120,1948
2413910050,605000,4,1.75,3280,35160,1,2080,1200,1976
8078550190,329950,3,2.25,2070,7995,1,1350,720,1987
2225079030,180000,2,1,960,87991,1.5,960,0,1946
2019200480,220000,3,2.25,1470,7518,1,1160,310,1985
9274202005,723000,4,2.25,2430,4748,1.5,1630,800,1928
3834500170,375000,3,1.75,1430,8412,1,1070,360,1928
1223039242,388000,3,1.75,1760,9277,1,1760,0,1962
7657600005,249950,5,2,1730,7375,1,1730,0,1944
8963300005,390000,5,1.75,2290,7900,1,1190,1100,1965
2287000280,705000,4,1.75,1690,11739,1,1690,0,1959
0686300420,590000,4,2.5,3220,7875,1.5,3220,0,1966
9335400005,292000,4,1.75,2130,11097,1,1370,760,1952
2321059093,506000,3,2.5,2100,213008,1,2100,0,1990
7732410380,907500,4,2.5,2770,8642,2,2770,0,1987
3625049088,2.27115e+006,4,3.25,4040,18916,1,4040,0,1954
0013001795,319500,4,2.75,2500,5100,1.5,1420,1080,1907
1604602195,265000,5,1.75,1580,5292,1,980,600,1913
1003400250,237000,3,1,1130,10650,1,1130,0,1954
0042000006,235000,5,1,1500,9282,1.5,1500,0,1966
1193000380,740000,4,2.25,2230,6000,1.5,1810,420,1928
6300500545,359000,3,1.5,1550,4980,1,1080,470,1978
0538000190,334950,4,2.5,2230,5500,2,2230,0,1999
2826049091,259950,2,1,790,8100,1,790,0,1947
6147650170,253000,4,2.5,2230,4541,2,2230,0,2006
3630030500,561000,3,2.25,1710,4140,2,1710,0,2004
6844701680,455000,2,1.5,1260,5100,1,1260,0,1941
9542000275,675000,4,2.5,2420,18470,1,920,1500,1968
1423600020,267000,3,1.5,1090,8160,1,1090,0,1967
8944460170,368000,4,2.5,2689,5724,2,2689,0,2006
6431000005,599995,3,1,1620,3000,1.5,1620,0,1928
3755000020,342500,3,1,940,10500,1,940,0,1966
1503200050,252000,4,1.75,1940,13370,1,1940,0,1974
2599000130,247200,3,1,1590,11200,1,1590,0,1961
0871001980,910000,3,3.5,3020,4082,2,2080,940,1954
1774000170,419950,4,1.75,1870,16549,1,1870,0,1969
8945300290,160000,3,1,880,8976,1,880,0,1966
9433000480,799950,4,3.5,3030,5494,3,3030,0,2014
6672920050,400000,3,2.25,2140,11266,2,2140,0,1986
7893805650,210000,5,2,2050,10200,1,1430,620,1956
7893805650,475000,5,2,2050,10200,1,1430,620,1956
9542830480,355900,3,2.5,2090,3821,2,2090,0,2008
3824100364,420000,3,2.25,2520,26943,1,1760,760,1977
9542850290,710000,4,2.5,2630,8580,1,1700,930,1977
5726500130,518000,4,1.75,2560,15000,1,1880,680,1974
1862400285,375000,3,1,1200,5404,1,1200,0,1937
6123600285,185000,3,1.5,1010,7755,1,1010,0,1953
6838000170,402000,3,2.5,1520,3425,2,1520,0,1986
2922069134,585000,3,1.75,2170,153767,1,2170,0,1976
2767603165,500000,4,2,1980,4500,2,1980,0,1910
1118001835,1.715e+006,4,2.5,3070,7207,2,2670,400,1927
4030100290,1.68e+006,5,3.5,5170,7197,3,3520,1650,1998
9828702335,570000,2,2,1140,690,2,760,380,2014
8141200080,680000,8,2.75,2530,4800,2,1390,1140,1901
9407101850,345000,3,2.25,1690,14615,2,1690,0,1979
9542830050,355000,4,2.5,2150,3600,2,2150,0,2010
4038300010,390000,3,1.5,1180,7700,1,1180,0,1959
1898700050,128000,3,1,1400,9690,1,1400,0,1969
0826000480,448500,3,1.75,1300,4800,2,1300,0,1912
6163901150,346000,3,1.75,1590,9636,1.5,1590,0,1953
3956900480,779000,3,1.75,1990,5600,1,1330,660,1941
3824100020,335000,3,1.75,1510,9720,1,1510,0,1948
5026900235,1.85e+006,4,3.25,2910,1880,2,1830,1080,1914
1330850130,799990,3,2.5,2850,21780,2,2850,0,1994
1726059134,1.075e+006,3,2.5,2830,56628,2,2830,0,2001
2767604551,371000,2,1.5,1110,1189,3,1110,0,2000
7424600020,620000,4,2.5,1900,9775,1,1900,0,1967
8731000010,343000,4,1.75,2290,10290,1,1340,950,1960
5104200380,265000,3,1,1010,14948,1,1010,0,1969
1311030430,1e+006,5,2.5,4670,15857,2,4670,0,1998
3585900190,825000,3,2.5,3400,38400,1,1870,1530,1955
0098020630,889000,4,3.5,4070,10976,2,4070,0,2004
3826500470,305000,3,2.25,1630,10962,1,1100,530,1977
5422560660,407000,2,2.5,1700,6635,2,1700,0,1976
0267000130,613000,5,2.5,2070,12000,1,1340,730,1967
6117502230,1.6375e+006,3,3.5,4660,21164,2,4660,0,1975
2402100675,645000,3,3.75,2050,6000,2,1550,500,1910
1624059224,1.16e+006,4,3.5,4680,9700,2,3360,1320,2005
3811000250,610000,3,2.25,2320,38186,2,2320,0,1980
8029520250,450000,3,2.5,3800,13071,2,2730,1070,1994
3438501150,300000,3,2,720,7598,1,720,0,1947
3582900280,1.12e+006,5,2.75,4400,18500,1,2250,2150,1963
3521069142,418200,3,2.5,2260,74297,2,2260,0,1992
0646910020,250000,3,2.5,1650,2802,2,1650,0,2004
1026069134,619000,3,2.5,2560,43608,2,2560,0,2002
5230000020,500000,4,3,3720,15048,3,3720,0,1979
1442740010,465000,4,2.5,2590,16437,2,2590,0,1986
7937600010,322000,4,1,1750,68841,1,1750,0,1942
1545801410,276900,3,2.5,1620,7320,2,1620,0,1989
1235700073,660000,3,2.25,1700,12615,1,1300,400,1990
7806450050,480000,3,2.5,2450,28185,2,2450,0,1990
3250500103,925000,3,1.75,1610,10796,1,1070,540,1951
2624300080,825000,3,3,3730,35900,1,2960,770,1979
7568700525,326000,2,1,1210,7440,1,780,430,1940
7683800010,205000,3,1,1300,9880,1,1300,0,1959
3089000005,150000,2,1,850,54000,1.5,850,0,1950
9510970010,593567,3,2.5,1770,3205,2,1770,0,2005
9560800290,440000,3,2.5,2060,11231,2,2060,0,1987
1385100050,751000,3,2.5,3090,13316,2,3090,0,1992
3294700101,295000,2,1.75,1050,6500,1.5,1050,0,1925
8021700725,422500,3,2,1300,2250,2,1300,0,1988
4038200480,480000,3,1,1160,8800,1,1160,0,1959
3630180380,890900,4,2.5,3420,6233,2,3420,0,2006
2782100280,672500,4,2.75,2620,6707,2,2620,0,2000
3797002575,605000,4,1.5,1880,3500,1,1080,800,1926
9315600050,1.675e+006,5,3.25,4560,19080,1,2490,2070,1963
1939110080,565000,4,2.5,2330,7936,2,2330,0,1987
5423030380,725000,4,1.75,2350,7574,1,1720,630,1979
5693501100,640000,3,3,1560,1466,3,1560,0,2006
1612500170,253750,4,1,1380,7110,1.5,1380,0,1939
6116500290,799950,6,2.75,3040,36721,1,1760,1280,1958
2450000275,595000,4,1.5,1350,8113,1,1350,0,1959
2194100050,850000,4,2.5,3180,11652,2,3180,0,1977
3782760280,366000,3,2.5,1790,4065,2,1790,0,2009
4320200020,715000,4,3,1986,6000,2,1746,240,1922
2944500420,300000,4,2.5,2400,7215,2,2400,0,1992
3616600231,960000,4,3,4590,9150,2,3490,1100,1981
6758700050,812000,3,2,1970,3420,2,1970,0,1913
2545900050,234950,3,1,1360,9948,1,1360,0,1977
8824900050,656500,4,2,2710,4750,1,1460,1250,1919
6300000213,255000,2,1.5,920,1598,2,920,0,1995
2211700290,538000,3,2.75,2000,7204,1,1250,750,1960
0739500050,260000,3,2.25,1920,9680,1,1300,620,1961
6190500380,546200,3,2.5,2678,6607,2,2678,0,1998
5129000006,280500,3,1,1220,4541,1,890,330,1952
2112700280,295000,3,1.75,1440,4000,1,1050,390,1979
9828702895,700000,4,1.75,2420,520,1.5,2420,0,1900
2026059181,560000,3,2,2090,15790,1,2090,0,1992
3295610080,912000,4,2.75,4030,10888,2,4030,0,1997
1474000050,437000,3,1.75,1310,9282,1,1310,0,1976
2896400170,447000,3,2.5,1800,3074,2,1800,0,2003
3342103281,500000,4,1,1160,20100,1,820,340,1913
7172200080,508300,3,1,1160,5969,1,880,280,1930
5209200010,485000,3,1.5,1870,7853,1,1300,570,1962
6744700427,540000,7,5.75,3700,7647,2,3700,0,1948
1328310440,356000,3,2.25,2280,8765,2,2280,0,1977
2710600080,525000,4,2,1720,6099,1,860,860,1949
8651611980,962800,4,2.75,3630,11775,2,3630,0,1999
1541700010,315000,4,2.5,2040,6300,2,2040,0,2003
0477000019,525000,3,2.25,1750,1879,3,1750,0,2001
8165501700,325000,2,2.25,1550,2285,2,1550,0,2007
9534400010,965800,4,1.75,2500,8725,1,1500,1000,1966
7577700185,550000,4,1,1440,3600,1.5,1440,0,1924
0257000263,182200,4,1,1130,13927,1.5,1130,0,1929
8638500020,315000,3,1,1210,8505,1.5,1210,0,1958
0452001310,500000,2,1,960,5000,1,960,0,1900
7852000500,480000,5,2.5,2160,7737,2,2160,0,1998
4219401236,1.69e+006,3,1.75,3400,8965,1,1820,1580,1957
1622069127,525000,5,3.25,3960,321908,2,2690,1270,1989
2644300005,407500,4,2.5,1900,9075,2,1900,0,1988
3211260290,443000,4,3,2620,35124,2,2620,0,1987
3625500130,1.2565e+006,4,2.5,3150,13700,2,3150,0,1966
6819100380,642000,3,1,1040,4480,1,870,170,1924
8562600500,520000,3,1.75,1540,7558,1,1540,0,1964
9279200280,750000,3,2,1820,5000,1.5,1720,100,1941
6788201440,855000,5,1.5,1930,4500,1.5,1930,0,1929
2624089026,275000,4,1,1430,27153,1.5,1430,0,1934
8698600080,265000,5,2.75,2920,5250,1.5,1800,1120,1911
0425069136,894400,3,2.5,3100,45738,2,3100,0,1991
5528600050,546000,2,1,1200,12856,1,1200,0,1948
8682290660,699950,2,2.5,2390,7489,1,2390,0,2007
1839920050,435000,3,2,1270,10713,1,1270,0,1969
6624010010,259500,4,1.5,1300,7200,1,1300,0,1970
9406590010,359950,4,3.25,2290,4785,2,2290,0,2007
3575305362,517000,3,1.75,1740,10000,1,1740,0,1976
8835900010,579000,3,1,1590,5400,1,1280,310,1948
7199000290,525000,4,2,2420,10735,1.5,2420,0,1967
6669150280,320000,4,2.5,2130,9653,1,1500,630,1978
2619600010,635000,4,1.75,1950,13320,1,1370,580,1969
2314300420,400000,4,2.5,2150,5397,2,2150,0,1998
9512500380,455000,3,1.75,1270,7700,1,1270,0,1968
8653600050,572000,3,1.75,1850,22767,1.5,1850,0,1908
4045900020,650000,2,1.5,1440,136778,1,1140,300,1956
1311800130,162500,3,1.5,1390,7417,1,1390,0,1967
9542890010,400000,2,2.5,1340,1240,2,1150,190,2008
4027700795,268300,3,1,1190,9000,1,1190,0,1968
7013200280,989000,6,4.5,3830,4800,3,3050,780,1919
2460700430,342000,3,1.75,1780,10409,1,1280,500,1981
6147650280,315000,4,2.5,3130,5999,2,3130,0,2006
3574800010,485000,4,2.75,1830,8384,1,1320,510,1979
8731981640,277500,4,2.5,2550,7500,1,1750,800,1976
1525069134,1.295e+006,4,3.5,3790,90169,2,3790,0,1998
2824069180,385000,4,1.75,1800,10890,1.5,1800,0,1912
0751000080,426000,2,1,1630,7680,1,830,800,1947
2044500213,310000,4,2,1870,6000,1.5,1870,0,1956
2044500213,449000,4,2,1870,6000,1.5,1870,0,1956
1703400470,375000,2,1,980,3915,1,980,0,1919
7363600185,1.1875e+006,3,2.25,2860,10625,1,1920,940,1976
3904901300,468000,3,2.25,1470,5597,2,1470,0,1985
7548300425,336000,1,1,1160,5000,2,1160,0,2000
4123830480,392000,4,2.75,1940,6555,2,1940,0,1990
9477000280,412500,4,2.25,1630,7969,1,1100,530,1977
8567450080,545000,4,2.5,2755,11612,2,2755,0,2001
7129304540,133000,5,2,1430,5600,1.5,1430,0,1947
7129304540,440000,5,2,1430,5600,1.5,1430,0,1947
2250000010,294450,4,2.25,1400,7341,1,1300,100,1961
5162100660,335000,4,2.5,2520,7205,2,2520,0,1987
4140500050,362000,3,1,1290,10125,1,1290,0,1956
2129700525,322000,3,1.75,1400,18002,1,1400,0,1977
4337000275,230500,2,1,740,8853,1,740,0,1943
3942900010,380000,4,2,1710,9996,1,1710,0,1950
8699100321,292000,4,2.75,2414,7693,2,2414,0,2006
7686203180,172500,3,1,1040,7500,1,1040,0,1954
1193000480,784000,4,2.75,3540,7091,1.5,1970,1570,1947
1234000630,525000,4,2.75,2530,11549,1,1700,830,1942
8562750250,600000,3,2.5,2320,7609,2,2320,0,2003
5088500170,435000,3,2.5,2530,16102,2,2530,0,1989
1061500630,359900,5,2.75,2790,7600,1.5,2790,0,1965
8073000491,700000,4,1.75,1950,7139,1,1150,800,1957
3277801448,280000,3,2,1020,889,2,720,300,2009
1656600280,655000,4,2.5,3110,24466,2,3110,0,1997
4139420190,2.48e+006,4,5,5310,16909,1,3090,2220,1992
5360200052,499950,3,2.5,2580,23925,2,2580,0,2001
7234601025,540000,3,2.5,1380,1021,2,1160,220,2008
8001470480,970000,4,2.75,3980,9209,2,3980,0,2002
2597670470,330000,4,2.5,2080,7000,1,1400,680,1989
7199330130,474000,3,1.75,1530,8000,2,1530,0,1978
4039700080,670000,4,1.75,1930,9310,1,1930,0,1968
5317100780,1.3e+006,4,3.25,2330,9687,2,2330,0,1918
2597450250,1.16e+006,4,2.5,3860,10361,2,2940,920,1985
2472920680,440000,4,2.5,2880,8061,2,2880,0,1988
7436300170,411000,2,2.5,1590,2088,2,1590,0,1997
3964400470,500000,3,1.5,2150,4000,1.5,1470,680,1928
7351200050,1.335e+006,4,1.75,2300,13342,1.5,2300,0,1934
1377800277,696000,6,3.25,2900,6400,2,2300,600,1977
3862400050,465000,3,2.25,1970,11088,1,1180,790,1967
7199310170,518000,4,2.5,1740,7500,1,1220,520,1976
8039900086,251000,3,1.75,1220,7250,1,1220,0,1962
1137600190,255000,3,2,1290,13282,1,1290,0,1978
1566100130,319000,2,1,780,8271,1,780,0,1924
9547205610,719000,4,2.75,2210,3400,1.5,1470,740,1926
5608000190,1.52e+006,5,3.5,5930,13288,2,3920,2010,1996
3295450050,322000,4,2.5,1950,4553,2,1950,0,2000
3751602249,205000,4,1,1340,7920,1,1340,0,1970
7889600190,229000,3,1,1590,6240,1,1060,530,1956
0217700050,395000,3,2.25,1780,9672,1,1350,430,1960
7943000020,183000,2,1,760,7272,1,760,0,1980
7199310290,583500,3,1.75,1720,7800,1,1170,550,1978
0192700080,312000,3,2.5,2070,25710,1,2070,0,1917
0023520380,539000,3,1.75,1790,9860,1,1410,380,1978
8961950050,409000,4,2.75,3230,12651,2,3230,0,2002
3300701365,510250,3,1.75,1400,4000,1,870,530,1951
0871000170,535000,2,2,1370,3827,1,1020,350,1952
9407150250,280000,3,2.5,1600,7936,2,1600,0,1996
7789000235,286000,3,1,950,8400,1,950,0,1958
8587400050,710000,3,2.75,2210,7660,1,1460,750,1968
5100401315,395000,2,1,930,6380,1,930,0,1940
2634500005,237500,2,1,810,8494,1,810,0,1949
6332000050,464000,3,2,1630,6550,1,850,780,1912
2126049265,495000,3,1.75,1770,10080,1,1770,0,1968
7950304095,257500,1,1,710,6060,1,710,0,1916
0587550010,570000,4,3.5,3990,23544,1,2300,1690,1999
1402630190,362000,3,2.5,2310,7485,2,2310,0,1986
2402100895,640000,33,1.75,1620,6000,1,1040,580,1947
3750604417,172500,3,1,1140,8800,1,1140,0,1972
9547202890,596000,2,1,1040,4880,1,1040,0,1910
2600110250,840000,4,2.5,2170,9796,1,1650,520,1980
7403200050,1.6e+006,3,2.25,3370,23065,1,1920,1450,1980
9528104360,435000,2,1.5,901,1245,3,901,0,2001
2634500050,251000,2,1,840,7870,1,840,0,1949
0268500020,282500,4,1,1650,9750,1,1650,0,1964
1796361100,265000,3,2.25,1380,7226,1,1140,240,1987
8807300130,330000,3,1,910,10240,1,910,0,1969
7170200080,435000,2,1,1230,3800,1,1230,0,1928
1877500005,827235,3,1.75,1740,8560,1,1500,240,1948
7211400525,249950,4,1,1290,5000,1.5,1290,0,1957
2549000020,400000,3,2.5,1950,18533,2,1950,0,1988
4137040250,300499,4,2.5,2150,7944,2,2150,0,1990
5101400461,449000,4,2,1560,5220,1,1560,0,1959
2306400010,500000,2,1,1120,3220,1,1120,0,1923
8861000095,865000,3,1.5,1790,7526,1,1790,0,1953
3754500010,899950,4,3.5,3290,5414,2,2360,930,2006
4326000190,370000,4,1,1540,9541,1.5,1540,0,1961
1525069088,442500,5,3.25,4240,226097,2,3410,830,1980
9474700020,310000,3,1,1010,9945,1,1010,0,1973
4389200876,1.565e+006,4,2.75,2970,12750,1.5,2130,840,1918
6084600420,245000,4,2.25,2190,9113,2,2190,0,1986
6668900010,254950,2,1,700,8100,1,700,0,1949
0125059178,510000,6,4.5,3300,7480,2,3300,0,1980
2131701410,299950,3,2.25,1370,5000,2,1370,0,1990
3158500130,379950,4,2.5,2680,4500,2,2680,0,2011
6300500275,350000,3,1,1390,4820,1,910,480,1926
3395040920,300000,3,2.5,1700,3575,2,1700,0,2000
1193000280,994000,3,2.25,2510,6339,1.5,1810,700,1932
8022900005,315000,3,1.5,1700,8067,1,1250,450,1956
1774000050,480500,4,2.5,2180,11200,1,2180,0,1968
1725800280,373000,3,1,1770,5720,1.5,1140,630,1926
8691390980,728000,4,2.5,3290,5951,2,3290,0,2003
1180008370,415000,4,3.5,3040,7125,2,2240,800,2002
9558020460,427500,4,2.5,2460,5091,2,2460,0,2003
3575302880,339300,3,2,970,10000,1,970,0,1972
6671900095,313000,3,1.75,1320,6205,1,1320,0,1948
5637500094,431500,3,3.5,1900,1612,2,1430,470,2008
4310701330,415000,3,1.5,1220,835,1.5,1220,0,1950
0023520190,490000,3,1.75,1470,9750,1,1470,0,1978
0098000130,1.425e+006,4,5,4630,24054,2,4630,0,2005
6829900080,275000,3,1.5,1400,9750,1,1400,0,1964
5370200170,325000,2,1,1070,5080,1,1070,0,1942
3885805896,1.18e+006,5,3.75,3630,6000,1.5,2470,1160,2004
9550200470,690000,4,1.5,1970,4590,2.5,1970,0,1909
6111400020,410000,4,2,2010,9474,2,2010,0,1953
5135000050,960000,4,2.5,2820,5934,1,1770,1050,1952
8029510010,299250,3,2.5,2530,8669,2,2530,0,1990
4438400050,239000,2,1,710,14000,1,710,0,1953
7831800460,235000,2,1,1210,9400,1,1210,0,1949
2425069069,587000,3,2.25,2370,217800,2,2370,0,1979
8029550020,431000,4,2.5,2300,6087,2,2300,0,2001
7533800170,1.636e+006,3,2.5,3110,6765,2,2550,560,1946
9460000010,285000,3,1.75,1990,6500,1,1090,900,1961
2600130020,778000,3,3,2630,10156,1,2630,0,1987
4037700285,415000,3,1,1300,7975,1,1300,0,1958
8682261190,550285,2,1.75,1680,4500,1,1680,0,2004
5453700020,910000,3,2.25,2180,9865,1,1660,520,1966
4139400630,860000,3,2.5,2770,9136,2,2770,0,1991
9550201495,765000,3,1.75,2120,5000,2,1980,140,1920
9808610190,782000,4,2.5,2830,20345,2,1980,850,1979
7443000514,525000,3,3.5,1370,1764,2,1180,190,2000
1823099056,745000,3,2.5,2810,435600,2,2810,0,1995
6055000010,470000,3,3.5,3520,35512,2,2760,760,2005
3878900225,345000,3,1.75,1990,5650,1,1320,670,1963
4222700130,279000,3,2.25,2070,7800,1,1170,900,1964
1124000010,500000,3,1.5,1320,8100,1,1320,0,1951
0428000225,237000,3,1,1300,8160,1,1300,0,1960
8133300050,200500,3,1.75,1260,9346,1,1260,0,1963
2423039134,387500,4,1.75,2400,9900,1,1250,1150,1957
2726049150,392500,4,2,1950,8040,1,1950,0,1961
8074200080,305000,3,2,1430,12430,1,1430,0,1957
7856600170,981000,4,2.5,2110,10100,1,2110,0,1968
8649900440,680000,4,2.5,2980,8770,2,2980,0,1990
7696630170,276000,4,2.5,2068,7242,2,2068,0,1976
0226039075,655500,4,3.5,3380,8330,2,3380,0,2000
3296000170,555000,5,2.75,2810,13144,1,1440,1370,1964
3223049073,235000,2,1,930,10505,1,930,0,1930
7300700050,325000,3,1,1300,8879,1,920,380,1950
9900000190,268950,3,1,1320,8100,1,880,440,1943
3751600635,264500,3,1.5,1580,14040,1,1050,530,1980
7575600430,240000,3,2.5,1620,5250,2,1620,0,1987
3223039109,819000,3,2.5,2750,226512,2,2750,0,2000
7151700190,850000,2,1.5,2210,5000,1,1530,680,1951
2076400050,294950,4,2.25,1740,9600,1,1160,580,1957
2162000190,693000,3,2.25,2120,13644,2,1420,700,1973
5226500250,478000,4,2.5,2780,7290,2,2780,0,1989
1787600294,222000,2,1,830,6893,1,830,0,1950
6388930170,635000,4,2.5,2070,11286,2,2070,0,1996
2767704332,469000,3,3.25,1390,1278,2,1140,250,2005
6699940250,350000,4,2.5,2610,5866,2,2610,0,2005
8151601190,180000,5,1,1460,11726,1.5,1290,170,1936
5561000420,490000,4,2.25,3390,39356,1,1640,1750,1964
3797001900,360000,3,1.5,1360,6000,1,860,500,1911
6641020050,630000,4,2.5,2807,9430,2,2807,0,1996
3232200095,615000,4,1,1340,2006,1.5,1340,0,1931
2310000440,279950,3,2.25,1340,7202,2,1340,0,1989
6414600321,317000,3,1,1160,8813,1,1160,0,1952
7199320190,618000,4,2.25,2470,7350,1,1600,870,1978
7922800190,620000,5,1.75,2000,8713,1,1000,1000,1962
9553200052,345000,3,1,1110,6250,1,1110,0,1956
4083802425,608000,3,1.5,2240,3750,1,1220,1020,1952
0984000130,325000,4,2.25,1920,11603,2,1920,0,1967
2473002500,475000,3,1.75,2270,13000,1,2270,0,1968
3356403304,154000,3,3,1530,9997,1,1020,510,1992
8651200080,1.19e+006,5,3,3330,19126,2,2610,720,1977
1329300480,376950,4,2.5,2643,5750,2,2643,0,2012
1972201305,500000,2,2,1250,3360,1,1250,0,1957
0425079001,499950,3,2.5,3230,129578,1,2100,1130,1964
9347900020,230000,3,1,880,9035,1,880,0,1967
1015000050,652600,4,2.5,2220,5900,2,2220,0,2014
9542802000,185000,3,1.75,1130,7000,1,1130,0,1978
8088600080,274950,3,1,1450,8820,1,1050,400,1958
5637500250,447000,2,1,760,6035,1,760,0,1920
0087000213,129000,2,1,1150,30184,1,1150,0,1950
5104200470,436000,5,3,2720,9856,2,2720,0,1969
0455000190,825000,3,1.75,2080,5000,2,2080,0,1906
3356403140,225000,3,1,1080,16000,1,1080,0,1952
4472000050,265000,3,2.5,1890,6088,2,1890,0,1996
5350200425,765000,3,1.5,1500,5111,2,1500,0,1984
3975400190,509000,4,2,1960,2166,1.5,1260,700,1926
9541600255,762450,4,1.75,2570,8640,1,2570,0,1958
5538300460,465000,5,1.5,1830,9000,1,1030,800,1955
7625700305,564000,3,1.75,1980,6250,1,1090,890,1910
2895600420,384500,2,1,1130,5236,1,1130,0,1942
2320069260,415000,3,2,2010,33090,1.5,2010,0,1986
7305300470,345000,2,1.75,1820,8409,1,910,910,1948
9477940440,465950,4,2.5,2340,6896,2,2340,0,2001
2561340020,325000,3,1.75,1780,11096,1,1210,570,1979
2561340020,500000,3,1.75,1780,11096,1,1210,570,1979
0524069075,450000,4,2.5,2450,20348,1,1410,1040,1978
2296700050,475000,4,3,2410,8284,1,1210,1200,1969
4122900190,1.3464e+006,5,1.75,3380,20021,1,1690,1690,1963
2754700095,747000,3,1.5,1710,5120,2,1710,0,1920
9265700005,395000,3,1.75,1740,6220,1,1740,0,1954
9826700726,505000,3,2.5,1995,1483,3,1760,235,2005
0321049193,215000,3,2,1760,9282,1,1100,660,1947
1923099034,775000,4,3.5,3970,210830,2,3970,0,2000
4305600250,540000,4,2.5,3000,5471,2,3000,0,2013
6648100010,392500,3,1.75,1540,8925,1,1540,0,1957
5536100020,987000,3,2,2160,15788,1,2160,0,1951
5536100020,1.19e+006,3,2,2160,15788,1,2160,0,1951
5104450440,252500,3,2,1810,10684,2,1810,0,1987
7560000050,730000,3,3.5,2440,3502,2,1970,470,2000
7784400130,497300,6,2.75,3200,9200,1,1600,1600,1953
7298900010,640000,4,2.5,2970,34981,2,2970,0,1998
0259601100,580000,5,2,2290,7125,1,1190,1100,1964
8041100010,377000,3,1.75,1820,34800,1,1820,0,1967
5318100840,1.28e+006,4,3.5,3010,3600,2,2370,640,1999
2771101964,396500,3,1.5,1360,1488,2,1120,240,2003
1560870470,300000,4,2.5,2080,2999,2,2080,0,1998
1232000950,532000,3,1,1110,4800,1.5,1110,0,1946
8682261440,579000,2,1.75,1560,4500,1,1560,0,2004
1370801440,1.4e+006,4,2.5,3520,7815,2,3140,380,1929
7680400050,571000,5,1.75,2280,43560,1,1380,900,1949
6928000440,301950,3,1.75,1370,9288,1,1370,0,1988
3797000290,660000,3,3,2340,2970,2,2160,180,1925
9264030470,455000,4,2.5,3170,10688,2,3170,0,2001
6300000396,375000,3,1.75,1380,5060,1,1380,0,1986
1786700080,470000,4,2.5,2700,6769,2,2700,0,1999
5116000170,374990,3,2.5,1300,10484,2,1300,0,1983
8682282210,541500,2,2.5,1900,3690,2,1900,0,2006
8651611640,782500,3,2.5,3750,7821,2,3750,0,2001
8946750020,264000,3,2.25,1552,3677,2,1552,0,2012
1939130420,640000,4,2.5,2500,7417,2,2500,0,1991
7640400190,660000,3,2,1770,8141,1,1770,0,1952
4139420430,1.365e+006,5,3.5,4210,17258,2,4210,0,1995
1509500080,389950,3,2.5,2170,8140,2,2170,0,1994
6341000020,226000,2,1,1510,19874,1,1510,0,1951
1022069071,390000,3,1.75,1870,40250,1,1870,0,1959
8078400020,485000,3,2.25,1570,8111,2,1570,0,1984
9113200250,840000,4,2.5,2480,4602,2,2480,0,2000
1592300010,600000,5,3.5,3580,21343,1.5,2140,1440,1937
9250900095,331000,2,1,1480,6210,1,1080,400,1950
8815400670,780000,3,2,2610,6000,1,1310,1300,1941
7212680080,300000,3,1.75,1700,8481,2,1700,0,1993
2968801315,361810,3,1.75,1240,7620,1,1240,0,1968
6141100255,467000,3,1,1660,6582,1,1000,660,1946
8068000440,399000,3,1.75,1620,10000,1.5,1620,0,1918
7883605900,315450,3,1.75,1130,7500,1.5,1130,0,1908
9521101315,600000,3,1,1310,5000,1.5,1310,0,1906
8651442910,247500,4,2,1710,5200,1,910,800,1977
8113101233,330000,3,1,2140,5037,1,2140,0,1957
7016200460,500000,4,2.25,2350,7210,1.5,2350,0,1972
4189800020,367500,3,1,1570,10050,1,1570,0,1963
5506500170,560000,3,2.5,2780,32880,1,2780,0,1993
5135000170,655000,4,1.75,2540,7620,1,1320,1220,1948
8155500020,530000,5,2.75,2500,7140,1,1250,1250,1968
2597501190,270000,3,2.25,2080,26574,1,1380,700,1993
5288200225,437500,3,2,1760,2875,2,1290,470,1988
6189200050,575000,3,1.75,1760,10349,1,1760,0,1957
6664900470,278000,4,2.5,1940,6887,2,1940,0,1990
7954300460,568500,4,2.5,3010,6181,2,3010,0,2000
8018600655,280000,4,3,2460,9606,1,2460,0,2012
2508000020,250000,2,1,750,6350,1,750,0,1920
1424059130,247500,3,0.75,1300,72309,1,680,620,1950
7856660130,1.25e+006,5,2.75,3710,13874,1.5,2340,1370,1977
5302400080,535000,4,2.5,2360,15008,1,1920,440,1986
3026059368,814842,3,2.5,3190,6899,2,3190,0,2014
3275910020,340000,4,2.5,2181,5521,2,2181,0,2006
2229900020,359950,3,1.75,1890,9100,2,1890,0,1952
7748000020,750000,3,1.75,2610,5544,1.5,1680,930,1934
7457000005,1.22e+006,4,2,3090,8125,2.5,3090,0,1918
9268200285,370000,2,1,860,5040,1,860,0,1956
1328330780,329950,3,1,1000,9170,1,1000,0,1980
7806450190,500000,3,2.5,2760,35171,2,2760,0,1990
0626400020,734000,4,2.5,3490,18521,2,3490,0,1990
5416510920,385000,4,2.5,2960,5054,2,2960,0,2006
3330500345,230000,2,1,1280,4635,1,840,440,1917
3885801190,1.385e+006,4,3.5,3230,7200,1,1640,1590,2000
1035000007,210000,3,2,1830,4992,1,1230,600,1953
1471701470,293000,3,1.75,1420,13187,1,1420,0,1974
7519000225,465000,3,1,1580,3774,1.5,1580,0,1900
1433290010,449000,3,2.25,1960,44634,1,1130,830,1984
1223049150,325000,2,1.75,1670,10725,1,1670,0,1965
5198600010,180000,3,2,1670,7056,1,1670,0,1958
4310703070,650000,6,3,2960,5000,1,1790,1170,1968
6154900005,665000,4,2.75,2420,7102,1,1670,750,1946
3541700170,324450,3,2,1420,16000,1,1420,0,1966
0952001495,588000,4,1.75,2170,5750,1,1370,800,1975
8122600020,200000,4,1,1310,5200,1.5,1160,150,1945
3579700080,383000,4,1.75,1830,11090,1,1060,770,1962
2769602140,499950,3,2,1360,2500,1,730,630,1986
5152920170,549000,5,2.5,3440,12350,1,1760,1680,1976
3226049530,465000,5,3,2010,7264,1,1290,720,1990
4017050020,450000,3,2.5,2450,19744,2,2450,0,1990
3982700250,799900,4,2.5,3030,7800,2,1580,1450,1991
2523069134,495000,4,2.5,2480,91911,1,1470,1010,1973
7281300010,1.2e+006,3,3.5,4310,10842,2,3140,1170,1988
3396800280,637000,4,2.5,2120,15000,2,2120,0,1983
7234600851,589000,4,1,2210,4366,2,2210,0,1901
7418000020,305000,3,1.75,1400,10350,1,1400,0,1976
7548300170,600000,4,2.25,2760,5200,2,1790,970,1910
1446300020,587000,4,2.5,2550,6256,2,2550,0,1992
4385700425,1.425e+006,2,2.5,2220,4000,2,2220,0,2000
0016000545,250000,4,1,1320,11212,1,1320,0,1914
7996720050,515000,3,3,2440,3202,2,1640,800,1982
8691310840,833000,4,2.75,3780,10308,2,3780,0,1999
4309700130,860000,3,3.25,4720,32467,2,3190,1530,1998
5100401060,550000,4,3,2360,6678,1,1760,600,1949
1180002580,180000,2,1,890,6000,1,890,0,1919
3379100130,507000,4,1.75,1770,9375,1,1170,600,1968
8645900080,427000,3,2,1720,128066,1,1720,0,1994
7569500010,616950,3,3.5,2490,2722,2,2020,470,1999
8026200080,372000,4,1.75,1890,10550,1,1010,880,1969
5101404555,290000,2,1,1020,6380,1,1020,0,1930
9432900250,329990,4,2.75,2420,8438,2,2420,0,1997
3995700250,393500,3,1.75,1600,8156,1,1600,0,1948
2574900080,1.55e+006,5,3.25,3370,17458,1,2000,1370,1982
8731982630,240000,4,2.25,1720,8300,1,1720,0,1973
2968800660,285000,3,1,1090,8640,1,1090,0,1973
2872900010,382500,3,1.5,1090,9862,1,1090,0,1987
1118000080,1.925e+006,4,3.75,3600,16101,1,3600,0,1951
8923600185,800000,3,2.5,2760,9471,1,1760,1000,1956
1725059252,550000,4,3.5,2770,24140,2,2770,0,1967
3818700190,387846,4,1.75,2520,15205,1,2040,480,1954
5125400305,367500,4,2,1960,16015,1,1960,0,1980
4232400010,780500,5,1,1760,4264,2,1760,0,1902
5100402606,680000,3,1.75,1090,6775,1,850,240,1950
3876300080,434400,5,1.75,1960,7875,1,1960,0,1968
1246700050,370000,2,1,1220,17172,1,1220,0,1947
1837010010,465000,3,1.75,1730,8073,1,1350,380,1971
1328320280,323000,3,2,1830,6925,1,1830,0,1979
5468760050,270000,4,2.5,1600,9921,2,1600,0,2009
5556300114,1.32e+006,3,1.75,2040,42693,1,2040,0,1980
2316800020,560000,4,2.5,2710,6583,2,2710,0,2003
7133300675,450000,3,1,1140,4500,1,840,300,1907
0751000020,290000,2,1,930,7740,1,930,0,1924
3578400670,354000,3,2,1010,21340,1,1010,0,1980
2767603890,705000,5,3,2380,5000,2,2380,0,1909
9477000190,445000,3,2.25,1860,7200,1,1240,620,1977
2268000500,229900,3,1,1440,11925,1,1440,0,1968
7202271060,610000,4,2.5,2980,5896,2,2980,0,2001
7852020080,535000,3,3.25,2670,5108,2,2670,0,2000
3298400470,437400,3,1.75,2150,8925,1,2150,0,1960
8854000010,540000,5,2.75,3160,10059,2,1740,1420,1978
1624059093,570000,3,2,1890,29185,1,1470,420,1949
8564950280,533000,3,2.5,2810,4607,2,2810,0,2004
7853230460,555000,3,2.5,2690,4819,2,2690,0,2004
1796350080,239950,3,1.75,1230,9600,1,1230,0,1984
9477200460,350000,3,1,950,9451,1,950,0,1977
7972601995,245000,2,1,1200,4880,1,980,220,1943
1454100440,456000,4,1.75,1670,9886,1,1670,0,1947
2558690130,465000,4,2.25,2140,7701,1,1470,670,1977
8682310470,445000,2,1.75,1440,4660,1,1440,0,2008
3876000440,517850,5,2.75,3050,7500,1,1800,1250,1966
4137070440,329000,5,2.75,2570,7260,2,2570,0,1996
2391602500,512500,3,2.5,1840,2875,2,1840,0,1997
8632100010,365000,2,1,1250,8100,1,1250,0,1947
3034200426,450500,3,1,1410,9384,1,1410,0,1948
5078400190,915000,3,1,1560,8232,1,1560,0,1952
1450100420,205000,3,1,960,7314,1,960,0,1960
1853500290,314000,4,2.5,1870,8449,2,1870,0,1992
8133700020,496000,2,1,900,9260,1,900,0,1946
0723059073,329950,4,1,2050,7590,1,1280,770,1957
2374200005,375000,4,2,2400,6000,2,2400,0,1913
7420200050,623000,3,2.5,1850,7777,2,1850,0,1989
7211350130,310000,4,1.5,1220,9600,1,1220,0,1980
7802900500,532500,3,3.25,3140,37120,1,1760,1380,1984
8081900101,960000,4,2.25,2410,4560,2,1800,610,1929
9510300130,598000,4,2.5,3130,40918,2,3130,0,1994
8582010290,683000,3,2.5,2300,9218,2,2300,0,1998
4023500352,425000,5,2.5,2840,9425,1,1590,1250,1962
9482700440,533000,5,2.75,1800,3780,1.5,1400,400,1926
6117502455,375000,3,1,1190,9486,1,1190,0,1953
2791500020,250500,3,2,1710,7225,2,1710,0,1988
5643600351,257000,4,1.75,1900,22896,1.5,1360,540,1922
4059400585,218000,3,1,880,18205,1,880,0,1945
9285800585,460000,3,2,2060,4437,1,1030,1030,1929
5727500561,255544,3,1,1360,6186,1.5,760,600,1941
8682310430,560000,2,2,1680,4647,1,1680,0,2008
3782760170,480000,4,2.5,2980,4074,2,2980,0,2011
1925059073,1.3e+006,5,1.75,2130,19180,1,1500,630,1968
6891800500,580000,3,2.75,2650,9752,1,2650,0,1989
4319200605,475000,3,2.5,1700,9100,1,1160,540,1998
6117500460,1.3095e+006,4,2.5,2680,12215,1,1590,1090,1956
0522079022,700000,3,2.5,2530,623779,1,2530,0,1980
3066410080,590000,3,2.5,2520,10223,2,2520,0,1988
4137000280,264500,3,2.5,1630,8346,1,1630,0,1990
2767600920,465000,2,1,730,2600,1,730,0,1918
7972601680,290000,3,1,910,7620,1,910,0,1971
1725059136,1.815e+006,4,4.5,4510,12873,2,4510,0,1998
4037000080,416000,3,1,1110,12150,1,1110,0,1957
3580900290,360000,4,2,1450,8940,1,1450,0,1962
7527410080,585083,5,2.75,2910,36250,1,1590,1320,1977
2653000005,840000,4,2.75,2600,2750,1.5,1620,980,1936
3028200080,81000,2,1,730,9975,1,730,0,1943
4218400005,1.285e+006,3,2.25,2440,9200,1,2440,0,1950
4058802335,326000,4,1.75,2290,7380,1,1390,900,1963
2487200680,447000,2,1,720,7500,1,720,0,1925
1950900005,185000,3,1,940,7125,1.5,940,0,1958
6647400250,439950,3,2.5,1540,7773,2,1540,0,1982
9407000920,234000,3,1.5,1140,10300,1.5,1140,0,1967
8617000020,485000,4,2.5,2100,8886,2,2100,0,1964
1193000190,750000,4,1.75,2670,6250,2,2020,650,1941
7443000480,865000,4,2,2750,5527,2,2130,620,1901
2557000380,287500,4,2.5,2570,9000,1,1590,980,1979
4450700010,375000,3,1.75,1660,9673,1,1130,530,1976
1236300307,565000,3,2.25,1700,8800,1,850,850,1969
3422059249,260000,4,3,1530,8306,2,1530,0,2010
9476200290,190000,3,1,1260,10900,1,1260,0,1943
3812400898,399950,5,2,2760,6420,1,1380,1380,1964
5422420470,275000,3,2.5,1830,7062,2,1830,0,1990
2492200280,528000,3,2.75,2160,4086,1,1380,780,1987
4331000130,315000,3,2,1770,9685,1,1770,0,1948
6073500190,614306,2,2.25,2210,5500,1,1410,800,1968
9522300010,1.49e+006,3,3.5,4560,14608,2,4560,0,1990
3629910470,590000,3,2.5,2110,3870,2,2110,0,2004
1250200285,261500,3,1,1130,3600,1,1130,0,1908
1509700050,300000,4,2.5,1960,9898,2,1960,0,2001
2045800006,439000,3,2.25,2230,4551,1.5,1450,780,1928
2171400199,277554,5,2.25,2350,13000,1,2350,0,1961
2123049502,215000,3,2,1340,8505,1,1340,0,1931
0284000095,1.2e+006,2,2.25,2160,17861,2,2160,0,1956
5652600427,420000,4,2,1700,6375,1,850,850,1950
7202330470,485000,3,2.5,1650,3436,2,1650,0,2003
6131600255,202500,3,2,1540,8316,1,1540,0,1954
7853301660,710000,5,3.25,3920,8572,2,3920,0,2007
9211010440,535000,4,2.5,3250,6933,2,3250,0,2009
1423900080,260000,4,1.75,1360,7700,1,1360,0,1966
2215901190,254000,3,2,1480,7480,1,1480,0,1992
0251100020,600000,4,2.5,2360,5226,2,2360,0,2001
3395041206,285000,3,2.5,1800,2516,2,1800,0,2001
0224069169,800000,4,3.75,2540,20662,2,2540,0,1998
3365901435,165000,3,1,1200,13100,1,1200,0,1943
7689600630,216500,2,1,710,6960,1,710,0,1943
3158500290,387990,4,2.5,2640,5595,2,2640,0,2011
7189800095,500000,4,2.5,3010,5040,2,3010,0,2006
7202270440,650000,4,2.5,2770,5612,2,2770,0,2001
3501600114,646000,4,2.5,2310,4079,2,2310,0,2008
8097000250,323400,4,3,2060,9138,1,1430,630,1992
9542830430,300000,3,2.5,1880,4200,2,1880,0,2007
6012500170,712500,5,2,2280,5400,1.5,1340,940,1947
7217400895,550000,3,1.75,1380,3402,1.5,1380,0,1900
2651100050,400000,3,1,1180,7537,1,1180,0,1969
2212200050,255000,4,1.75,1650,7200,1,1100,550,1977
7922900460,660000,3,1.75,2030,9032,2,2030,0,1963
8925100440,925000,4,2.25,2110,6375,1,1600,510,1941
0259800680,534000,4,2.25,2130,7210,1,1330,800,1965
0271200130,215000,3,1,1690,7700,1,1690,0,1969
3760500280,1.95e+006,3,2.5,2510,12779,1.5,2510,0,1968
5315100277,1.4e+006,5,4.25,3530,7924,2,3530,0,2001
9265410010,212000,3,1.75,1470,8350,1,1470,0,1990
8731800840,265000,3,1.75,1840,7300,1,1840,0,1966
7579200715,400000,3,1.75,1860,5750,1.5,1300,560,1918
9485300010,311500,4,2.5,1940,10133,2,1940,0,1992
1652500010,2.328e+006,4,3.5,4420,20759,2,4420,0,2003
4059400190,225000,2,1,800,6050,1,800,0,1944
8965510190,1.25e+006,4,2.5,3700,21755,1,2620,1080,1988
7100000250,380000,3,1,1400,8710,1,1400,0,1948
2541100010,600000,4,2.5,2250,11370,2,2250,0,1991
7732410130,600000,3,2.25,2230,9053,2,2230,0,1987
7889600285,315000,3,2.5,1950,3000,2,1950,0,2001
1556200005,847000,5,1,2550,4623,2.5,2550,0,1905
8691310980,730000,4,2.5,2750,10351,2,2750,0,1998
1561600095,1.058e+006,4,2,2290,11137,1,2290,0,1955
3025300250,1.62e+006,4,2.25,2350,17709,2,2350,0,1977
5297200089,664000,2,1.75,1720,5785,1,860,860,1948
3303860630,454450,4,3,2810,6000,2,2810,0,2007
6430500086,341000,3,1,940,4200,1,940,0,1955
4025300285,276693,4,1,1190,8875,1.5,1190,0,1946
0923049400,185000,2,1,1390,11340,1,1390,0,1969
5466300130,160000,2,2.5,1660,2258,2,1660,0,1981
4136900250,270000,4,2.5,1920,8497,2,1920,0,1998
7635800313,300000,4,1.5,1460,8760,1,1460,0,1958
2938100005,264950,3,1.5,1370,10115,1,1370,0,1957
0796000235,209950,2,1,1050,6250,1,840,210,1943
8682280170,850000,3,2.5,3360,8708,2,3360,0,2006
7504110780,645000,4,2.5,3160,11380,2,3160,0,1983
1445500010,855000,4,2.25,2480,36974,2,2480,0,1973
7574910420,632500,4,1.5,2720,37258,2,2720,0,1994
2115720130,289950,3,2.5,2070,5013,2,2070,0,1987
3586500630,850000,2,1.75,2170,25732,1,2170,0,1952
9475960050,565000,4,2.75,3260,4900,2,3260,0,2013
7527000020,792000,3,2.5,2250,19270,2,2250,0,1999
3668000500,260000,3,2.25,1950,9600,1,1200,750,1987
1549500585,585000,3,2,2220,209523,1,2220,0,1991
8898700680,295500,3,1.75,1330,10523,1,1000,330,1981
6163901061,329000,4,2,1190,7877,1.5,1190,0,1946
7855600080,750000,3,1.75,2770,15232,1,1570,1200,1976
4024100807,495000,4,2.5,2310,7555,2,2310,0,1997
5037300130,672500,3,1.75,1580,5750,1,1330,250,1947
3528900086,1.307e+006,5,3.25,2800,3200,1.5,1910,890,1932
1552520010,405000,3,2.5,1500,9636,2,1500,0,1994
5113400168,620000,3,1.75,2140,5808,1,1070,1070,1947
9346900170,615000,4,2.25,2330,7020,1,1450,880,1973
3999300080,887000,6,2.25,3830,11180,1,2440,1390,1962
0472000895,1.057e+006,4,2.75,4510,5000,2.5,3270,1240,1941
0687600010,753000,4,1.75,2160,39430,1,1660,500,1974
1130000005,1.6e+006,3,2.25,3170,5000,2,2230,940,1975
7397300170,3.71e+006,4,3.5,5550,28078,2,3350,2200,2000
1077100020,365000,3,1.5,1520,8519,1,1520,0,1954
7856570190,870000,4,2.75,3410,23000,2,3410,0,1982
5104510010,321000,4,2.5,1830,9601,2,1830,0,2003
2895550050,280000,3,2.5,1550,4486,2,1550,0,2000
4142450480,288000,3,2.5,1520,3593,2,1520,0,2004
5559200020,248500,3,2,1240,12285,1,620,620,1939
5381000352,330000,4,2.5,2380,13550,2,2380,0,1999
2474300050,740000,5,3.5,2720,11454,2,1830,890,1988
7787110680,445000,3,2.5,2210,8010,2,2210,0,1998
1788700185,198500,2,1,1050,9600,1,1050,0,1959
2887950020,280000,7,2.5,1940,5458,2,1940,0,1994
8835210480,336500,3,2.25,1420,3433,2,1420,0,1981
0844000225,267000,3,2.5,1690,10336,2,1690,0,1989
1771000430,315000,3,1,1160,9180,1,1160,0,1968
8078430480,545000,4,2.5,2040,7412,2,2040,0,1988
8001450170,274950,3,1.75,1840,16679,1,1840,0,1989
8924100430,500000,2,1,1440,7130,1,1210,230,1948
7418700050,299000,3,1,1390,9624,1.5,1390,0,1954
3630020430,420000,3,2.5,1470,1445,2,1160,310,2005
1972200725,620000,3,2.5,1776,1248,3,1604,172,2006
0267000170,575950,3,2.25,1640,12000,1,1180,460,1967
8961980290,666500,4,2.5,2860,6600,2,2860,0,2000
1551500130,180000,4,1.5,1740,7292,1,1020,720,1962
5557800010,261350,3,1.75,1390,18200,1,1390,0,1962
3776300010,1.03e+006,4,3.5,2730,5607,1,1660,1070,1948
2473000680,390000,3,1.75,1435,8960,1,1435,0,1969
7984400005,253500,3,1,1640,12384,1,1090,550,1954
9238430680,625000,4,2.5,2630,48706,2,2630,0,1986
3211000170,255000,4,2.5,1580,7800,1,1580,0,1959
7338220280,257000,3,2.5,1740,3721,2,1740,0,2009
8073000480,869000,2,1.75,1900,13122,1,1100,800,1954
7525530670,745000,4,2.5,3130,10860,2,3130,0,1990
0191100275,1.35e+006,4,3.5,3500,9525,2,3500,0,1999
1214000050,350000,3,1.75,2130,7500,1,1090,1040,1956
6852700279,475000,3,2.5,950,1110,2,950,0,2003
5423600080,540000,3,2.5,1720,11656,2,1720,0,1987
6661200050,175000,2,1,830,2699,1,830,0,1996
6146600170,100000,2,0.75,660,5240,1,660,0,1912
0366000095,890000,5,1,2590,4652,2,2310,280,1907
2895550280,280000,3,2.5,1600,4271,2,1600,0,2000
0293760050,1.05e+006,4,4.25,4390,13833,2,3320,1070,2003
7298040500,486000,4,2.5,3560,12047,2,3560,0,1988
7802900224,670000,5,2.5,2860,68519,2,2860,0,1958
3904910010,480000,3,2.5,1640,7847,2,1640,0,1987
8121100255,440000,3,1.75,1500,6180,1,1060,440,1947
5700004040,1.5e+006,3,3.25,3990,8505,2,2870,1120,1922
3528000290,743700,4,2.5,2610,33206,2,2610,0,1988
9268200050,449950,3,1.75,1470,7590,1,1470,0,1988
6132600221,367000,2,1,700,2334,1,700,0,1945
3303980470,1.185e+006,4,3.25,3960,12895,2,3960,0,2001
1450000050,201000,3,1,900,7576,1,900,0,1959
6788200605,575000,3,1.75,2010,3800,2,2010,0,1922
2214800170,295000,3,2.5,1940,10350,1,1420,520,1979
7116000225,190000,3,1,1510,8760,1,1510,0,1946
2767600635,742500,2,3,2020,5000,1,1350,670,1952
1644500050,875000,6,3.5,4430,11453,2,3000,1430,2001
2579500101,1.387e+006,4,3.5,4010,10880,2,3150,860,1990
3876311650,600000,4,2.25,3070,8400,2,3070,0,1970
7984400050,207000,3,1.5,1460,11100,1,1460,0,1956
7852170130,650000,4,2.75,3260,5335,2,3260,0,2003
9358000780,275000,2,1,830,5610,1,830,0,1922
2663000345,1.2e+006,4,2.5,2390,4200,2,2150,240,1924
4338800500,262500,3,2,1130,7200,1,1130,0,1944
5101407350,399000,2,1,1120,8661,1,1120,0,1946
3512100050,139000,4,1.5,1410,10648,1,1410,0,1966
6633900050,575000,3,2.5,1750,4797,2,1750,0,1991
4083301950,580000,2,1,1040,3200,1,1040,0,1926
7202350010,468000,3,2.25,1630,2490,2,1630,0,2004
4168100130,230000,3,1,1380,10112,1,940,440,1963
8155850010,675000,4,4,3680,18804,2,3680,0,1990
7955030010,318000,3,1,1250,20040,1,1250,0,1970
4136870020,332100,5,3.5,2660,6978,2,1980,680,1996
1446401190,175000,2,1,620,6600,1,620,0,1963
9323600380,817000,4,2.25,2600,10660,2,2600,0,1979
3262300920,1.2e+006,4,3,2150,8119,2,2150,0,1953
6332000130,525000,3,1.75,1470,6550,1,1070,400,1916
9150100020,189000,3,1,1380,7282,1.5,1380,0,1915
2770604081,629950,3,2.5,1680,1683,2,1120,560,2014
6329000050,641500,1,1,1000,9084,1,1000,0,1950
2125400010,490000,3,2.25,1630,7573,1,1230,400,1983
3876313260,415000,3,1.75,1790,15142,1,1360,430,1976
5101400561,250000,2,1,890,6380,1,890,0,1951
9533100080,781000,3,1.5,1290,8175,1,820,470,1952
9561100080,400000,4,2.25,2420,7927,1,1400,1020,1973
5101402618,935000,4,3,3680,7105,2,2890,790,2008
4027700009,575000,4,2.5,3020,17810,1,1600,1420,1979
9544200277,1.66e+006,4,3.25,4240,11189,2,4240,0,2006
8731960050,302300,5,2.75,3130,9450,1,1580,1550,1973
1393800005,355000,2,1,900,6656,1,900,0,1940
3896100130,1.538e+006,3,2.25,2880,7599,1,1710,1170,1958
7785000130,926250,4,1.75,2390,17717,1,2390,0,1964
2968800825,300000,3,1.75,1450,7620,1,1050,400,1955
7199330480,361500,3,1.75,1070,9000,1,1070,0,1978
5458800415,616000,3,1.5,1740,9840,1,1740,0,1963
8929000250,395000,2,1.75,1210,1161,2,1210,0,2014
7893206305,245000,3,1.5,2100,10000,1,2100,0,1954
7956300020,206000,3,1,1060,9600,1,1060,0,1962
0240000130,706000,4,2.5,3280,16575,1,2190,1090,1972
1370803730,578000,3,1.5,1660,6000,1.5,1660,0,1937
4299000130,341950,5,3,3070,5252,2,3070,0,2005
1233100351,305000,3,1,1150,9048,1,1150,0,1922
2652500225,575000,3,2.75,1710,3600,1,1590,120,1909
3224069026,330000,3,1,1180,43124,1,1180,0,1959
2592400250,445000,4,2.25,2130,7200,2,2130,0,1972
4364700595,333000,3,1,1050,7560,1,1050,0,1951
8562750660,598500,4,2.5,2520,3980,2,2520,0,2005
7231600098,225000,2,1,700,6000,1,700,0,1943
8635750980,570000,4,2.5,2640,4200,2,2640,0,1998
5652600605,630000,5,2,2330,6783,1,1310,1020,1956
2141310020,779000,5,2.25,2830,7738,2,2830,0,1977
7852160080,760000,4,3.5,3720,13591,2,3720,0,2004
3649100346,322968,5,1.75,1890,9600,1,1890,0,1960
7852010840,595000,4,2.5,2910,7287,2,2910,0,1998
0823059145,321000,4,1,1300,18836,1,1300,0,1941
9238430660,653000,3,2.25,2770,57745,2,2770,0,1985
6329000190,750000,4,1.75,2520,21834,1,1420,1100,1960
8818900250,530000,3,1,1340,4284,1,1080,260,1910
1250200415,352750,2,1.75,1060,1241,2,960,100,2008
3303951150,424950,4,2.5,2480,8563,2,2480,0,1992
3083000048,427000,5,2.75,2220,4000,1,1230,990,1973
1102000095,558000,4,2.5,3220,5120,2,2420,800,2000
3426049153,438200,2,2,1600,5643,1,1600,0,1954
7625700020,340000,1,1,640,4800,1,640,0,1918
0586000020,830005,4,3.75,3610,7904,3,3290,320,1994
8724300010,548000,4,3.25,3420,5012,2,2330,1090,2008
2741100741,411715,3,1.75,1840,5101,1,1040,800,1952
3425059173,865000,4,4,2790,16117,2,2790,0,1999
0715010130,1.75e+006,6,4.25,5860,13928,2,4150,1710,2013
7504100920,688000,3,3,3450,16200,2,3450,0,1983
5104520460,399950,4,2.5,2350,5100,2,2350,0,2003
1257200020,555000,3,1,1250,4590,1.5,970,280,1903
4452300130,677000,3,2,2000,3207,1,1100,900,1916
8651520420,539000,3,2,2260,9568,1,1780,480,1985
6401700010,410000,3,1.75,1510,6597,1,950,560,1939
8857320130,472000,2,2.25,1800,2748,2,1800,0,1979
1102000759,755000,3,2.5,2420,8856,1,1620,800,1957
6457000080,269900,5,1.75,1750,8325,1,1750,0,1966
1126059022,667400,4,2.5,2660,40312,2,2660,0,1977
4340000010,1.22e+006,3,2.25,2640,7544,1,2640,0,1995
3052700460,544000,3,2.5,1460,1613,2,1180,280,2007
0567000020,800000,2,1,1570,5000,1.5,1570,0,1924
3575304017,315000,3,1,1010,7500,1,1010,0,1975
7812801700,227000,4,1,1200,7200,1.5,1200,0,1944
5103300020,765000,4,2.5,4040,25752,2,4040,0,2000
9578080130,625000,3,3,1820,1641,3,1540,280,2006
3885803044,1.875e+006,4,5,5810,7440,2,3790,2020,2004
9323600280,822600,4,2.5,3010,9600,1,1510,1500,1979
7016100380,515000,4,2.5,1910,8947,1,1160,750,1970
3438500114,377000,4,2,1640,5014,1,930,710,1982
2597800010,600000,3,1,1480,17360,1,1480,0,1954
8018000020,525300,4,1.75,2520,7770,1,1680,840,1965
4055700167,760000,4,3,2840,13554,1,1990,850,1974
1863900190,202000,2,1,840,7200,1,840,0,1907
0522079027,470000,3,2,1730,38884,1,1730,0,1997
7525530470,810000,3,2.5,3140,10983,2,3140,0,1991
8858100020,175000,3,1,1480,8415,1,1080,400,1967
6414100231,440000,4,1.75,1920,7986,1,960,960,1952
6303400460,197000,2,1,770,8636,1,770,0,1951
9476200020,254000,3,1,1010,7384,1,1010,0,1943
3575302938,405000,3,1,1460,10000,1.5,1460,0,2002
2695600190,416000,2,1,940,4264,1,940,0,1949
9433000470,779950,4,2.75,2840,4864,3,2840,0,2014
7140200250,200000,4,2.75,1910,7210,1,1430,480,1980
3905090130,658100,4,2.5,2430,8509,2,2430,0,1992
3335000050,397000,2,1.75,1610,4104,1,950,660,1996
4397650080,815000,3,3.75,2780,5002,2,2780,0,1999
1568100380,345000,2,1,1160,8504,1,1160,0,1949
8078570460,305500,4,2.5,1850,7199,2,1850,0,1989
6382000080,340000,3,2.25,2120,13090,1,2120,0,1997
7905380080,330000,5,2.5,2620,12763,1,1400,1220,1979
6600490250,269000,4,2.5,2060,3608,2,2060,0,2004
7200001756,349950,3,1,1060,9525,1,1060,0,1966
4427100130,431000,3,1,1500,6240,1,1500,0,1953
5606000255,735000,4,1.75,2380,5700,2,1820,560,1946
1402700170,414000,5,3,3045,5030,2,3045,0,1999
5366200460,619500,3,2.5,1700,4105,2,1700,0,1992
1245500725,675000,3,1.75,1240,13869,1,1240,0,1957
9477201060,380500,3,1,1410,7854,1,1410,0,1971
4060000290,253000,3,1.5,880,6600,1,880,0,1945
0522059327,157500,2,1,740,9003,1,740,0,1949
0686530020,627000,4,2,2030,9300,1,2030,0,1976
5145100460,469500,4,2.5,2090,7241,1,1140,950,2001
6329000380,319950,2,1,920,8341,1,920,0,1939
8960200280,249500,3,1,1180,7200,1,1180,0,1968
2867100007,485000,3,1,1260,3230,1.5,1260,0,1907
9542100005,1.125e+006,5,3,3690,10260,1,2070,1620,1967
1545807280,314500,3,1.75,1700,17355,1,1200,500,1978
3996900460,220000,2,1,770,8149,1,770,0,1948
0217500005,444950,3,2.5,2020,7800,1,1330,690,1958
1513800080,598000,4,2.5,2030,9825,1,1330,700,1985
8691390460,699850,4,3.5,2690,6164,2,2690,0,2002
6633900170,595000,3,2.5,1750,3354,2,1750,0,1991
0205000050,735000,4,2.5,3270,45537,2,3270,0,1993
8838900167,542500,4,2.5,2330,14289,2,2330,0,1978
7199330170,450000,3,1.75,1720,6960,1,1140,580,1978
0236500050,298500,3,2,2420,8800,1,1420,1000,1959
2025049028,403950,2,1,710,1136,2,710,0,1943
3298700305,271000,2,1,710,4240,1,710,0,1942
6145600780,335000,2,1,1510,3844,1,1510,0,1923
1332700010,305000,2,2.25,1610,1968,2,1610,0,1979
2768300655,630000,3,3,1880,2200,2,1520,360,2007
7224500010,253000,2,1.75,1220,5000,1,860,360,1921
4037000185,395000,4,1.75,2060,7900,1,1070,990,1957
7614100020,265000,3,2.5,1340,10290,1,1140,200,1981
1423400225,225000,2,1,1030,9192,1,1030,0,1959
5419000050,338500,4,2.5,2717,4513,2,2717,0,2005
5151200290,300000,2,1.75,1360,8100,1,860,500,1975
4060000170,255000,2,1,1260,7810,2,1260,0,1945
1568100290,337000,4,3,2240,8504,2,2240,0,1992
4137010010,324900,3,2.25,2080,9740,2,2080,0,1988
2581900284,821000,3,2.75,2760,8476,1,1690,1070,1967
1222069136,500000,4,2.75,3000,213008,1,3000,0,1975
7625701795,885000,4,3.5,3310,6000,2,2200,1110,2010
1771100440,360000,4,2,1630,10375,1,1630,0,1968
3211200290,304000,3,1,900,7500,1,900,0,1972
4154302045,376000,2,1,880,2400,1,760,120,1918
4036801315,425000,4,1.5,1620,7875,1,1620,0,1956
9185700414,1.1805e+006,3,1.75,1610,7200,1,1090,520,1973
1221000562,187000,3,2.5,1730,1803,2,1730,0,2005
1890000250,710000,2,1.5,1640,4080,1.5,1540,100,1916
7436400020,585000,3,1.75,1840,7350,1,1370,470,1974
3303850290,1.4e+006,5,4,4700,22326,2,4700,0,2002
2025059026,1.98e+006,4,3.5,4500,44384,1,3340,1160,1990
3751600430,250000,3,1.75,1780,35233,1,1420,360,1979
7856640460,950000,4,2.75,3800,12200,2,3800,0,1986
9510920050,725000,3,2.5,2980,16996,2,2980,0,1992
8651720020,505000,4,2.5,2780,6369,1,1590,1190,1978
2114700500,90000,1,1,560,4120,1,560,0,1947
7950303530,400000,4,2,2060,3060,2,2060,0,1968
8910500471,407000,3,1,1140,7785,1,1140,0,1954
9550204450,651000,3,1.5,1890,4400,1.5,1890,0,1919
4024101990,485000,3,2.25,2090,7450,1,1350,740,1978
5595900345,460000,4,2.75,3460,13168,2,3460,0,1932
1782500095,369000,2,1,1320,6135,1,880,440,1942
8887001192,355000,2,1,1240,27042,1,1000,240,1943
4006000307,155000,2,1,810,4755,1,810,0,1980
5605000440,1e+006,3,1,1880,5450,1.5,1880,0,1924
2591840050,419625,4,2.5,2680,11590,2,2680,0,1988
1442300005,435000,3,2,2040,6880,2,2040,0,1954
3343901440,379000,4,1.75,2180,7876,1,1290,890,1977
9406590250,293000,4,2.25,1870,5371,2,1870,0,2009
2212250080,592100,4,2.75,2310,7851,1,1790,520,1989
3578700073,362000,3,1.75,1120,9730,1,1120,0,1944
1123049126,227000,3,1,1340,10035,1,1340,0,1959
0526059259,335500,3,1.75,1260,8487,1,1260,0,1970
3222079136,213000,3,1.75,1200,55321,1.5,1200,0,1977
7237300290,338000,5,2.5,2400,4496,2,2400,0,2004
7468900235,163500,3,1,940,7200,1,940,0,1954
3352401476,199988,2,1,860,5000,1,860,0,1949
4217402162,1.185e+006,3,2.25,2390,7875,1,1980,410,1948
6147650430,320000,4,2.5,3130,5200,2,3130,0,2005
1133000235,450000,6,2.25,3550,11780,1,2960,590,1948
2781270080,249900,2,2,1470,2541,2,1470,0,2005
1423200170,223000,2,1,910,9869,1,910,0,1957
3023059071,631000,4,4,2630,59586,1,1470,1160,1963
0511700170,350000,4,2.25,1780,10416,1,1060,720,1963
2124089028,279000,3,1.75,1430,39160,1,900,530,1925
1431700280,310000,5,2,2730,7344,1,1510,1220,1962
7686202635,185000,2,1,900,8000,1,900,0,1954
3874400380,445000,3,2.5,1740,22089,1,1130,610,1977
0642500080,365000,4,2.5,2905,4874,2,2905,0,2003
1591600527,333500,3,1.5,2230,9120,1,1390,840,1959
5587000010,385000,3,2.25,1680,8450,1,1340,340,1960
2201500440,345000,3,1.5,1240,11200,1,1240,0,1954
7603100095,1.26e+006,3,3,3230,8625,2,2220,1010,1998
9412200080,440000,4,2.5,2560,10400,1,1280,1280,1965
7852130080,444500,3,2.5,2600,4724,2,2600,0,2002
2923039243,340000,4,1,1200,11834,1,1200,0,1972
6908200250,680000,4,1,1660,6075,1.5,1660,0,1915
3039000010,420000,3,1.75,1140,8558,1,1140,0,1982
1657300280,438500,3,2.25,3050,10689,2,3050,0,1988
9200000050,109500,2,1,800,10625,1,800,0,1942
7508200080,461000,4,2.75,1700,7495,1,1200,500,1964
5454200080,968000,4,1.75,2630,9645,1,2630,0,1963
7972601100,355000,3,1.75,1960,7705,1,980,980,1950
5112800190,249000,3,1.5,1180,11579,1,1180,0,1962
0984210170,256500,5,2.5,1960,7350,1,1360,600,1969
8081500050,1.81e+006,5,2.5,4250,20441,1,2490,1760,1984
8731801190,269000,3,2.25,1950,8661,1,1950,0,1966
9103000715,1.35e+006,4,3.5,3600,5217,2,2720,880,1947
8732300430,885000,3,2.25,2060,9552,1,1610,450,1975
3754700170,455000,3,2,1640,9825,1,1090,550,1971
2652500795,980000,4,2.5,2730,4800,1.5,2230,500,1909
7454000470,412500,3,1.75,1530,6300,1,1530,0,1942
3630121060,740000,4,3.5,3060,4777,2,3060,0,2007
1370800825,1.298e+006,4,2.25,2860,5658,2,2130,730,1933
4310702759,326000,2,1.5,1030,798,3,1030,0,2008
8635750950,568500,4,2.5,2460,4200,2,2460,0,1998
3448900420,620000,4,2.5,2500,8282,2,2500,0,2013
2113700005,283000,3,1.75,1830,7600,2,1490,340,1947
8615800500,875000,6,3.25,2820,4536,2,1930,890,1917
9106000005,1.31e+006,4,2.25,3750,5000,2,2440,1310,1924
0806800420,289950,3,2.5,2070,6145,2,2070,0,2003
2787311190,252500,3,2.5,1780,7192,1,1250,530,1974
3342102385,376000,4,2.25,2200,6750,1,1480,720,1959
7504000290,635700,4,2.5,3240,13978,1,1860,1380,1977
8691300500,710000,4,2.5,2880,12349,2,2880,0,1996
0930000425,440000,3,1.75,1570,5120,1,980,590,1947
3291800670,439000,3,2.5,3180,7904,1,1810,1370,2006
1425059145,455000,2,1.5,1310,12196,1.5,1310,0,1970
4406000050,225000,2,1,910,9612,1,910,0,1981
1432700420,250000,3,1,1460,10914,1,1460,0,1959
5561400470,585000,4,3.25,3410,34939,2,2470,940,1992
8827901350,685000,3,1.75,2720,4720,1.5,1580,1140,1925
6190700284,420000,5,2.75,2280,10319,1,1300,980,1959
3644100073,245000,2,1,670,1675,1,670,0,1960
3223059173,275000,4,2,1480,15000,1,1480,0,1957
0109210460,270000,3,2,2330,8000,1,1390,940,1986
9106000050,767250,4,3,2170,2500,2,1710,460,1997
4337600280,229000,3,2,1760,9900,1,1760,0,1943
3438501100,400000,3,1,1240,4000,1.5,1240,0,1928
7935000280,2.195e+006,5,3.25,5210,35765,2.5,4940,270,1911
7419700010,665000,5,2,2800,17788,1,1400,1400,1963
1626069102,500000,4,2.25,2060,44431,2,2060,0,1988
7574000080,355500,5,2,2360,19899,1,2360,0,1968
3830700010,369000,4,2.5,2370,6557,2,2370,0,1998
1454100010,338500,2,1,720,6050,1,720,0,1951
0603001045,256000,3,1,950,4000,1,780,170,1949
2607720440,470000,3,2.5,1980,9725,2,1980,0,1994
0930000470,675000,3,2.5,2540,7680,2,2540,0,1940
2621750280,369950,4,2.75,2760,7533,1,1400,1360,1997
7853220470,615000,5,3.5,2950,7980,2,2350,600,2005
4139660430,1.20069e+006,5,3,3640,28531,2,3640,0,1996
1338800430,950000,3,1.75,2150,3503,2,1870,280,1921
1338800491,799500,4,2.5,2760,5750,2,2760,0,1993
0792000006,187000,2,1,840,11600,1,840,0,1952
7504020670,598000,5,2.25,2890,12478,2,2890,0,1977
4017600010,429950,3,2.25,2060,10160,1,1340,720,1967
1471701410,347950,5,2.25,1700,13500,1.5,1700,0,1962
3528000470,851000,3,2.5,3560,107290,2,3560,0,1987
3192000080,205000,3,1,1210,10185,1,1210,0,1957
1565100010,225000,3,2.25,1590,9200,1,1110,480,1979
9201000460,705000,4,2.25,2620,10536,1,1520,1100,1979
0323059316,535000,5,2.5,3190,6178,2,3190,0,2003
6802200190,222500,3,2,1450,9044,2,1450,0,1990
1773100430,313500,2,1.5,1270,1282,2,1000,270,2006
6137610190,632000,3,2.25,2730,7521,2,2730,0,1992
1568100387,467000,3,2,1840,3432,2,1840,0,2012
3826500290,339000,3,2.25,1970,7210,1,1380,590,1978
0629410190,712000,3,2.75,3200,6699,2,3200,0,2004
4189800050,335000,3,1,1060,10050,1,1060,0,1967
6126600950,470000,3,3.25,1740,1693,2,1360,380,2007
5411800250,367000,3,1,810,7000,1,810,0,1968
7853302140,440500,3,2.5,2460,4399,2,2460,0,2007
1423910670,305000,4,1,2100,9288,1,1050,1050,1968
2301400470,635000,3,1.75,1530,5000,1,1020,510,1948
1860600290,1.02e+006,3,2.25,1670,4800,1.5,1670,0,1903
9267200345,342000,2,2.5,1175,1366,2,740,435,2005
3826500170,283000,3,2.25,2130,8800,1,1270,860,1978
9804500420,430000,4,2.75,2470,50123,1,1280,1190,1978
2895550190,245000,4,2.5,1700,4268,2,1700,0,2000
6699930440,355500,3,2.5,2600,5540,2,2600,0,2004
3543900380,395000,3,1,1460,5000,1,1460,0,1934
0059500050,324900,4,2.25,2010,7280,2,2010,0,1988
9274202885,660000,3,1.75,1320,5750,1.5,1320,0,1918
7701930050,570000,3,2.5,3150,20189,2,3150,0,1990
0200800480,552321,3,2.5,1960,8469,2,1960,0,1984
3835500005,1.1e+006,2,1.75,2050,11900,1,2050,0,1950
9543000896,237000,3,1.5,1800,9216,1,1800,0,1950
1090000005,402000,2,1,1210,5600,1.5,1210,0,1922
5561000430,470000,3,2.25,1830,39165,1,1830,0,1963
1568100670,395900,3,1.75,1880,8706,1,940,940,1927
6813600440,442000,2,1.75,860,5535,1,860,0,1948
7701990380,795000,4,2.75,2890,16397,2,2890,0,1997
7153400010,190500,3,2,1390,10155,1,1130,260,1980
5608010420,808000,4,2.75,3340,7230,2,3340,0,1996
9141100073,500000,4,2.5,2040,6685,2,2040,0,1998
0629400480,775000,4,2.75,3010,15992,2,3010,0,1996
9250900104,300000,5,1.75,2110,8500,1,1100,1010,1962
9250900104,496000,5,1.75,2110,8500,1,1100,1010,1962
5104531700,448000,4,2.5,2510,6853,2,2510,0,2006
0623039026,645000,2,2.25,2770,11884,1,1570,1200,1969
7626200235,464600,3,1.75,1120,5500,1.5,1120,0,1925
7228500425,590000,3,1,1530,2370,2,1530,0,1901
3332500095,399000,3,2.5,1800,3300,2,1690,110,2004
7950300440,305000,2,1,1030,6000,1,1030,0,1925
8143000280,478000,3,1.75,1210,6175,1,1210,0,1976
4045500715,598800,1,1,1090,32010,1,1090,0,1958
1155620190,430000,4,2.25,1790,7203,1,1110,680,1973
3332000715,433000,4,1.5,1550,5053,1,1180,370,1963
5113000420,420000,4,2.75,2400,20000,1,1170,1230,1961
3223039181,585000,4,1.75,2470,131790,2,2470,0,1937
7399300420,255000,3,1,1170,7395,1,1170,0,1969
1088400190,305000,3,1,1120,10125,1,1120,0,1961
1588600177,396000,4,1,1040,4420,1.5,1040,0,1944
9264950420,347500,4,2.5,2460,7350,2,2460,0,1989
5418650080,900000,4,2.5,3690,11468,2,3690,0,1987
9492800020,425000,3,1.75,1960,43332,1,1400,560,1982
0323089173,429000,3,2.5,1920,15124,2,1920,0,1995
6821102358,540000,3,2.25,1670,3135,2,1220,450,2002
0943100689,324950,3,2,1340,9750,1,890,450,1974
8722100825,1.049e+006,3,2.25,2610,3357,2,1980,630,1926
4223000280,221000,4,1.75,1540,7200,1,1260,280,1966
1454100122,405000,3,2,1640,7201,1,1640,0,1948
3323500010,1.15e+006,3,2.5,2100,15120,1,2100,0,1953
9557300080,588000,4,1.75,1930,7245,1,1510,420,1972
6306100080,234950,3,2,1430,10850,1,1430,0,1994
5700001100,580000,4,1.5,2430,4995,1.5,1730,700,1928
6187500080,637000,5,3,2460,7240,1,1840,620,1991
7369600080,704000,4,2.25,2490,6973,1,1490,1000,1953
1623049145,210000,2,1,880,9750,1,880,0,1938
2877102330,772000,4,2.5,2110,3750,2,2110,0,2000
0546001060,763000,4,1.75,1850,4388,2,1850,0,1941
2822059091,213500,2,1.5,2060,7713,1.5,2060,0,1930
3971701300,255000,2,1,1360,9367,1,680,680,1924
1732600050,423500,3,2,2000,10490,1,1430,570,1978
3585900430,520000,3,1.5,1810,18483,1,1810,0,1954
6791000050,550000,3,2.75,2230,14400,1,1460,770,1977
1818800289,795000,3,2.75,1820,7517,1,1820,0,1997
2738600080,495000,4,3,2740,2811,2,2240,500,2003
1310440950,455000,4,2.5,2710,6558,2,2710,0,1997
1322049150,85000,2,1,910,9753,1,910,0,1947
0007200080,239000,4,2,1980,10585,1.5,1980,0,1924
1788800080,184900,3,1,1040,10080,1,1040,0,1959
1328320920,386000,4,2.25,2810,8560,1,1610,1200,1979
7283900185,415000,4,2.5,2000,5962,2,2000,0,1999
8685500020,387000,3,1,1530,6372,1,1210,320,1962
1338800425,2.14e+006,6,4,5110,7128,2.5,5110,0,1906
0282500010,685000,4,2.25,3133,16197,2,2533,600,1965
0798000630,340000,4,2.5,2020,32710,1,1070,950,1941
5583200345,422000,2,1,750,4000,1,750,0,1926
1036100130,442000,3,2.5,1980,39932,2,1980,0,1994
0795002375,280000,3,1,1200,6250,1,920,280,1943
1245000461,1.15e+006,5,2.5,3580,8921,2,3580,0,2000
6802200280,279000,3,2.5,2010,11618,2,2010,0,1990
9521100795,569000,4,2,1730,3884,1,1060,670,1924
4039800080,1.355e+006,5,3.5,5960,13703,2,4770,1190,1984
6146600595,209950,2,1,860,5080,1,860,0,1960
6380500151,468000,3,1.5,1370,7697,1,1370,0,1939
8643000185,237100,3,1.75,1360,9603,1,1360,0,1963
7212650950,336000,4,2.5,2530,8169,2,2530,0,1993
0357000005,500000,4,2,1680,3813,2,1680,0,1900
5648600010,290000,3,2.5,1580,6860,2,1580,0,1995
2818600010,1.185e+006,7,3.5,3890,8342,2,2840,1050,1968
9842300095,365000,5,2,1600,4168,1.5,1600,0,1927
3977630130,146300,3,1,1200,9668,1,1200,0,1975
5160300020,554000,3,1.75,1760,10780,1,1760,0,1977
3754700050,424000,3,2,1670,7700,1,1170,500,1972
0629860010,1.348e+006,4,3.5,4640,9827,2,3210,1430,2007
0446000010,508500,4,1.5,1800,6750,1.5,1800,0,1950
8562000010,244500,3,1.75,1210,8864,1,1210,0,1985
0646910480,206000,2,2.5,1280,1566,2,1280,0,2005
0868000415,643500,3,2,1650,7104,2,1650,0,1945
1826049430,372500,4,1.75,1590,10523,2,1590,0,1922
2769600190,630000,5,2,1900,5000,1,1720,180,1957
3630070280,418000,2,2.5,1500,3608,2,1500,0,2005
8944460190,425000,4,2.5,2689,6688,2,2689,0,2006
3630180470,800000,4,2.75,3250,5500,2,3250,0,2007
6099400293,208000,2,1,960,13438,1,960,0,1951
6791000280,476000,3,1.75,1650,9600,1,1650,0,1977
7796450190,277500,3,2.5,1690,5171,2,1690,0,2003
2294900010,478000,3,1.75,2790,36585,1,1410,1380,1970
1186000095,890000,4,2.75,2310,4020,3,2310,0,1979
2770601763,450000,3,3.5,1790,1288,3,1390,400,2000
3392100050,205000,3,1,1230,8750,1,1230,0,1965
2878600655,665000,3,2,1620,2640,1.5,1620,0,1929
3299200080,518000,4,2.75,2440,12051,1,1440,1000,1966
2564900020,465000,4,2.25,2100,7350,2,2100,0,1979
2111010080,330000,3,2.5,3040,7232,2,3040,0,2003
6669080020,449400,4,3,2490,5064,2,2490,0,2007
8682300010,829000,3,2.75,2690,10443,1,2690,0,2007
1974200020,450000,4,1.75,2190,9752,1,2190,0,1964
3211000190,310000,3,1.75,1490,9120,1,1490,0,1959
6354000050,615000,3,2.25,2530,45234,2,2530,0,1985
0625049153,605000,3,2,2060,4040,1,1120,940,1947
5561000190,437500,3,2.25,1970,35100,2,1970,0,1977
4449800595,545000,3,1.75,1400,4000,1.5,1400,0,1925
1115750190,770000,3,2.5,3680,35617,1,2390,1290,1985
8644300170,600000,5,2.25,3000,13899,2,3000,0,1975
9523102660,560000,3,1,1440,5000,2,1440,0,1910
1630700380,1.92e+006,5,5.75,7730,230868,2,6660,1070,2004
7588700007,457000,3,1,1170,3348,1.5,1170,0,1924
3501600235,585000,2,1,1770,8640,1.5,1520,250,1949
9545230280,560000,3,2,1860,13374,1,1860,0,1985
7905200130,345000,2,1,770,3008,1,770,0,1917
2742100250,550000,4,3.5,3820,17745,2,2440,1380,1955
5104540500,589950,4,2.5,3190,8195,2,3190,0,2006
0638100073,327000,3,1.5,1320,13200,1,1320,0,1970
3022039071,800000,2,2.25,1730,31491,2,1730,0,1947
3426079024,150000,3,1,1010,25000,1,1010,0,1966
2767604254,425000,2,2.5,1140,1182,3,1140,0,2007
1138010170,350000,3,1,860,7030,1,860,0,1973
9407100500,273000,3,1.75,1540,10545,2,1540,0,1978
0191100250,750000,4,2.25,2160,9525,1,1080,1080,1961
1557000190,240000,3,1.5,1450,9477,1,1450,0,1963
8732020670,400000,3,1.75,1830,9620,1,1830,0,1978
5029450290,230000,3,1.5,1630,6625,1,980,650,1980
8035600290,372000,4,2.5,2500,8215,2,2500,0,1990
6450301835,459500,3,1.75,1470,4950,1,1030,440,1984
6388930420,582000,3,2.5,2380,19860,2,2380,0,1995
2296700470,465000,4,2.5,2170,7700,1,1420,750,1969
1473120190,386000,3,2,2120,7560,1,2120,0,1991
0011200290,546000,3,2.5,1530,3464,2,1530,0,1998
5530000050,278000,3,1.75,2710,9088,1,2060,650,1965
7853220670,540000,3,2.5,2860,8935,2,2860,0,2004
3124089049,529000,4,1.75,2800,90169,2,2800,0,1934
0868000305,554000,4,1,1120,7104,1.5,1120,0,1946
1311200380,210000,3,1,1730,7210,1,1430,300,1963
9197100101,225000,2,1,1010,5408,1,1010,0,1926
6646200280,561600,4,2.5,2350,6624,2,2350,0,1990
7116500920,300000,6,5.25,2860,5682,2,2860,0,1978
1068000255,1.65e+006,4,3.5,4285,9567,2,3485,800,1946
1240700170,1.0171e+006,4,3.75,4060,19290,2,4060,0,2002
4031000250,150000,3,1,1310,9612,1,960,350,1962
7625703260,400950,2,1.75,2320,6250,1,1400,920,1948
8651580660,620000,4,2.25,2210,8101,2,2210,0,1985
6117500980,449000,4,2.75,2090,14141,1.5,1680,410,1941
9547205380,630000,4,2.5,2240,4025,1,1250,990,1926
0414100280,336000,2,1,1180,7200,1,1180,0,1949
0321059091,299950,4,1.75,1560,31299,1,1560,0,1965
7772000010,352500,4,2,1970,7451,1,1350,620,1962
0007200179,150000,2,1,840,12750,1,840,0,1925
0007200179,175000,2,1,840,12750,1,840,0,1925
8029500380,305000,3,2,1830,10873,1,1830,0,1989
0825059178,2.574e+006,4,3.75,4475,20424,2,2659,1816,1999
6021502750,607500,3,1.5,1800,4700,1,1200,600,1941
9268200380,505000,2,1,1250,5040,1,950,300,1920
2008000420,280500,3,1.75,2440,10179,1,1220,1220,1962
8914100170,610000,3,2.5,2910,12283,2,2910,0,1993
6654700250,381000,5,2.75,3060,6895,2,3060,0,2003
6139800430,482000,5,2.25,2230,9600,1,1320,910,1978
9477201470,379950,3,1,1270,6900,1,1270,0,1977
3025300095,2.5e+006,4,4.5,4300,19844,2,4300,0,1985
3211290050,425000,3,2.25,1580,39189,1,1180,400,1992
7511200190,580000,4,2.25,2570,36465,2,2570,0,1980
5739601300,605000,2,1,860,6510,1,860,0,1952
3278602660,194000,1,1,820,1060,1,760,60,2007
8078410250,546200,4,2.25,2090,8579,2,2090,0,1987
2798000020,1.395e+006,4,3.5,3560,16782,2,2560,1000,2014
2739200050,315000,3,1.75,1860,9629,1,1240,620,1961
9278200095,465000,3,1.5,900,8690,1.5,900,0,1941
3222079120,330000,2,1,1160,32251,1,580,580,1963
4401200010,795000,4,2.75,3100,7501,2,3100,0,1998
2473250280,265000,4,2.25,2300,9100,1,1280,1020,1977
4441300170,1.3e+006,4,2.5,3110,11857,2,2040,1070,1990
0723049530,126500,3,1,1130,12212,1,1130,0,1942
6752510010,760000,4,2.5,2920,7901,2,2920,0,2004
0955000430,540000,2,1.25,1230,1569,2,1050,180,2009
8663100050,446000,5,2.75,2190,12687,1,1370,820,1978
0226109056,170000,1,0.75,850,5600,1,850,0,1903
2558600130,379000,3,2.5,1500,7420,1,1000,500,1972
8823900290,1.4e+006,9,4,4620,5508,2.5,3870,750,1915
8691400080,800000,4,2.75,3150,7035,2,3150,0,2004
0621069102,260000,3,1,1300,10139,1,1300,0,1962
5456000280,820000,5,2.5,3160,8000,1,1580,1580,1960
2891400380,449950,3,1.75,2070,96703,1,2070,0,1999
2297400020,392000,3,2.25,1790,7125,1,1220,570,1974
7215721350,465000,3,2.5,1650,4636,2,1650,0,1999
5490210670,449950,4,2.5,2070,7312,1,1230,840,1977
6431500122,520000,3,1.5,1580,8841,1.5,1180,400,1923
3376600170,546800,4,2.25,2170,10000,1,1420,750,1975
8861000235,825000,4,2.75,2220,11925,1,1560,660,1953
2881700231,337000,3,1.75,1440,11364,1,1440,0,1985
0534000080,333000,2,1,720,6686,1,720,0,1942
6371000020,380000,2,2,1120,780,2,760,360,2004
7212651440,280000,3,2.5,1970,8426,2,1970,0,1992
7575500080,202000,3,1.5,1420,9081,1,1420,0,1990
7197800020,585000,4,2.5,2250,4119,2,2250,0,2001
5592900285,435000,4,2,2630,9663,1,1330,1300,1956
0525069127,1.2e+006,4,3.5,4740,172497,2,4740,0,2003
2460900010,364000,2,2.25,1280,2574,2,1280,0,1992
1566100595,300000,3,1,1260,8280,1,1260,0,1946
8682291680,558000,2,1.75,1930,4601,1,1930,0,2006
7841300285,199950,1,1.5,1048,4800,1,1048,0,1942
6071700020,515000,3,2.25,1640,8400,1,1640,0,1962
4315700275,590000,4,2.5,2380,4950,2,2380,0,2004
2330000130,813500,4,2,2530,15520,1,2220,310,1964
1246700103,725000,4,2.5,2700,25870,2,2700,0,1992
7504200250,490000,3,2.25,2330,3600,1.5,2330,0,1971
3797310010,277000,3,2.25,2160,9612,2,2160,0,1994
4058000010,325000,4,1.5,1470,70800,1,1470,0,1976
3888100022,649800,4,2.5,2280,9827,2,2280,0,1995
1934800022,425000,3,1,1280,3200,1.5,1280,0,1903
3501100280,460000,2,1,850,4650,1,850,0,1975
2725069108,750000,3,3.25,4610,81935,2,4610,0,1984
0126039413,469000,5,2.5,2690,11745,1,1790,900,1960
0461001435,566000,4,1.75,2440,5000,1,1340,1100,1954
6403500290,407500,3,2.5,1930,10460,2,1930,0,1996
2826049108,353500,2,1,800,8775,1,800,0,1942
1823069102,524000,3,2.25,2430,73151,1,2430,0,1974
4233400280,264950,4,2.5,1990,9656,2,1990,0,1994
1088800470,547500,3,2.5,2550,10355,2,2550,0,1990
2025701060,264500,3,2.25,1370,7087,2,1370,0,1993
7922900250,507500,3,2,2020,8118,1,1020,1000,1963
6372000280,560000,3,3.5,1560,2198,2,1180,380,2006
1424130050,995000,5,4,5610,22529,2,4090,1520,1996
7942601435,835000,6,2,3560,5120,2.5,3560,0,1900
3959401284,440000,3,1.5,2120,6290,1,1220,900,1949
1370802335,1.015e+006,3,2.5,2920,5629,1,1460,1460,1955
4058801680,300000,2,1,1340,7788,1,1340,0,1947
3501100050,125000,3,1,1230,4800,1.5,1230,0,1916
1231000895,986000,4,3.5,2840,5900,2,1920,920,1910
7129300500,315000,4,2.5,2080,5650,1,1680,400,1950
6752600050,320000,4,2.5,2070,7007,2,2070,0,1996
3303990380,972000,4,3.25,4010,13797,2,4010,0,2003
2579500006,760000,3,2.5,2190,10000,1,1540,650,1957
3365900462,265000,4,3,1730,7264,2,1730,0,1920
2695600130,355000,2,1,1250,4558,1,1250,0,1948
3438501700,300000,3,1,1300,20812,1,1300,0,1927
3876311350,474950,5,2.5,2080,8347,1,1460,620,1975
4046710050,470000,4,2,2180,17180,2,2180,0,1977
1725059259,437500,3,1,1630,16393,1,1630,0,1969
7518503220,520000,2,1.5,1840,3825,1,1040,800,1928
3445000005,237600,2,1,1370,11584,1,1370,0,1950
3530420020,162950,2,1,950,2784,1,950,0,1972
6893300290,457000,3,1.75,1690,6375,1,1690,0,1903
7856560480,635000,3,2.5,1780,11000,1,1210,570,1980
8121100415,735000,4,3,2840,4120,1.5,2060,780,1931
3754501060,910000,2,2.5,2000,5150,2,2000,0,1992
3278602040,346500,3,3.25,1570,2048,2,1290,280,2006
1592000050,655000,4,2.5,2370,9517,1,1630,740,1984
1324079007,425000,3,1.75,1610,144619,1,1610,0,1977
7140600225,137000,3,1,1300,10125,1,1300,0,1959
0200500680,557500,3,2.5,2620,11056,2,2620,0,1988
0421079142,415000,4,2.25,3060,48787,2,3060,0,1992
9346700280,830000,5,2.25,2780,10192,2,2780,0,1978
0293800680,949000,4,3,4270,85643,2,4270,0,1991
0339600190,420000,3,1,1310,3963,1,1310,0,1986
1787600190,353000,2,1,1100,7500,1,1100,0,1951
2026079016,560000,3,1.75,1480,383328,1.5,1480,0,1980
8673400086,445700,3,2.5,1270,1180,3,1270,0,2001
2760200050,226000,4,1,1270,6459,1.5,1270,0,1918
3205000050,358000,3,1,890,9870,1,890,0,1960
2201500680,501000,3,1.75,1480,8667,1,740,740,1954
4022902555,609000,4,2.5,3240,23870,1,1840,1400,1972
3410600080,734950,4,3.25,4280,47179,2,3050,1230,2002
7385300020,725000,5,2.5,3210,12000,1,1830,1380,1968
3876312570,350500,3,2.25,1870,7200,1,1390,480,1975
5016002275,610000,5,2.5,3990,3839,1,1990,2000,1962
3213200250,605125,2,1,1160,5029,1,910,250,1940
6448000010,1.388e+006,4,2.25,2940,20384,2,2940,0,1970
1330900050,550000,3,2.25,1850,37264,2,1850,0,1981
2810600022,335000,2,1.75,1060,1202,2,760,300,2003
1761600050,397000,3,2,1100,9165,1,1100,0,1969
4233400480,240000,3,2,1190,10299,1,1190,0,1994
4222310680,240000,3,2,1030,11118,1,1030,0,1970
5630500005,262500,2,1.5,1140,14373,1,1140,0,1949
9523102040,440000,3,1.5,2260,5300,1,1200,1060,1940
2626119028,160000,3,1,1140,3240,1.5,1140,0,1910
5015001680,427000,4,1,1860,4736,1.5,1860,0,1901
7202360430,920000,4,3.5,4080,10666,2,4080,0,2005
3880900170,2.3e+006,4,2.5,3280,7100,2,2180,1100,1911
0926069142,480000,4,2.5,2870,35757,2,2870,0,1977
2790410250,615000,4,1.75,2300,11700,1,1960,340,1977
6681500080,736500,3,2,2230,4800,1.5,1290,940,1915
9274201809,542500,3,2.5,1920,1649,2.5,1600,320,2004
0418000415,191000,2,1,700,5000,1,700,0,1952
8078460050,730000,4,2.5,2740,11975,2,2740,0,1991
7151700585,1.225e+006,5,2.25,3440,5000,2,3440,0,1901
2722059292,129000,1,1,650,15364,1,650,0,1967
2223059099,284000,3,1.5,1500,10018,1,1500,0,1957
1703050500,645000,3,2.5,2490,5978,2,2490,0,2003
6386600130,218000,3,1.5,1330,7600,1,1330,0,1968
9194102188,675000,4,3.5,3190,6875,2,2120,1070,1999
2464400285,575000,3,2.5,1590,2910,2,1110,480,1984
6450301310,225000,2,1,830,5720,1,830,0,1950
7427800080,626000,3,2.25,1810,5107,2,1810,0,1989
0040000669,499950,4,2.5,2910,20067,2,2910,0,2001
5538300225,405000,4,1.75,2180,13529,1,1090,1090,1956
4239400840,152500,3,1,1090,3523,1,1090,0,1969
8035650500,325000,4,2.5,2160,6825,2,2160,0,1994
3888100029,475300,3,1,2110,10005,1,1110,1000,1924
4364700585,485000,3,1.75,2180,7318,1,1210,970,1967
9839300285,720000,3,2.5,2100,2200,2,1500,600,1919
6141100380,465000,3,1.75,1410,6886,1,1410,0,1924
5652601330,489000,3,1.5,1020,9072,1,920,100,1930
3025059093,3.1e+006,5,5.25,5090,23669,2,5090,0,2006
5466700290,288000,3,2.25,2090,7500,1,1280,810,1977
5437800020,225000,3,1.75,1350,9793,1,1350,0,1968
7784400185,499000,3,1.75,2650,11774,1,2240,410,1952
5561301150,632000,5,3,3520,36558,2,2100,1420,1985
1523550480,580000,3,2.5,2040,4627,2,2040,0,1992
8083400066,730000,4,1.5,2340,5000,2,2100,240,1912
3797710020,325000,4,2.25,1770,7799,2,1770,0,1998
3205200480,421000,3,1.75,1100,8662,1,1100,0,1964
0869700050,316000,3,2.5,1490,4078,2,1490,0,1998
2877101310,415000,2,1,1460,4200,1,880,580,1914
7202330280,401000,3,2.25,1350,2839,2,1350,0,2003
6146600420,229950,3,0.75,1030,12700,1,1030,0,1944
8563030500,539950,3,1.75,1820,9875,1,1820,0,1966
3624039150,335000,3,2,1170,5360,1,1170,0,1919
7853210050,339000,3,2.5,1450,3748,2,1450,0,2004
3293700480,414950,4,1.75,2200,8545,1,1100,1100,1918
3210700170,650000,4,2,1610,8976,1,1610,0,1966
8161020050,445000,3,2.5,2690,21883,2,2690,0,1994
8731983340,295000,3,2.25,1850,7800,2,1850,0,1974
7871500280,975000,4,2.25,2250,3600,2,2010,240,1912
3276200280,296500,3,1.5,1580,10100,1,1580,0,1961
0826069180,440000,4,2.75,2030,56192,1,1550,480,1979
3955800080,420000,5,1.5,1890,10880,1,1890,0,1962
1657310170,302000,3,2.5,2140,9492,2,2140,0,1994
2597690050,350000,4,1.75,1770,7336,1,1770,0,1986
0720079001,667000,3,1.75,3320,478288,1.5,2260,1060,1933
3975400185,645000,3,2,1640,4218,1,910,730,1941
3342101795,430000,4,2.75,1820,5400,1,1220,600,1988
9297301190,413000,4,1,1410,6000,1,810,600,1925
7424100050,420000,3,1,1240,7300,1,1240,0,1968
7199340480,495000,3,2.25,1780,8050,1,1230,550,1979
2525049259,2.18773e+006,4,4.5,4240,13162,2,4240,0,2004
8835700250,965000,4,2.5,3570,17411,2,3570,0,1990
6150700005,500000,4,2.5,1900,5001,1,1200,700,2008
6819100080,636100,3,1,1010,6000,1.5,1010,0,1919
3904902630,720000,4,2.5,2870,12648,2,2870,0,1986
5152200020,298000,3,1.75,1620,12825,1,1340,280,1962
3300701440,409000,2,1.75,1480,4000,1,740,740,1925
1152700020,370000,4,2.5,2650,5706,2,2650,0,2005
8944300010,230000,5,1,1410,9000,1,1410,0,1967
8680300010,290000,3,2,1360,6685,1,1360,0,1952
8731950080,420000,4,2.25,2930,9840,1,1560,1370,1977
5608000080,917000,4,2.5,3500,10891,2,3500,0,1995
2225039130,957000,5,3.25,3160,5000,2,2180,980,2005
7504180130,482000,3,2.25,1710,21485,2,1710,0,1989
3956100190,488000,3,1.75,2180,14734,2,2180,0,1990
2346200050,760369,5,2.5,2870,4712,2,2870,0,2014
0040000471,170000,2,1,1500,18540,1,1500,0,1950
9346950050,625000,3,2.5,2120,10021,1,1230,890,1976
9477201150,357000,3,1.5,1590,6750,1,1080,510,1976
8078430130,583000,3,2.25,1830,8276,1,1350,480,1989
6404600006,173250,3,2,1210,9097,1,1210,0,1954
6415100122,414050,4,2,1590,10331,1.5,1590,0,1956
5505700020,400000,3,1.75,1050,6150,1.5,950,100,1928
1117300050,537000,3,2,1550,27003,1.5,1550,0,1982
8651710430,465000,4,2.25,2070,7500,2,2070,0,1977
9292000380,425000,3,2.25,1740,9682,1,1740,0,1969
2525059127,445000,4,2,1700,21780,1,1080,620,1940
1788300010,179950,2,1,1200,9000,1,1200,0,1958
1150700130,275000,3,2.5,1710,7230,2,1710,0,1996
3354400545,190000,4,2.5,1840,13493,2,1840,0,1994
2742100009,385000,3,1.75,1900,5520,1,1280,620,1982
2475900170,303000,4,1,2300,9583,1,1220,1080,1928
9189700255,165000,3,1,970,7503,1,970,0,1967
2769600480,600000,2,2,1270,5000,1,1270,0,1944
2260800170,710000,3,2.25,3130,65775,2,3130,0,1978
1118500010,875000,5,3.25,4230,21455,2,2720,1510,1990
5636010280,269950,3,2.5,1480,9743,2,1480,0,1996
2326059099,838000,4,2.5,3310,42998,2,3310,0,2001
4423100095,670500,4,2,1590,6750,1,1590,0,1951
8142000080,420000,4,1.5,1690,9391,1,1290,400,1960
3222059007,370000,3,1.5,1690,161913,1,1430,260,1952
6648000050,360000,3,1.75,1500,7200,1,1500,0,1957
3574900170,562500,4,2.5,2320,8721,2,2320,0,1991
2008000130,360500,3,2.5,3300,11525,1,1650,1650,1961
0291300010,389999,3,2.25,1445,1471,2,1300,145,2003
9412200280,450000,4,3,1890,13140,1,1270,620,1967
9315000010,247500,4,2,1760,8400,1,1060,700,1962
7889600080,208000,3,1,1050,6240,1,1050,0,1948
8663310010,455000,3,2.5,1980,7309,2,1980,0,1993
0930000305,379400,4,1.75,2120,7680,1,1060,1060,1950
7606200275,190000,3,1.5,760,40039,1,760,0,1906
0203900380,326188,3,1,1300,8800,1,1300,0,1977
0880000005,168000,2,2.5,1160,2174,2,1160,0,1998
9406570290,314000,4,2.5,2340,8990,2,2340,0,2003
5561000920,630000,4,2.75,2710,37277,2,2710,0,2000
4037000470,550000,3,1.75,1440,8957,1,1440,0,1957
8651511060,530000,4,2.25,1980,15086,2,1980,0,1981
9413600010,637500,3,1.75,1680,10685,1,1680,0,1966
9358001732,400000,3,2.5,1390,2815,2,1390,0,1999
8820900029,700000,5,2.75,3100,9825,2,3100,0,1950
6802200670,272000,3,2.5,1680,8512,2,1680,0,1991
7852190630,600000,4,2.5,2710,6474,2,2710,0,2004
2815600235,450600,2,1,840,7020,1.5,840,0,1943
3013300660,550000,3,2.25,2090,8095,2,2090,0,1988
8091600080,225000,3,1,1120,8407,1,1120,0,1987
8651402750,132825,3,1.5,1210,5200,1,1210,0,1969
8651402750,219950,3,1.5,1210,5200,1,1210,0,1969
2215500080,580000,5,2,1940,6000,1,970,970,1945
0225069016,568000,3,1.75,1930,213008,1,1300,630,1980
0766900250,406000,3,1.75,1270,6017,1,1030,240,1990
2922703260,469000,3,1.75,1680,2400,1.5,1170,510,1929
8011100095,415000,3,2.5,2090,6045,2,2090,0,2000
2206700280,390000,3,1.5,1000,13991,1,1000,0,1956
7985000010,251000,3,1.75,1350,10125,1,1350,0,1967
1504800050,750000,3,2.5,3280,6750,2,2440,840,2001
5351200280,845000,4,2.5,2390,5071,2,1760,630,1988
7229900005,350000,3,1.5,1860,17640,1,1860,0,1966
3126049217,322000,3,1,1380,5864,1,790,590,1944
7446500010,664500,4,2.25,3070,9210,2,2740,330,2010
2721600010,988000,3,1.75,2190,3800,1.5,2190,0,1923
3392900080,625000,2,1.75,1990,4000,1,1090,900,1952
1524059027,675000,2,1,930,36478,1,930,0,1951
9414500480,503000,3,1.75,2070,9827,1,1420,650,1967
8576400050,431000,4,2.25,2170,10500,1,1270,900,1960
5252000170,250000,3,1.75,1910,10230,1,1290,620,1964
2676500080,268500,4,2.5,2100,4237,2,2100,0,2006
3585900080,1.07e+006,6,3.25,3560,21400,2,3560,0,1952
5126900321,295000,4,2.5,2290,4539,2,2290,0,2001
8563500020,780000,3,2.25,2130,11782,1,1590,540,1977
6624030050,354000,3,2.5,2160,15817,2,2160,0,1999
4343800080,305000,2,1,860,7250,1,860,0,1949
1873100050,733000,5,2.75,2880,4425,2,2880,0,2005
3210700380,640000,4,2.75,2100,11894,1,1720,380,1968
4099500605,840000,4,2.5,2360,9600,1,1630,730,1973
4217401365,1.475e+006,5,3.25,3680,10300,1.5,3680,0,1927
0923000095,525000,3,1,1560,8100,1,1140,420,1952
1828000050,625000,4,2.75,1680,11180,1,1680,0,1966
9126100346,350000,3,2,1380,3600,3,1380,0,2015
2919201365,650000,4,2.75,2610,4160,3,1910,700,1910
9297300500,435000,2,1,870,4000,1,870,0,1950
6073200010,660000,3,1,1210,9622,1,1210,0,1955
8807810660,350000,3,1,1150,12877,1,1150,0,1970
2112700185,435000,3,2.5,3110,6000,1,1560,1550,1967
1789800020,375900,6,1.5,2550,33740,1,1750,800,1958
3275300050,272000,3,3,2430,10500,1,2150,280,1983
3279000420,233000,3,1.75,1460,7800,1,1040,420,1979
0952001660,500000,4,1.5,1330,5750,1.5,1330,0,1915
4023500362,540000,4,1.75,2040,9322,1,1440,600,1977
9510910050,712000,3,2.5,2375,4094,2,2375,0,2002
1137400050,425000,4,2.5,2480,4504,2,2480,0,2005
8864000425,242000,3,1.75,1580,6099,1,790,790,1944
5518800010,515000,5,3.25,2740,9629,1,1390,1350,1977
3204800430,415000,4,1.75,1920,7700,2,1920,0,1970
5152960080,375000,3,2.75,2200,9600,1,1570,630,1977
7696500280,182500,3,1,910,7194,1,910,0,1971
8643000190,310000,3,1.5,1860,10379,1,1240,620,1963
7625701045,360000,3,1.75,1510,6000,1,1060,450,1947
7202360670,889000,4,3.5,3920,9555,2,3920,0,2004
4305700086,450500,2,1,1330,3698,1,1330,0,1952
0731500170,342000,4,2.25,1964,3541,2,1964,0,2013
5096300130,413000,3,2,1520,3451,1,1520,0,1996
1441600020,960000,5,4,3720,15200,2,3720,0,2005
6163900073,180000,2,1,770,9370,1,770,0,1947
5581400080,770000,4,2.5,3210,14910,2,3210,0,1995
8100000080,224400,3,1.75,1070,7200,1,1070,0,1994
5379806590,280000,3,1.5,1430,8861,1,1430,0,1956
9286100250,500000,3,2.5,1670,2575,2,1670,0,2000
4337600005,153000,2,1,710,9000,1,710,0,1943
3645100280,385000,3,2.25,1920,4833,1,1060,860,1921
6170900190,325000,2,1,750,5534,1,750,0,1947
8581400345,315000,4,3,2210,4191,2,2210,0,2004
4345300050,294999,4,2.5,1660,9760,2,1660,0,1994
6143000020,175000,3,1.75,1910,17003,1.5,1910,0,1963
6143000020,299000,3,1.75,1910,17003,1.5,1910,0,1963
0111000190,146000,2,1,780,9750,1,780,0,1937
5306100255,290000,3,2.25,1650,10336,1,1500,150,1962
1370803180,1.776e+006,3,3.25,3230,7800,2,3230,0,2005
5249803745,367500,2,1,810,4800,1,810,0,1919
2787250080,535000,4,2.5,2750,15099,2,2750,0,1994
8656300345,334999,3,2.5,1650,13816,2,1650,0,1998
0582000185,655000,3,1.75,1960,5520,1,1080,880,1952
0191100235,1.298e+006,4,3.5,2790,10125,1.5,2790,0,1985
6662410250,480000,4,2.25,2230,11200,1,1300,930,1977
1053000010,465000,3,1.5,1280,4720,1,850,430,1941
2473100635,297950,3,2,1240,10800,1,1240,0,1967
7960100050,590000,3,2,1860,3600,1.5,1110,750,1915
1177000130,805000,4,2.75,2410,6000,1,1410,1000,1950
8732160250,204250,3,2.25,1960,7708,1,1490,470,1984
3905100630,500000,3,2.25,1710,4561,2,1710,0,1994
5469501410,490000,4,2.5,3480,12696,1,1980,1500,1977
4107100190,2.5e+006,4,3.75,3480,14850,1,1870,1610,1951
5215200050,750000,3,2.5,2960,69351,2,2960,0,1990
4027700006,405000,4,2.5,2670,20894,2,2330,340,2002
0421000500,209995,2,1,700,7303,1,700,0,1953
0305010190,680000,4,2.5,2830,8399,2,2830,0,1998
0751000190,355000,3,1.75,1120,7740,1,860,260,1948
1446400715,280000,2,1,1310,6600,1,1310,0,1942
4027701284,385000,3,2.25,1710,11500,1,1210,500,1978
6072000380,505000,4,2.75,2200,9778,1,1100,1100,1962
7212651100,429900,4,3.25,3310,8897,2,2380,930,1991
6977000080,560000,4,2.5,2280,9874,2,2280,0,1989
8651440780,231000,3,2,1640,4875,1,1040,600,1977
3298701025,135000,2,1,750,5217,1,750,0,1943
0475000605,800000,4,3,3520,4895,1,1980,1540,1954
1023059430,420000,3,2.5,2720,8622,2,2720,0,2002
3760000020,360000,3,1,1660,9600,1,1660,0,1963
3905090080,642000,4,2.5,2560,8780,2,2560,0,1992
0339600290,379950,3,2,1080,5077,1,1080,0,1985
9542400010,745000,3,1.75,2050,11041,1.5,2050,0,1959
1498303895,630000,4,2,2670,3240,1.5,1780,890,1930
0739820050,250000,3,2.5,1730,7200,2,1730,0,1985
9238450430,275000,3,1,990,9798,1,990,0,1968
3336000050,435000,6,3,3560,4290,1,1780,1780,1957
5269200050,175000,2,1,700,8174,1,700,0,1941
1982200430,560000,4,1.75,1880,3880,1.5,1090,790,1944
3763300005,325000,4,2.25,1870,9680,1,1170,700,1959
1336800185,1.185e+006,3,2.75,2500,5568,2,2500,0,1905
1561910190,399950,3,2.5,2570,10431,2,2570,0,1989
5415350480,752000,4,2.5,2940,10382,2,2940,0,1991
1126059108,1.2e+006,4,3.5,3930,43560,2,3930,0,2003
3818700185,400000,4,1.5,2150,11026,1,2150,0,1952
7883601155,240000,3,2,1330,6000,1,630,700,1900
7559600430,640000,5,2.5,3220,4759,2,3220,0,2003
3449820380,564450,3,2.5,2710,6174,2,2710,0,1998
1523069022,300000,3,1.5,1630,82764,1,1630,0,1948
7569450480,286000,3,2.5,1680,4226,2,1680,0,2003
7202340190,531800,3,2.5,1930,5344,2,1930,0,2004
8651710190,502000,4,2.25,2140,10943,1,1550,590,1977
5450900010,993500,4,2.25,4070,23321,2,4070,0,1968
2201500980,450000,3,1,1350,10000,1,1350,0,1954
2624079028,997950,4,3.5,4270,117176,2,4270,0,2008
3095000185,526000,3,1,1320,5250,1.5,1320,0,1913
4476400275,335000,3,1.75,2100,8298,1,1230,870,1952
8018600980,187250,2,1,710,14700,1,710,0,1926
7173700591,735000,3,2.25,2350,6000,1,1020,1330,1948
2568800290,425000,3,1,1180,8400,1,1180,0,1951
5111400086,110000,3,1,1250,53143,1,1250,0,1945
1079350020,305000,3,2,1490,7697,1,1490,0,1994
0088000591,212000,3,1,1000,9450,1,1000,0,1962
2524049108,1.38e+006,5,4.25,4050,18827,1,2150,1900,1979
1552800280,298950,5,2.25,2300,11505,1,1300,1000,1963
2423020010,525000,3,1.75,1330,8136,1,1330,0,1977
0629410130,707000,4,3.25,3200,7081,2,3200,0,2004
4139440480,695000,3,2.75,2590,12063,2,2590,0,1993
4139440480,796500,3,2.75,2590,12063,2,2590,0,1993
7016300050,420000,4,2.5,2030,8100,1,1150,880,1973
3425059099,625000,5,2.5,2700,21208,1,1950,750,1955
9541600280,620000,3,1.75,1670,9900,1,1670,0,1957
3025300225,1.45e+006,5,2.75,3090,19865,1,3090,0,1953
7214770020,549950,5,2.5,2650,54380,2,2650,0,1984
7227801630,275000,4,2,1440,10920,1,1440,0,1943
7284900098,705000,3,2.5,2820,7200,1,1780,1040,1979
7696630080,197000,3,1.75,1690,7735,1,1060,630,1976
3235390010,265000,3,1.75,1420,8126,1,1420,0,1991
2966800010,297000,4,1.75,1790,5341,1,1050,740,1951
6600410290,207500,3,1.75,1320,12528,1,1320,0,1970
6300500479,410000,3,2.5,1509,1418,3,1509,0,2014
1450900020,268000,3,2,1610,8416,1,1610,0,1994
1284000010,330000,4,1.75,1550,50094,1,1550,0,1967
3626039028,417500,3,1,1160,7491,1,1160,0,1917
7856560380,760000,4,2.25,2500,8500,2,2500,0,1979
2770604346,499000,3,2.5,1540,1326,3,1390,150,1995
9202650130,620000,4,2.5,1910,7683,2,1910,0,1987
8700100010,315000,3,2.5,2340,6837,2,2340,0,1992
4045750010,624950,3,2.5,2060,4730,2,2060,0,1994
5706201470,525000,3,2.25,1960,12350,1,1960,0,1961
8835210130,300000,2,1.5,1150,3927,2,1150,0,1982
8731990440,299900,4,2.75,2330,7200,1,1560,770,1977
5540000050,299000,3,2.5,2210,10119,1,1450,760,1966
2470200020,1.88e+006,4,2.75,3260,19542,1,2170,1090,1968
9500900430,265000,4,1.75,1900,10588,1,1900,0,1958
3024089049,280000,2,1.75,1610,158558,1.5,1610,0,1948
6600410170,124740,3,1,1340,15600,1,1340,0,1978
7796000095,1.085e+006,3,2.75,3170,34850,1,3170,0,1957
1338600225,1.97e+006,8,3.5,4440,6480,2,3140,1300,1959
0316000190,219000,4,1,1370,5339,1.5,1370,0,1948
9276200190,569950,5,1,1420,6250,1.5,1420,0,1926
1447600285,212500,2,2,1030,21712,1,1030,0,1938
5307100280,680000,3,2.25,1820,8316,1,1320,500,1960
1338800280,1.457e+006,4,1.5,2650,6900,2,2400,250,1909
3211200420,300000,3,1,910,7700,1,910,0,1971
2770604082,629950,3,2.5,1680,1683,2,1120,560,2014
7334600280,349900,2,1.75,1550,9230,1,970,580,1969
5406500440,690000,4,2.5,2780,6235,2,2780,0,2001
1235100328,1.454e+006,5,4,4070,11334,2,4070,0,2014
4141010050,1.288e+006,3,2.5,3240,12625,2,3240,0,1987
9510310280,696000,4,3.5,3650,38546,2,2550,1100,1996
0725069102,650000,3,2.25,2180,60112,2,2180,0,1976
8562901350,640000,3,3.5,2480,10800,2,2480,0,1998
1442700430,499950,5,2.5,3180,23809,1,3180,0,1978
6806300980,490000,4,2.5,3630,8387,2,3630,0,1997
8562740290,685000,5,2.5,3160,5635,2,3160,0,2003
7454001405,387500,4,1,1370,7140,2,1370,0,1942
0952007141,401750,2,1.5,1070,1236,2,1000,70,2005
1545806720,254950,4,2,2180,8800,1,1170,1010,1977
5561300980,500000,4,2.25,2420,36680,2,2420,0,1977
9348700480,856500,4,2.5,3290,8147,2,3290,0,2003
1868900285,552000,3,1,1430,5000,1,1080,350,1919
8651720470,506500,4,2.5,1890,7200,1,1500,390,1978
3904950190,500000,3,2.25,1760,4539,2,1760,0,1988
5300200050,280000,4,2.75,2230,10160,1,1400,830,1968
7334501300,308000,3,1.75,1630,11475,1,1330,300,1979
8078350280,613500,3,2.5,2350,7035,2,2350,0,1989
4068300280,255000,3,1.75,1550,9720,1,1050,500,1976
2625079030,545000,3,2.5,3550,136343,2,3550,0,1977
1024069063,620000,4,2.5,2720,34498,1,1360,1360,1966
3624039102,450000,3,1.75,1740,6800,1.5,1740,0,1949
8025700460,279000,4,1.75,1840,7275,1,1090,750,1976
8956000460,625000,3,2.5,2010,3200,2,2010,0,2009
2329800630,274950,3,1.75,1670,7415,1,1320,350,1987
2491200050,423000,3,1.75,1820,6038,1,1040,780,1952
6181700250,350000,2,1,720,5820,1,720,0,1950
2460500020,305000,4,1.75,2370,10140,1,1460,910,1968
7893801760,368000,3,1.75,2120,11340,1,1060,1060,1966
5259800440,232000,3,1.75,1290,6604,1,1290,0,1984
7338402850,250000,4,3,1800,2500,2,1800,0,2000
1423910130,220000,3,1.75,1230,8917,1,1230,0,1966
2769602135,435000,3,2,1380,2500,1,750,630,1986
4365200425,350000,2,1,740,7680,1,740,0,1922
2473380920,206325,5,2.5,1720,10202,1.5,1720,0,1970
2473380920,339000,5,2.5,1720,10202,1.5,1720,0,1970
2787700630,399000,4,2.5,2100,7355,1,2100,0,1969
6917700305,529000,2,1,1210,7667,1,900,310,1950
7215720420,640000,4,2.5,2210,7722,2,2210,0,1999
2856100250,735000,4,2.5,2470,2550,3,2470,0,2004
9421500130,378000,5,2.5,2760,8015,1,1600,1160,1960
1250201640,775000,3,2,2540,7200,1.5,1600,940,1905
5316100920,2.25e+006,3,4.25,5150,7800,2.5,4170,980,1954
6813600605,1.35e+006,4,4.5,3420,7440,3,3420,0,2014
1974300020,380000,4,2.5,2270,11500,1,1540,730,1967
1974300020,624900,4,2.5,2270,11500,1,1540,730,1967
3630020380,379770,3,2.5,1470,1779,2,1160,310,2005
1771000290,340000,3,1.75,1280,16200,1,1030,250,1976
5126310470,515500,4,2.75,2830,8126,2,2830,0,2005
1870400605,600000,4,2.25,1970,7125,1.5,1500,470,1908
4047200825,400000,1,1,1390,60984,1,1390,0,1960
7304300430,364000,4,1,1020,11383,1.5,1020,0,1947
8079010190,440000,4,2.5,2250,7526,2,2250,0,1989
1453600182,285000,2,1,800,6240,1,800,0,1954
9828700235,669000,3,1,1560,4500,1.5,1560,0,1915
3448002285,475000,4,2,2100,13468,1,1050,1050,1962
2513500010,747000,2,1,990,4000,1,990,0,1911
9284801100,317000,3,1.5,1060,5750,1,1060,0,1981
8901000491,390000,2,1,1270,8164,1,1270,0,1941
0452002135,1.07e+006,4,2.5,2740,5000,2,2740,0,2012
6610000591,1.205e+006,4,2.75,2470,5500,1,1570,900,1960
7518501025,580000,3,1.75,1970,5100,1,1130,840,1908
6072400470,518000,4,2.5,2070,10244,1,1370,700,1969
1865800250,147500,3,1.75,1010,6552,1,1010,0,1969
6072650250,555000,4,2.25,2220,8125,1,1450,770,1965
8807900233,427500,2,2,1090,934,3,1090,0,2008
3585901025,1.735e+006,3,2.5,4310,32093,1.5,2510,1800,1982
9238440020,265950,3,2.5,1490,3840,2,1490,0,2002
9325800005,247500,2,1,700,6046,1,700,0,1950
7520000020,244000,4,1,1450,8960,1,1450,0,1943
3904920380,578550,3,2.5,2120,6602,2,2120,0,1989
3630080430,451000,4,2.5,1670,3315,2,1670,0,2005
8682262230,489000,2,1.75,1810,4220,2,1810,0,2004
3326079016,190000,2,1,710,1164794,1,710,0,1915
7214800430,475000,3,3,2540,18900,1,1580,960,1978
6430000275,485000,3,2,1420,4080,1.5,1420,0,1905
1924079090,530000,3,2.75,2440,45738,2,1840,600,1987
1509500380,379000,4,2.5,2570,10155,2,2570,0,1994
9809000010,1.629e+006,5,2.5,3090,16583,2,3090,0,1964
8722101100,739000,3,1.75,2050,5160,1.5,1300,750,1926
8651410670,189950,3,1,920,6460,1,920,0,1969
3629830250,637500,4,3,2320,4468,2,2160,160,1999
0868001435,2.225e+006,3,3,3450,16740,1,1960,1490,1949
4168100020,209950,3,1,1660,8800,1,960,700,1963
0814000020,460000,3,1,1130,7000,1,830,300,1944
7852010950,543500,4,2.5,2550,5835,2,2550,0,1998
2395710010,376000,4,2.75,2420,5773,2,2420,0,2005
3630000130,430000,3,2.25,1470,1703,2,1470,0,2005
2105200010,515000,4,2.5,2030,39049,1,1530,500,1953
2856100381,580000,7,2.75,2310,2400,1.5,2310,0,1915
5608030020,600000,5,3.5,3370,16846,2,2650,720,1998
3404700080,476800,3,1.75,1900,43700,1.5,1900,0,1919
1890000275,815000,3,1.5,1940,3570,2,1740,200,1916
7852000010,455600,3,2.5,2420,8252,2,2420,0,1998
5230300280,270000,3,1,1010,9514,1,1010,0,1969
4232902335,1.2e+006,5,4,2710,2800,3,2380,330,1974
4232900250,525000,2,1.5,1340,3600,1.5,1340,0,1903
1312930250,242000,3,1.75,1310,9645,1,1310,0,1979
6446200305,715000,4,2.5,2650,30500,1,1680,970,1960
7852020670,475000,3,2.75,1890,3938,2,1890,0,1999
4475000170,370000,4,3,2580,5511,2,2580,0,1999
7202360170,788600,4,2.75,3500,7200,2,3500,0,2005
6146600185,160000,2,1,1040,13100,1,1040,0,1912
2825079001,800000,5,1.75,1930,501376,2,1930,0,1930
3905040780,520000,4,3,2190,5085,2,2190,0,1992
2488200168,725000,3,1.75,1530,4000,2,1530,0,1985
3336000170,335000,4,1,1480,6500,1.5,1480,0,1914
8835700010,919000,4,2.5,3620,17133,1,2220,1400,1993
0303800020,425000,3,2.75,3370,13929,2,2650,720,1986
3971700670,420000,5,2.5,2100,14395,1,1140,960,1983
2481610050,905000,4,3,3370,47959,2,3370,0,1981
4154304505,435000,2,1,2240,7200,1,1120,1120,1940
7202330170,438000,3,2.5,1650,3031,2,1650,0,2003
9430100020,725000,4,2.75,2630,7505,2,2630,0,1994
2436700280,840000,4,1.75,2330,4000,2,1300,1030,1924
7525211410,425500,3,2.5,1970,2752,2,1970,0,1978
3760500514,853505,3,2.5,2820,14890,1,1770,1050,1985
4067600255,398000,2,1,590,10945,1.5,590,0,1983
7853302130,418500,3,2.5,2060,4399,2,2060,0,2007
0811000050,826000,3,1.5,1890,5000,1.5,1890,0,1929
8691330130,742000,4,2.5,2810,10986,2,2810,0,1997
6623400050,180000,4,1,1470,18581,1.5,1470,0,1924
9542801410,286000,4,1.75,2190,8400,2,2190,0,1978
7202330190,421200,3,2.5,1440,3060,2,1440,0,2003
3303950660,390000,3,3,2480,14141,1,1500,980,1994
4140930010,739000,4,2.5,2780,6737,2,2780,0,2002
2724069169,499900,4,3,2180,12196,2,2180,0,1968
7979900430,670000,3,2.25,3340,13805,1,3340,0,1950
1338300010,842500,3,2.25,2560,3996,1.5,2150,410,1910
5238800020,492500,2,2.25,1600,80400,2,1600,0,1978
4154305575,836500,3,2.5,2230,7200,3,2230,0,1996
6821102385,334000,2,1,900,1818,2,900,0,1945
6600410480,179900,3,1,1010,9920,1,1010,0,1977
4146800050,563000,3,2,1580,5289,1,870,710,1940
3793500050,310000,3,2.5,1890,6300,2,1890,0,2003
0641900050,335000,4,2.25,2160,8817,1,1460,700,1965
0641900050,499950,4,2.25,2160,8817,1,1460,700,1965
2402100715,658500,2,1,1410,5101,1.5,1410,0,1927
1453602313,297000,2,1.5,1430,1650,3,1430,0,1999
1890000225,725000,6,1.75,2380,4080,2,2380,0,1917
7525900050,780000,3,2.25,2206,82031,1,866,1340,1983
6413600290,252500,3,1,1030,6127,1,880,150,1947
0952006728,330000,3,2.5,1070,1155,2,720,350,2005
1088801350,525000,3,2.5,2320,9610,1,1730,590,1990
3575302759,365000,2,1.75,1270,7500,1,1270,0,1982
3508100161,500000,4,3,2570,9104,2,2570,0,1930
8651410190,179950,3,1,920,4875,1,920,0,1969
1823099028,440000,3,2,1790,32379,1,1790,0,2007
0745000005,145000,1,0.75,480,9750,1,480,0,1948
9414700020,331000,4,3,2483,5701,2,2483,0,2005
2331300415,780000,3,2.25,2140,3000,2,2140,0,1905
6815100380,855000,3,1.75,1900,4000,1,1300,600,1965
7575610250,225000,3,2.25,1650,7739,1,1290,360,1986
5153900080,199000,3,1,1510,9100,1,1510,0,1966
7525410190,550000,3,1.75,2910,35200,1.5,2910,0,1979
6819100020,1.425e+006,4,4.25,4960,6000,2.5,3680,1280,1909
1868902745,805000,3,2,2710,4500,1.5,1880,830,1929
3783100080,261000,3,1.5,1810,29308,1,950,860,1983
3327750020,347000,3,1,940,9198,1,940,0,1968
1112700010,390000,3,2.25,1600,10240,1,1090,510,1979
9269260420,436000,4,2.5,2640,3899,2,2640,0,2000
9286730020,1.80275e+006,5,3.25,3890,20005,1,2260,1630,1977
8673400190,557000,3,2.5,1630,1587,3,1630,0,2004
1951600250,135000,3,1,830,9600,1,830,0,1959
3296900280,425000,3,2.5,1800,14036,2,1800,0,1993
5459000305,648752,3,2.25,2060,9953,1,1070,990,1964
4122900020,1.388e+006,4,3,4040,20001,1,2020,2020,1972
5212000020,630100,4,2.75,1910,11356,1,1160,750,1977
1825079005,739000,4,2.5,2800,246114,2,2800,0,1999
6450303235,269000,3,1.5,1320,2625,2,1320,0,1986
7227501190,250000,3,1,1220,5038,1,1220,0,1942
7853300020,475000,5,2.75,3100,5298,2,3100,0,2007
2922703235,290000,1,1,550,5700,1,550,0,1916
6138000095,219000,3,1,1080,10639,1.5,1080,0,1953
2356800020,416000,2,1,880,6650,1,880,0,1918
5379805495,179000,2,1,720,8914,1,720,0,1949
3861440010,302000,4,2.75,2030,9120,1,2030,0,1988
2505500009,565000,4,2,2040,8281,2,2040,0,1961
3388000080,281700,3,1,1570,8316,1,1070,500,1962
0480000170,480000,2,1,1500,3420,1,1500,0,1902
2597650660,775000,4,2.5,3180,15358,2,3180,0,1988
7304300470,375000,3,1.75,1260,11224,1,1260,0,1947
7334600170,345000,3,1.5,1390,13860,2,1390,0,1979
7222000244,300000,3,3,2850,9375,1,2240,610,1977
9558020840,364950,4,2.5,2070,2992,2,2070,0,2002
5592900020,410000,3,3.25,2650,7819,1,1760,890,1956
8732190380,231000,3,1.75,1220,8817,1,1220,0,1978
2249800080,445000,3,2,1630,8702,1,1630,0,1987
2062600020,530000,2,2.5,1785,779,2,1595,190,1975
7660100309,353500,3,2.5,1260,972,2,840,420,2008
6093900280,209950,3,1.5,1380,11130,1,1380,0,1960
4154303125,650000,3,1.75,2330,7200,1,1320,1010,1950
2695600005,325000,2,1,840,4239,1,840,0,1948
3826500020,257000,3,2.25,1730,9516,1,1180,550,1978
9238440130,337000,4,2.5,2230,5970,2,2230,0,2002
3630030010,541000,3,2.5,1790,4038,2,1790,0,2005
1592000130,577500,3,2.5,2280,10879,2,2280,0,1984
2487200279,560000,3,2.5,2430,5128,1,1270,1160,1978
1959703070,979700,5,3,3730,5500,1.5,2160,1570,1927
4038700680,750000,5,3,2230,8560,1,1150,1080,1960
9390700095,407500,2,1,770,2971,1,770,0,1923
6392003810,530000,4,1.75,1814,5000,1,944,870,1951
7806210250,235000,4,1.75,1920,9350,1,1000,920,1977
2919200440,715000,4,2.5,1860,3840,1.5,1170,690,1928
6751500185,795000,5,3,2750,10000,1,1730,1020,1957
5137300130,465000,4,2.5,1930,9653,1,1930,0,1968
2744000010,287600,3,2.5,1950,8251,2,1950,0,1990
4279600010,630000,6,3,2470,9328,2,2470,0,1982
2540830020,445000,3,2.25,1630,6449,1,1310,320,1986
7214800190,490000,4,2.25,2110,16200,1,1630,480,1978
9169100185,565000,3,1.75,1490,5000,1,1250,240,1954
0859000022,330000,3,2.5,1740,1844,2,1320,420,2008
1180005050,463000,4,2.75,1900,6000,1,1300,600,1961
3625700010,1.87e+006,5,4,4510,15175,2,4510,0,1969
7335400020,219500,3,1,1090,6710,1.5,1090,0,1912
8902000050,622200,3,1.75,1720,7200,1,1420,300,1959
1972200698,474800,2,3.25,1400,1243,3,1400,0,2000
0415100010,465000,4,2.5,2090,9702,1,1320,770,1965
5500200010,389950,3,1.75,1580,9049,1,1580,0,1966
1842390130,650000,4,2.5,2620,19864,2,2620,0,1984
6362900007,395000,3,2,1500,2506,1,870,630,2003
5466380050,304500,4,2.5,2030,5202,2,2030,0,2001
7417700185,307000,3,1,1020,8484,1,1020,0,1949
4127000050,485000,3,2.5,1540,7120,1,770,770,1938
8084900170,1.562e+006,5,3,3910,16200,1,2890,1020,1960
2205700470,650500,5,4.25,3920,11412,2,3920,0,1955
3629200020,960000,4,2.5,3180,10105,2,3180,0,1986
6070800050,710000,3,2.5,2330,9160,2,2330,0,1997
6329000185,540000,3,2.5,2600,23361,1.5,2150,450,1912
8815400020,601000,4,1.75,1950,4200,1,1040,910,1951
1742800430,463828,5,1.75,3250,13702,1,1650,1600,1965
5006000170,293000,4,1,1130,8308,1.5,1130,0,1944
7202310010,597500,3,2.5,2620,4800,2,2620,0,2002
0323089005,240000,2,1,1120,45302,1,1120,0,1932
1525079056,284000,3,1.75,1800,23103,1,1800,0,1968
4140900050,440000,4,1.75,2180,10200,1,2000,180,1966
7387500235,340000,3,1.75,1960,8136,1,980,980,1948
7387500235,363000,3,1.75,1960,8136,1,980,980,1948
3726800010,270000,2,1,1150,3600,1,1150,0,1910
2621760290,365000,4,2.5,2800,6820,2,2800,0,1997
6046401300,428000,3,2,1310,2550,1,780,530,1986
3326069026,600000,3,1.75,2340,57499,1,2340,0,1988
6608500290,405000,3,2.5,1430,10200,1,1430,0,1960
1862700290,339900,4,2.5,2340,9748,1,1610,730,1981
4331000190,275000,3,1,1290,11250,1,1290,0,1956
5101400994,361600,2,1,760,6380,1,760,0,1941
1615900020,325000,6,2,2780,13950,2.5,2780,0,1955
2804600005,1.05e+006,3,2,2090,4077,1.5,1530,560,1931
7431500280,959750,4,3,3060,50002,1,2460,600,1957
6303401365,210000,3,1,1110,7962,1,1110,0,1962
2817850290,258000,3,2,1790,7879,1.5,1790,0,1998
3205100080,468000,3,1.5,1830,9848,1,1830,0,1962
2464400280,710000,4,3.5,2850,2910,2,1970,880,1905
7889601300,268000,3,1,1420,6000,1,1420,0,1941
8151600101,115000,2,1,790,7252,1,790,0,1930
3764650010,500000,3,2.5,2300,4307,2,2300,0,1998
3521069150,431000,3,2.5,2440,71002,1,2440,0,1996
4345000440,241500,3,2,1310,7349,1,870,440,1995
1822059073,300000,3,1,1380,12000,1,1380,0,1963
2600130190,982000,4,2.5,2790,10289,2,2790,0,1987
7985100190,248500,3,2.5,1360,7293,2,1360,0,1988
0305010050,665000,4,2.5,2510,5936,2,2510,0,1998
3761100257,1.215e+006,3,3,4560,16339,2,4040,520,2001
0952003340,380000,2,1,780,3910,1,780,0,1918
3347401315,220000,3,2,1410,7998,1,1410,0,1940
0513000585,631500,4,2,2530,5650,1.5,1910,620,1910
1049010050,386100,3,2,1270,6760,1,1270,0,1972
1370802455,1.05e+006,4,4.5,3180,4606,2,1990,1190,1929
4206901435,650000,2,1.75,1450,4000,1.5,1350,100,1903
1467400095,545000,4,1.75,2040,53578,1,1160,880,1959
2592210290,870000,4,2.5,2650,12001,2,2650,0,1984
3034200275,380000,3,1.75,1240,8611,1,1240,0,1973
7221400285,265000,2,1,820,8423,1,820,0,1957
7518502210,645500,2,1,1890,5202,1.5,1890,0,1909
1646501845,570000,3,2,1270,3090,2,1270,0,1911
8081020380,1.2e+006,4,2.5,3350,11688,1,1760,1590,1995
2158900095,605000,2,1,1550,3200,1.5,1550,0,1927
4031000460,199500,3,1,920,9812,1,920,0,1962
3881900605,445000,2,1,950,4800,1,950,0,1941
5700002285,495000,4,1.75,2040,3570,1,1020,1020,1917
6392002635,594000,4,1.75,1870,5200,2,1200,670,1937
6822100305,465000,3,1.75,1720,5280,1,900,820,1943
1871400585,160000,2,1,1020,13647,1,1020,0,1915
7300410010,340000,4,2.5,2690,6099,2,2690,0,1998
0925069134,870000,4,2,3090,41147,1,3090,0,1990
2114700460,249000,3,1.5,1070,5150,1,1070,0,1940
3326059238,500000,4,2.25,2050,7201,2,2050,0,1994
3750606890,220000,3,1.5,1660,15600,2,1660,0,1981
9117100130,368500,5,1.75,2810,9360,1,1520,1290,1965
5469502660,439950,4,2.25,2460,14600,1,1720,740,1977
3356402232,179900,3,1.75,1230,12000,1,1230,0,1970
8030500010,490000,4,2.5,2360,4367,2,2360,0,2003
2425700022,425000,4,1.75,1730,11890,1,980,750,1955
3956100050,533300,4,2.5,2770,21806,2,2770,0,1991
5292200010,447500,4,2,1770,3332,2,1630,140,1924
4178310080,768000,5,2.75,3030,13640,2,3030,0,1980
1180002745,285000,3,1.75,2380,6000,1.5,1320,1060,1935
4047200655,336900,3,1.75,1780,120661,1,1780,0,1979
9477000080,415000,4,1.5,1540,7886,2,1540,0,1967
3905100840,500000,3,2.25,1580,4379,2,1580,0,1994
7885800290,337000,4,2.5,3200,5772,2,3200,0,2003
9475710170,419950,4,2.5,2220,6800,2,2220,0,2002
6885900415,290000,4,2.75,2240,8162,2,1380,860,1946
5285200020,349950,2,1.75,1640,4176,1,1040,600,1948
4039400430,330000,3,1.5,1170,4950,1,1170,0,1960
2481610170,965000,4,2.25,3160,34560,1,3160,0,1981
1795910420,515000,3,2.5,2100,7851,2,2100,0,1986
7135521680,665000,4,2.5,2600,17388,2,2600,0,1996
2011000020,265000,3,1.75,1630,5999,1.5,1630,0,1985
1196002395,545400,3,2,2850,19200,1,2340,510,2004
3876590420,350000,4,3,2560,5606,2,2560,0,2004
4358700164,260000,2,1.5,980,1296,2,840,140,2001
7631800015,2.51e+006,3,3.25,5480,57990,2,5480,0,1991
3260810150,355000,3,2,2160,8091,1.5,2160,0,2000
7015201015,879000,3,3,3030,5156,1.5,2080,950,1929
9348700450,833000,4,3.5,3560,7178,2,2590,970,2006
3151600035,261590,2,1,760,6407,1,760,0,1943
2254502070,512500,3,3,2260,2400,2,2260,0,1909
8127700210,600000,2,1.75,1560,3200,1,880,680,1946
2926049237,417500,5,3,2270,6664,1,1340,930,1995
7785000230,970000,5,3,3480,15185,2,3480,0,1964
2025701390,316000,3,2.25,1900,7479,2,1900,0,1992
1561900330,397500,4,3,2350,9952,1,1650,700,1989
1370800940,1.35e+006,3,2.5,2390,5500,1,1700,690,1952
8691300900,840000,4,2.5,3730,9847,2,3730,0,1997
3751606514,270000,2,1,1780,81021,1,1780,0,1954
5104510490,312900,4,2.5,1630,4473,2,1630,0,2003
3432500210,325000,2,1,1130,6908,1.5,1130,0,1945
2771604791,680000,3,1.75,2140,3584,1,1070,1070,1952
2537500040,763000,4,2.5,3220,7873,2,3220,0,1994
1222069089,375000,1,1,800,533610,1.5,800,0,1950
3332500100,475000,3,2.5,1800,3300,2,1690,110,2004
7625702616,219000,2,2.5,809,940,2,809,0,2003
2561330040,415000,3,2.25,1820,9694,1,1240,580,1977
1423049019,90000,2,1,580,7500,1,580,0,1943
1423049019,220000,2,1,580,7500,1,580,0,1943
9277200065,616000,3,2,2900,5650,1,1520,1380,1959
1920079039,269500,2,1,1140,74052,1,1140,0,1968
7515000035,395350,2,1,1060,5754,1,1060,0,1917
5315101728,770000,4,3,2320,7200,1,1260,1060,1943
0326069164,840000,4,2.5,3450,43216,2,3450,0,2000
2695600410,428950,2,1,1760,4441,1,1310,450,1950
9348700610,800000,4,3.75,3370,6766,2,3370,0,2005
7308900100,401000,4,1,1940,5753,1.5,1940,0,1947
1453601502,303697,4,2,2520,7334,1,1600,920,1955
4077800593,355000,3,1,1360,8968,1,1360,0,1956
9268200641,350000,2,1,800,5040,1,800,0,1960
6705850300,754999,4,2.5,3010,9323,2,3010,0,1992
3720800115,982218,3,1.75,2340,5500,2,2340,0,1988
8079040330,406500,3,2,1780,8621,1,1780,0,1992
1824079052,1.65e+006,4,3.25,4200,210394,2,4200,0,1993
1923300315,565000,2,1.75,1720,3000,1,860,860,1925
3336001316,160000,2,1,830,4500,1,830,0,1920
9382200025,220000,3,1,1090,6320,1,890,200,1954
7237500650,1.284e+006,5,4.25,5040,9466,2,5040,0,2004
3100500065,970000,5,2.75,3500,5040,2,2950,550,1927
0795000620,115000,3,1,1080,6250,1,1080,0,1950
0795000620,124000,3,1,1080,6250,1,1080,0,1950
0795000620,157000,3,1,1080,6250,1,1080,0,1950
8651430220,183000,3,1,870,5200,1,870,0,1969
7954300740,527000,4,2.5,2830,6163,2,2830,0,2000
4046601460,407193,4,2,1880,14653,2,1880,0,1978
6933600456,970000,4,2.75,3600,5040,2,2610,990,2004
9357000650,535000,4,2.5,2340,5600,2,2340,0,1921
7347600490,245000,3,2,2040,13125,1,810,1230,1910
5095400760,337000,3,1.75,1310,12750,1,1310,0,1993
1245003660,630000,3,2,1470,6000,1,1090,380,1950
3275300040,320000,3,1.75,1370,9900,1,1370,0,1983
2407000405,228500,3,1,1080,7486,1.5,990,90,1942
6664900330,293000,3,2.5,1990,7577,2,1990,0,1990
4036800900,447000,3,1,1310,7000,1,1310,0,1958
8648220150,226500,3,1.75,1640,10762,1,1130,510,1988
3876313170,436000,3,2.25,1770,8000,1,1350,420,1976
2738600220,451000,3,2.5,2050,4876,2,2050,0,2005
1593000690,315000,3,1,1170,62290,2,1170,0,1986
5101406536,450000,2,1,1340,7250,1,1340,0,1951
2267000485,635000,3,1.5,2240,5300,1,1120,1120,1955
0822059059,292500,2,1,880,17743,1,880,0,1951
2310110230,329900,3,2.5,2170,4905,2,2170,0,2004
7974200777,531000,2,1.5,1260,6660,1.5,1260,0,1926
2025059201,725000,3,1.75,1880,13300,1,1380,500,1967
1074100110,355300,3,2.5,1620,7410,1,1620,0,1955
8000200090,280000,3,2.5,1610,10022,2,1610,0,1996
1247100035,1.095e+006,4,2.75,3330,9143,2,3330,0,1995
7010700210,605004,4,2,1370,4000,2,1370,0,1951
7950304065,260000,2,1,690,6000,1,690,0,1949
9523100026,748000,4,2.5,3170,4979,2,2570,600,1925
1093000090,776000,2,2,1990,6180,1,1010,980,1941
1532300155,425000,4,1,1080,6095,1.5,1080,0,1924
4006000423,230000,4,1,1870,14703,1.5,1090,780,1928
8665900331,418000,3,1.75,1670,12075,1,1370,300,1958
3370000150,440000,4,2.5,2800,28254,2,2800,0,2001
1853080540,858450,5,2.75,3460,7977,2,3460,0,2011
1023089197,390000,3,2,1930,12443,1,1930,0,1969
1175001075,957000,4,3,2370,3836,2,1750,620,1969
6392001810,507000,3,1,1180,6000,1,1180,0,1950
2767603160,575000,2,1,1320,4750,1.5,1320,0,1928
8129700985,700000,3,1.75,1350,4000,1.5,1350,0,1925
9406500600,239950,2,1.5,1068,1452,2,1068,0,1990
3830620300,253000,3,1,1580,8240,1,1040,540,1978
4237901250,540000,4,1,1690,3417,1.5,1690,0,1907
3754501240,1.55e+006,3,4,5120,4600,3,4490,630,2008
2226069018,805000,4,2.5,3960,38615,2,3960,0,2000
4206901215,920000,4,3.25,2420,4000,1.5,1870,550,1911
3904930730,496600,3,2.5,1910,5562,2,1910,0,1988
2115510300,246000,3,2.25,1440,10500,1,1130,310,1983
1773100620,350000,5,3,2320,8400,1,1510,810,1963
5075400150,585000,3,2,1670,4572,1.5,1670,0,1931
3893100319,450000,3,1.75,1390,11700,1,1390,0,1966
4139440610,746000,3,2.5,2620,8950,2,2620,0,1992
2481590090,598555,3,2.5,3040,7880,2,3040,0,2004
3222049151,820000,3,2.5,2990,10711,1,1560,1430,1976
1545805030,266500,3,2.25,1740,5460,1,1210,530,1998
0620079042,370000,2,1,2360,105850,1,1180,1180,1947
6848200325,625000,3,2.75,2240,3600,2.5,1650,590,1901
6929603207,243500,4,2,1610,6200,1,1610,0,1979
3626039229,340000,2,1,700,5829,1,700,0,1945
5589900610,559950,5,3,2730,9519,1,1670,1060,2014
7153400100,315000,3,2.75,1780,15114,1,1080,700,1980
1125069086,753000,3,2.5,3070,223463,2,3070,0,2003
2902200076,800000,3,3,2060,3200,2,2060,0,1907
8024201210,550000,3,2.25,1360,5111,1.5,1360,0,1934
3755500065,465000,3,2,1430,14250,1,1430,0,1953
3890600150,465000,3,2.25,1840,5752,2,1840,0,2003
2141320230,710000,4,2.25,2000,8068,2,2000,0,1976
8078430360,505000,3,2.5,1820,11012,2,1820,0,1988
0333100209,690000,3,1.75,2330,16300,2,2330,0,1964
5419800090,217500,2,2,1070,8400,1,1070,0,1980
1868900395,500000,2,1,930,3750,1,930,0,1909
1568100730,325000,2,2,1040,5796,1,1040,0,1921
1785400770,500000,4,2.25,1960,12436,2,1960,0,1984
2724079014,721500,3,3.25,2970,234788,2,2040,930,1991
1370801800,924000,3,1.5,2200,5000,1.5,2200,0,1932
3585901085,2.005e+006,6,4.5,3810,28176,1,3810,0,1969
0424049283,345000,2,1.5,830,1034,2,830,0,2009
7851990230,825000,4,3.5,3920,11086,2,3920,0,1999
1423069076,560000,3,2,2870,95396,1,1350,1520,1980
1786830090,599000,3,2,2560,14680,1,1330,1230,1987
2968801240,211000,3,1.5,1350,7620,1,1350,0,1941
3344500210,425000,4,2.25,1240,21190,1,910,330,1974
0226039317,750000,4,2.75,3210,8520,1,1810,1400,1976
7202330530,479000,3,2.5,1690,3322,2,1690,0,2003
3905090230,612500,4,2.5,2550,10623,2,2550,0,1992
6446200365,605000,5,1.75,3240,34510,2,2690,550,1963
0856001130,1.364e+006,4,2.5,3560,8960,2,3560,0,2001
7861500150,389900,3,2.5,2160,59241,1,2160,0,2007
5014600210,710000,4,2.5,3060,5000,2,3060,0,2006
2215900900,295000,3,2.5,1690,8564,2,1690,0,1992
2025700740,275250,3,2.25,1520,7199,2,1520,0,1992
2591730230,250000,4,2.5,2040,5770,2,2040,0,1994
7611200195,709000,3,2,2360,18000,1,2180,180,1951
9297800090,399500,4,1.75,1360,4840,1.5,1360,0,1928
2215900930,225000,3,2.5,2000,9202,2,2000,0,1992
7215730930,500000,3,2.5,1650,4648,2,1650,0,2001
5201810110,364900,3,3,2500,8304,2,2500,0,1997
3575302562,356000,3,1.5,1140,7500,1,1140,0,1976
3438502290,616750,3,1.5,2140,47743,1.5,2140,0,1978
8881900230,755000,3,2.75,2870,6600,2,2870,0,1984
3500100015,327500,2,1,830,8183,1,830,0,1950
8651511250,605000,3,2.25,1960,10139,2,1960,0,1984
8651401960,179950,4,1.5,1130,5200,1,1130,0,1968
7937900040,633000,5,2.75,3630,30570,2,3630,0,2000
6199000141,349950,4,2,1764,15600,1,1764,0,1942
3271300365,1.08e+006,3,2.75,2770,5800,1,1650,1120,1959
9264030040,425000,3,2.5,2650,12247,2,2650,0,2002
9829200580,990000,3,2.75,2500,6350,2,2370,130,1979
2929600035,410000,3,1,2710,19000,2,2710,0,1950
3459410230,590000,3,2.25,2490,8800,2,2490,0,1975
7303200450,242000,3,1.75,1500,7560,1,1500,0,1979
0924069042,775000,3,2,1160,13747,1,580,580,1931
0287000110,680000,4,1.5,1880,6200,1,1440,440,1954
1018000276,217000,3,2.5,1340,4200,2,1340,0,2002
1560870040,395000,3,2.5,1960,3953,2,1960,0,1999
7135500120,572500,3,2.25,2030,9791,1,1500,530,1984
5101408835,559900,5,3,2200,6380,1,1440,760,1987
0472000590,845000,3,2,2540,4750,1.5,1840,700,1930
0104550750,241000,3,2,1520,7131,1,1520,0,1993
7576700150,1.325e+006,3,2.25,2360,5504,2,2080,280,1913
7137300245,475000,3,1.75,1340,2805,1.5,1340,0,1919
5511600315,575000,2,1.5,1400,5810,2,1400,0,1940
1422059039,455000,4,2.75,3030,117378,1,1680,1350,1959
1026069095,839000,3,2.5,3200,203425,1,3200,0,2000
2207100165,475000,4,1.5,1580,10260,1,1030,550,1955
1705400361,600000,2,1,2120,6897,1,1060,1060,1923
1370804115,515000,2,1,1640,5200,1,1040,600,1937
9527000090,425000,3,2.25,1890,8400,1,1520,370,1977
1556200145,565000,4,2,1710,3875,1.5,1710,0,1907
1245500286,498000,2,2,1140,8282,1,1140,0,1924
8824900120,739000,4,3,2720,3800,2,1800,920,1919
3959401645,355000,2,1.75,1650,4000,1,950,700,1947
9264900880,263000,3,1.75,1790,7485,1,1330,460,1979
2826049160,375000,4,1.75,1680,6834,1.5,1680,0,1948
3449500035,322000,3,1.75,2200,12231,1,1250,950,1964
9266700845,325000,2,1,830,5100,1,830,0,1941
2493200455,290000,2,1,770,4800,1,770,0,1943
6352600210,809950,4,2.5,3280,6181,2,3280,0,2001
4278900110,969500,3,3.25,2080,3025,2,1220,860,1984
7214790110,665000,4,2.5,2790,43091,2,2790,0,1989
9358400150,635000,5,3.5,4150,13232,2,4150,0,2006
1545802100,272450,3,2.25,1780,7332,2,1780,0,1987
8563000110,427000,4,1.75,1460,9750,1,1460,0,1967
8074400150,261500,3,1,1410,8174,1,1410,0,1958
1951800040,488800,4,2.25,2170,9665,1,1300,870,1976
7934000090,340000,2,1,690,5200,1,690,0,1918
0050300090,398950,4,3,3000,10297,2,3000,0,2003
8651430210,217000,3,1,870,5200,1,870,0,1969
0126059019,799000,4,2.5,3170,94855,1,1910,1260,1978
2599700040,160000,4,1,1540,7350,1,770,770,1969
9512501400,447000,3,1,1270,8800,1,1270,0,1968
9169600043,765000,3,1.75,2190,6450,1,1480,710,1957
4139900210,1.32e+006,4,3.5,4410,36200,2,4410,0,1989
9558010090,445000,4,2.5,2790,8111,2,2480,310,2004
8101900100,310000,3,1,1510,6000,1,1170,340,1953
5592900205,380000,2,1.75,1800,7191,1,990,810,1952
1624049228,325000,4,1,2410,6975,1,1510,900,1957
2473410360,345000,4,2.75,2250,7412,1,1480,770,1975
7750500120,300000,3,1,950,4760,1.5,950,0,1929
1630700361,530000,4,1.75,2860,48351,1,1710,1150,1978
1630700361,583500,4,1.75,2860,48351,1,1710,1150,1978
4025300210,410000,2,1,1560,10125,1,1130,430,1954
2922701175,535000,2,1.5,1940,5700,1,970,970,1937
7352200450,2.05e+006,4,3.25,3580,19989,1.5,3480,100,1915
9320990120,345000,4,2.5,2040,5523,2,2040,0,1999
1238500281,539000,5,1,1700,11727,1.5,1700,0,1954
1951800580,590000,4,2.5,3700,12500,1,1920,1780,1973
3530430100,187000,2,1.75,1050,2926,1,1050,0,1974
1623059092,270000,3,2,1690,9583,1,1690,0,1969
7177300735,546000,2,1,1120,6180,1,1120,0,1939
1525039057,520000,3,1.75,1490,1036,2,1090,400,2008
5393601635,515000,5,2,2220,6000,1.5,1390,830,1925
4217401240,990000,3,2.5,2160,6000,1.5,1880,280,1939
3438501450,382000,2,1,870,10492,1,870,0,1937
1872900065,1.21e+006,3,1.75,1900,13600,1,1900,0,1956
9285800180,900000,4,3.5,3370,5000,2,2470,900,2008
4322200220,675000,3,2.75,3370,5350,1.5,2310,1060,1910
1819800042,460000,2,1,880,3300,1,880,0,1909
2946001675,234000,2,1,940,5375,1,940,0,1952
1138010530,399000,3,1,1340,7191,1,1340,0,1974
7763400035,253500,3,1.5,1440,12040,1,1440,0,1959
0925059107,475000,3,1.5,1750,12632,1,1750,0,1952
1112000100,740000,5,3.5,3990,5000,2,2910,1080,2004
7010700936,799000,3,2.5,2860,4442,2,2860,0,2000
9558010300,390000,4,2.5,1940,3864,2,1940,0,2003
7304301010,421000,2,1.5,1400,11245,1,1400,0,1947
2329800110,296500,3,2.5,1770,6033,2,1770,0,1987
8712100530,895000,4,2,1710,4178,1.5,1710,0,1926
3814800300,386000,4,2.5,2810,11897,2,2810,0,2003
4022300035,424000,3,1,1580,13912,1,1580,0,1955
6021503840,749000,3,1,1580,5000,1.5,1580,0,1926
5210200081,523000,3,1,1440,8681,1.5,1440,0,1937
0821049123,389000,4,2.5,2420,9147,2,2420,0,1998
6929600945,270000,4,1.5,1930,15000,1,1930,0,1946
5229300027,275000,3,1,1190,27215,1,1190,0,1943
2214800730,287500,4,2.5,2240,6944,1,1310,930,1979
3521059124,345000,2,2.5,2550,216344,2.5,2550,0,1993
1931300850,427000,2,1,920,3780,1,920,0,1910
2206500110,508450,4,1.75,1520,9600,1,1000,520,1955
3856903515,705000,3,2,1460,6250,1.5,1460,0,1912
5561401530,550000,1,1.5,1900,40600,1.5,1450,450,1977
2206900065,380000,3,1.5,1430,11173,1,1430,0,1955
7852090820,539900,3,2.5,2500,4203,2,2500,0,2001
2354300915,330000,2,1,720,7250,1,720,0,1943
9214400120,455000,2,1,1140,5720,1,850,290,1947
7298050090,510000,4,4,3530,10935,2,3530,0,1992
1323059098,315000,3,2,1220,14645,1,1220,0,1970
7345000120,206000,3,1,1320,7000,1,1320,0,1967
8563050110,592500,4,3,2170,8240,1,1370,800,1968
3754010040,744000,3,2.5,2020,7512,2,2020,0,1981
8944320100,334500,3,2.5,1990,3694,2,1990,0,1989
6788201781,886000,4,2,2660,3900,1.5,1480,1180,1923
1036400100,600000,4,2.5,2360,13500,1,1780,580,1973
0323089085,850000,3,2,2740,101930,1,2740,0,1999
7905200365,550000,3,1.75,1360,5850,1,1000,360,1938
2420069268,184900,2,1,1230,5000,1,1230,0,1911
7957600025,245000,3,1.5,1260,7964,1,1260,0,1955
1338600090,370000,2,1,1040,4172,1,1040,0,1946
5255690100,480000,4,2.5,2700,9700,1,1670,1030,1978
1646500365,579000,3,1.75,1800,4429,2,1800,0,1906
2645500021,339275,3,1.5,1590,7260,1,1080,510,1964
2220069003,425000,3,2.75,1360,542322,1,1140,220,1955
2123049498,170000,3,1.75,1370,10780,1,1370,0,1959
4139450360,950000,4,2.5,3320,7644,2,3320,0,1995
2600100300,623000,4,2.5,2980,9235,1,1690,1290,1977
2767600150,477000,3,2.5,1350,2053,3,1350,0,2005
1771000970,330000,3,1,1160,9600,1,1160,0,1967
7960100120,600000,3,2.25,1480,5400,2,1480,0,1914
0424049039,570000,3,2,1640,2808,1,820,820,1924
7853220970,515000,4,2.5,2680,7178,2,2680,0,2004
0439000230,805000,4,2.25,2440,9889,1,1540,900,1952
9406510040,555000,4,2.5,2920,24074,2,2920,0,1997
7697850360,245000,3,2.25,1780,9598,2,1780,0,1985
2923500750,638150,4,2.5,2170,7275,1,1820,350,1978
3024059057,1.65e+006,4,4.5,5550,16065,2,3880,1670,2003
0322059095,269950,4,2.5,2060,13500,1,1260,800,1968
8651400580,195000,3,1.5,1050,5525,1,1050,0,1969
7812800855,159100,2,1,790,7095,1,790,0,1944
4151800265,550000,3,1,1010,6120,1,1010,0,1942
1005000062,299000,2,1,1040,4600,1,1040,0,1950
9528105305,1.375e+006,4,3.5,3130,4500,2,2060,1070,2014
7225000215,249500,2,1,900,4500,1,900,0,1951
5605000215,700000,4,1,1470,5450,1.5,1470,0,1918
1922059401,275000,4,1,1080,26114,1.5,1080,0,1900
3824100286,565000,3,2.25,2440,8378,1,1480,960,1962
1226039058,425000,4,1.75,2520,11017,1,1320,1200,1956
2770605175,620047,4,1.75,1760,6000,1,880,880,1946
6791200120,480000,3,2.25,1820,13362,1,1220,600,1977
6791200120,515000,3,2.25,1820,13362,1,1220,600,1977
4137010590,420000,4,2.5,3040,24123,2,3040,0,1999
5495200040,610000,5,3.25,3490,23400,1,1890,1600,1957
0868000175,849000,4,1.5,2440,8040,1,1440,1000,1950
8820902549,718000,3,1.75,2280,3446,2,2280,0,1949
8731980040,295000,3,2.25,1980,8000,1,1560,420,1974
3096000040,871000,5,1.75,2360,6150,1,1180,1180,1940
4058800215,430000,3,3.75,3890,7140,1,2390,1500,1943
3579800405,440000,4,2.5,2300,10880,1,1190,1110,1961
3188100065,405000,2,1,910,6490,1,910,0,1942
8570900038,340000,3,2,1140,11620,1,1140,0,1994
4379400490,675000,4,2.5,2390,5249,2,2390,0,2006
0952003575,480000,3,1,1150,4945,1,1150,0,1943
0162500015,362500,5,2,2330,8586,1,1270,1060,1961
7732410360,752888,3,2.5,2420,9000,2,2420,0,1987
3031200120,255000,4,1.75,960,8863,1,580,380,1949
2131700900,283700,1,1.75,1010,10900,1,1010,0,1968
2122059198,335000,4,2.5,2370,6000,2,2370,0,2001
7340600735,285000,3,1.75,2880,18296,1,1580,1300,1958
2923049393,278000,4,2.25,2400,7738,1.5,2400,0,1964
7922710450,731000,5,2.5,3670,8960,1.5,3670,0,1973
0192450180,335000,3,1.5,1140,15890,1,840,300,1985
0782700120,334200,3,1.75,1410,45302,1,1410,0,1980
2887703155,642000,6,1,1530,4305,1.5,1530,0,1921
5700000245,540000,4,1.75,1720,4240,1.5,1460,260,1925
2420069003,299000,3,2.5,1620,79993,1,1620,0,1960
9274202165,560000,3,1.75,1570,4375,1,970,600,1940
9287802410,852000,5,2.75,1990,3750,1.5,1990,0,1913
2324039077,306000,2,1,930,5650,1,930,0,1941
9329300040,440000,3,1.75,1550,7820,1,1210,340,1981
0259700180,517000,4,1,1650,8250,1,1650,0,1966
5100400315,379000,2,1,800,6380,1,800,0,1940
3424069076,360000,2,1,930,6098,1,930,0,1919
9138100261,645000,4,1.5,2550,4000,1.5,1760,790,1926
7227500740,217000,2,1,720,4760,1,720,0,1942
8150100265,255000,2,1,620,4760,1,620,0,1941
1150000040,625000,3,2.5,2360,12164,2,2360,0,1987
9238900616,680000,3,1.75,1760,8400,1,1460,300,1960
9289900065,440000,3,1.75,2100,29735,1,1080,1020,1957
7504020610,615000,5,2.25,2480,12070,2,2480,0,1978
7454001210,239000,3,1,1040,6860,2,1040,0,1942
2122039137,462500,3,2.5,1656,108900,1,1656,0,1985
6884800180,619400,4,2,2090,3610,1.5,1790,300,1927
7110000068,975000,6,2.75,2520,54160,2,2520,0,1954
7625701935,330000,2,1,700,4000,1,700,0,1943
4054500180,985000,4,3.25,4030,36762,2,4030,0,1988
2917200475,430000,2,1,760,7114,1,760,0,1946
3262300555,2.458e+006,4,5.25,6500,14986,2,5180,1320,2001
1245003740,778000,3,2,1840,6000,2,1720,120,1946
1796381120,219000,3,2,1090,7350,1,1090,0,1990
3761100180,1.595e+006,4,2.5,2980,13341,1.5,1800,1180,1928
6666800180,715000,4,2.25,1900,8272,1,1460,440,1966
8651200040,950000,4,2.5,2790,15653,2,2790,0,1964
5100402310,425000,2,1,1280,5026,1,1020,260,1951
0421049170,239000,3,1,1510,15022,1,1510,0,1962
0726059047,310000,1,1,920,8282,1.5,920,0,1944
5100403636,400000,2,1,700,8120,1,700,0,1927
1535204365,428000,2,1.75,1980,44550,2,1280,700,1977
4240400155,600000,3,1,1440,4300,1.5,1440,0,1929
5468750040,415000,4,4,2740,8250,2,2740,0,1990
9158100040,401000,2,1,1400,8220,1,1400,0,1949
7460000040,292000,3,1.75,2270,7156,1,1370,900,1948
2927600155,291750,3,2.25,1310,12825,1,1310,0,1950
8731950910,227000,3,1.75,1680,7455,1,1680,0,1968
1726600110,675000,3,2.25,2260,13209,1,2260,0,1977
3320000212,397500,3,2.25,1350,980,2,1050,300,2007
1670400068,206000,2,1.5,1820,8867,2,1820,0,1921
7424700145,1.19e+006,3,3.5,3380,3333,3,2800,580,2008
2408800120,360000,4,1.75,2140,49658,1,2140,0,1959
1776230180,427500,4,2.5,2430,3249,2,2430,0,2010
7889601320,115000,2,1,940,6000,1,940,0,1943
7589200153,559000,3,1.5,2070,5386,1,1140,930,1948
8032700175,420000,4,1,1510,1501,1.5,1510,0,1906
9238430300,550000,4,1.75,2550,39460,1,1890,660,1982
6150700180,282150,2,1,700,5940,1,700,0,1948
3330501645,260000,3,1,1150,3090,1,1150,0,1910
7853210180,428000,3,2.5,2340,3466,2,2340,0,2004
6149700194,319950,3,3.25,1510,1245,3,1510,0,2007
3625049079,1.35e+006,3,2,2070,9600,1,1590,480,1946
2979800750,552000,2,1,1150,5000,1,1050,100,1924
2887700970,637000,4,2.75,2190,2867,1.5,1470,720,1929
8732130940,213000,4,1.75,1980,9000,1,1480,500,1978
2968800645,215000,3,1,960,7200,1,960,0,1958
2351800065,590000,3,1.75,2180,6120,1,1380,800,1949
2822069080,390000,4,2.5,2560,43560,2,2560,0,1989
5018200110,287000,4,2.25,2270,11997,1,1540,730,1959
1235100371,580000,5,2.75,3550,9600,2,3550,0,1960
3904930410,424000,3,2,1330,5632,1,1330,0,1988
3529000880,610000,4,2.5,2110,6360,2,2110,0,1988
8081020330,1.32e+006,4,3.25,3470,11843,1,2270,1200,1989
2516000515,623500,4,3,1550,3350,1,860,690,1918
3223039010,260000,2,1,570,81893,1,570,0,1936
9828702588,906000,3,2.5,2030,1800,3,2030,0,2013
6672920150,330000,3,2,1500,11233,1,1500,0,1987
9485700150,275000,2,1,920,7688,1,920,0,1955
3500100208,290000,3,1,1470,8200,1,1040,430,1953
4083302915,599950,2,1,1150,3775,1,1150,0,1917
1560920450,550000,4,3,4180,35169,2,4180,0,1986
2475200930,289000,3,1.75,1690,3449,1,1690,0,1987
2064800120,411000,4,2.75,2150,9915,1,1240,910,1976
0272000945,826000,3,3.25,2330,4000,1,1730,600,1964
9476700035,400000,4,2,2680,13680,2,2350,330,1943
0859000018,342000,3,2.5,1740,2226,2,1320,420,2008
4237900645,475000,2,1.75,1320,3420,1,1080,240,1955
2436200436,1.205e+006,4,3.5,3150,5500,2,3150,0,2014
7635801321,455000,4,3,2480,9238,1,2050,430,1913
3975400085,850000,4,3,3330,4000,1,1790,1540,1958
1099600220,185000,3,1,1010,6400,1,1010,0,1971
8952900245,850000,6,3.25,4920,20590,1,2730,2190,1960
1622049140,239900,4,1.75,1570,18730,1,1200,370,1960
2824069373,765000,5,3.75,3580,14275,2,3190,390,1999
1774000330,437000,3,1.75,2220,17568,1,2220,0,1967
1555300530,240000,3,1.5,1010,10350,1,1010,0,1969
4402700593,395000,2,1,1440,7808,1,860,580,1949
2556500040,320000,3,1,1230,7492,1,1230,0,1955
1737100040,525000,3,1.75,1710,7350,1,1280,430,1981
7575620120,260000,3,3,2390,8993,2,1680,710,1988
2817900100,450000,3,2.75,2840,39324,1,2200,640,1988
1939100610,560000,4,2.5,2300,7989,2,2300,0,1990
4174600386,310000,5,3,2270,5001,1,1360,910,1989
1310440590,440000,3,2.5,2290,6302,2,2290,0,1997
4037200690,458450,4,1,1330,9715,1,970,360,1957
8072000035,200000,3,1,1200,10703,1.5,1200,0,1918
2125410210,430000,3,2.25,2160,6527,2,1580,580,1987
3755000120,360000,3,1,1120,10500,1,1120,0,1966
3598600088,311000,4,2.5,2090,11645,1,1200,890,1962
4083305633,615000,3,3.25,1470,1152,3,1470,0,2003
9545200180,575000,3,1.75,2270,10136,2,2270,0,1979
0046100504,2.027e+006,4,3.75,4100,22798,1.5,2540,1560,1934
0952000925,430000,3,1.75,1440,4025,1,720,720,1917
4039300490,400000,3,1.5,1200,4800,1,1200,0,1962
8151600941,340000,3,1.75,1720,10710,1,860,860,1957
3448001975,351000,1,0.75,930,6600,1,930,0,1924
2141500040,440000,4,2.5,2400,8038,2,2400,0,2002
2798600120,298000,4,2.5,1960,11798,2,1960,0,1999
2227900040,300000,4,1.75,1890,9205,1,1260,630,1964
3395040580,310000,3,2.25,1590,3056,2,1590,0,2001
6137610620,500000,4,2.5,2590,9354,2,2590,0,1993
7518505375,399900,3,1,860,1664,1.5,860,0,1927
9206950100,343000,3,2.5,1270,2509,2,1270,0,2004
9542890100,415000,2,2.25,1130,2191,2,1130,0,2010
4254000620,410000,3,2.5,1860,15457,2,1860,0,1997
6414100026,320000,2,1,1802,11225,1,1802,0,1961
1346300035,1.99e+006,5,3,4480,5000,2.5,3420,1060,1902
2212210360,253000,2,1,1310,7128,1,940,370,1980
0205000410,630000,3,2.5,2320,32772,2,2320,0,1992
2892600056,216000,2,1,1130,12500,1,1130,0,1953
3396800120,540000,3,2.5,2180,11100,1,1230,950,1983
2320069089,212000,3,1.5,1830,12233,1.5,1830,0,1930
4036400110,300000,3,2.75,2340,12282,1,1470,870,1978
7518506716,969950,3,2.5,2830,3750,3,2830,0,2014
9826701765,715000,3,1,1610,7680,1,900,710,1956
1438700040,1.32162e+006,5,2.75,2410,19447,2,2290,120,1968
5494000040,1.444e+006,4,2.75,2660,9547,1,1930,730,1968
7224500375,305000,3,1,1030,5350,1,1030,0,1924
1025049254,458000,3,4,1390,1569,2,1150,240,2006
2407000110,275000,3,1.75,1580,8775,1,1220,360,1942
7203600745,550000,3,2.75,2330,4780,2,1730,600,1930
7234601198,742000,3,3.25,1540,704,3,1540,0,2011
1931300110,700000,3,1,1570,4000,2,1570,0,1908
8624700015,640000,4,3,2940,5763,1,1640,1300,1955
6149700315,352000,3,0.75,1240,7200,1,1240,0,1947
2064800880,301500,3,1,1410,7419,1,1050,360,1969
3902300450,630000,4,2.5,2190,9880,1,1410,780,1979
1332300110,340000,3,2.5,3040,6255,2,3040,0,1999
7663700610,477500,4,1.75,1860,9364,1,1080,780,1953
7520000330,285000,3,2.5,1690,7460,1,870,820,1997
1521049156,255000,3,2.75,1900,16117,1,1900,0,1958
6648760150,315000,3,2.5,1600,7982,2,1600,0,1993
1807900300,830000,6,3,2530,9000,1,2530,0,1978
4310700778,539950,3,2.25,1860,1558,3,1860,0,2014
5364200620,980000,3,2.25,2390,4590,2,2090,300,1941
1939130120,735000,4,2.5,3100,8529,2,3100,0,1990
7280300375,536000,5,2.25,2650,9140,1,1350,1300,1965
2767602720,575000,3,2,1520,5000,1.5,1140,380,1945
3300701185,500000,2,1,1510,4000,1,930,580,1924
8731901910,285500,4,1.75,1960,7950,1,1960,0,1967
2558640110,498000,4,2.75,2270,7375,1,1290,980,1973
9465200405,412000,2,1,910,6282,1,910,0,1939
2896000450,607000,4,2.5,2100,8220,1,1300,800,1975
1320069255,199000,3,1,1000,8512,1,1000,0,1991
8651720150,492500,4,2.75,2760,18306,1,1630,1130,1978
3840700757,585000,4,2.5,2840,11044,2,2840,0,2001
8856970530,326995,3,2.5,1860,5321,2,1860,0,2000
2473351050,372500,4,2.25,1920,9660,1,1920,0,1968
7003200120,528000,2,0.75,840,40642,1,840,0,1937
1321059097,400000,3,1.5,2390,32109,1,2390,0,1975
2571910100,344000,4,2.5,2100,8501,2,2100,0,1993
5104511050,409950,4,3,2430,7163,2,2430,0,2003
2771603990,625000,3,2,1880,4000,1,1280,600,1950
9407001770,304950,3,1.75,1350,9000,1,1350,0,1987
3211230300,381500,2,2,2160,35183,1,2160,0,1985
3229200040,215000,3,1.75,1430,13399,1,900,530,1946
3810000843,345000,5,1.75,2840,12870,2,2840,0,1925
4045700455,363000,3,0.75,2510,20000,2,2510,0,1961
3322049095,240000,3,1,1690,20063,1.5,1690,0,1913
8682280970,548050,2,2,1930,5479,1,1930,0,2005
9269200650,314000,2,1,720,4920,1,720,0,1941
7701961220,800000,4,2.5,2990,16809,2,2990,0,1990
7883603945,400000,5,1.75,2300,6720,2,2300,0,1905
1352300580,247000,1,1,460,4120,1,460,0,1937
8714600145,540000,2,1.75,1240,4120,1,890,350,1906
0323089172,410000,4,2.5,1900,15123,2,1900,0,1995
8651511030,525000,3,1.75,2120,9146,1,1260,860,1981
7015200900,820000,4,2.5,2440,5737,2,1700,740,1929
0736100065,1.25e+006,4,2.25,3300,15375,1.5,2820,480,1933
3123049131,244000,2,1,1180,10200,1,1180,0,1955
1773101530,275000,1,1,520,4800,1,520,0,1930
6917700650,577000,2,1.75,2070,23160,1,1260,810,1946
3574800090,446950,5,2.5,2250,7945,1,1360,890,1977
7853220610,457000,3,2.5,2050,5694,2,2050,0,2004
9537200037,320000,4,1.5,1310,137214,1.5,1310,0,1926
5470100090,210000,3,1.5,1250,9484,1,1250,0,1969
3826500730,220000,4,2.5,2130,9100,1,1290,840,1978
2998800040,589000,3,2,2250,8800,1,1250,1000,1925
7658600150,435000,4,2,1880,3840,1,970,910,1904
3816300065,375000,3,1,1520,10798,1,1520,0,1953
1561600056,1.735e+006,4,3.5,4010,9654,2,4010,0,2007
8682261250,545000,2,1.75,1660,5581,1,1660,0,2005
6392002550,970000,3,2.25,3400,10000,2,3400,0,1983
1370803835,705000,2,1.75,2320,6755,1,1380,940,1946
7805450040,915557,5,3.25,3740,11536,2,2540,1200,1984
8019200823,259000,4,1.5,1810,9000,1.5,1810,0,1960
5457800930,1.695e+006,2,2.25,3170,3000,2,1990,1180,1900
3715500110,427000,3,1.75,1680,8610,1,1290,390,1969
6058600385,390000,2,1,930,3100,1,930,0,1911
7708250040,363000,3,2.5,2390,8000,2,2390,0,1995
2769600035,612000,4,2.5,2680,3626,1.5,1680,1000,1928
5500100120,380000,4,1.75,1790,10186,1,1790,0,1965
4472000040,230000,4,3,1680,6003,1,1150,530,1997
9376301591,580000,3,1.75,1570,2600,1.5,1570,0,1931
4232903990,770000,3,1,2230,3200,2,1630,600,1918
7575500150,207200,4,2,1260,8400,1,1260,0,1991
6817801430,525000,3,2,1790,11430,1,1190,600,1985
2883200760,925000,3,2.5,2440,7419,1,1520,920,1961
1797500985,883000,4,2.25,2410,4000,2,1650,760,1910
2896400210,455000,4,2.5,1780,2992,2,1780,0,2003
8691510150,343500,3,2.5,1900,5194,2,1900,0,2004
6163901380,244000,2,1,960,8450,1,960,0,1950
9477000650,397000,3,1.75,1640,11730,1,1640,0,1967
2560800165,180500,2,1,850,5000,1,850,0,1976
5589300495,310000,3,2.75,2150,6576,1,1900,250,1926
2517000600,315000,4,2.5,2780,3969,2,2780,0,2005
5364200477,718000,3,1,1030,4958,1,1030,0,1952
7349400100,279950,3,1.75,1930,7267,1,1330,600,1977
1455600062,689000,3,2.5,2080,9612,1,1700,380,1940
0629810720,828000,4,2.5,3520,9901,2,3520,0,1998
3395800455,150000,2,1,890,8100,1,890,0,1942
9191201385,505400,3,1.75,1640,3400,1,930,710,1926
6648150040,1.68e+006,5,3.25,4860,23723,2,3820,1040,1989
7211400615,217450,3,1,1040,5000,1,1040,0,1959
6870000150,677000,4,2.5,2820,4174,2,2820,0,2004
3324079092,361000,2,2.5,1320,48787,1,1320,0,2004
8901000543,620000,3,2.5,2590,7237,2,2590,0,2004
7428000120,176000,3,2.25,1540,5449,1,1180,360,1989
6675500112,330000,3,1,960,7218,1,960,0,1969
8898701340,290000,3,2.5,1190,8175,1,1190,0,1986
3904921120,711000,4,2.5,2770,9532,2,2770,0,1988
1545806960,295000,3,1.75,1060,8100,2,1060,0,1983
3303990410,1.0965e+006,5,3.25,4010,12110,2,4010,0,2003
1862900690,257500,3,2,1140,7078,1,1140,0,1991
0123039333,240000,4,1,1910,16320,1.5,1910,0,1934
8077210230,645000,4,2.5,2340,8955,2,2340,0,1990
9550200650,499000,2,1.75,1170,2400,1,740,430,1903
4326000220,321000,3,1,1290,9526,1.5,1290,0,1961
1862400522,449000,3,2.5,1810,1658,3,1810,0,1998
7589200165,515000,3,2.5,1820,5280,1,910,910,1949
0925059042,456000,4,1.5,2220,12385,1,1270,950,1978
2924079044,865000,3,3.75,3830,219106,2,3830,0,1977
5535600110,515500,4,2.5,2920,7700,2,2920,0,2003
1428900033,576925,4,2.5,2630,6100,2,2630,0,2004
1822059382,243000,3,1.75,1320,10416,1,1320,0,1996
3584000180,253400,3,2,1400,8640,1,1400,0,1968
7812500180,292000,3,2.5,1600,3580,2,1600,0,2000
0984210220,271500,3,2.5,1490,8005,1,1090,400,1976
8682310220,765000,2,2.5,2170,6750,1,2170,0,2012
7586200061,375000,3,3.25,1280,1730,2,1090,190,2005
5127100100,382880,3,2,1620,9566,1,1620,0,1968
7856000150,852500,3,2.5,2630,10100,1,1580,1050,1967
5076700025,475000,3,1.5,1240,8738,1,1240,0,1959
9221400600,462000,3,1.75,1300,2580,1,820,480,1919
1924059278,762400,3,1.75,2430,14607,1,1230,1200,1949
6163901283,330000,4,1.5,1890,7540,1,1890,0,1967
7504460090,473000,3,2.25,1890,12236,1,1890,0,1978
4154302560,550000,3,1.5,2440,7200,1,2440,0,1949
7905390220,449500,3,2.25,1780,7280,1,1340,440,1972
8691330910,744000,4,2.75,2830,13059,2,2830,0,1998
9169100175,700000,4,2,2490,4700,1,1690,800,1952
5706202070,511100,4,2.5,1560,12220,1.5,1560,0,1965
9478501020,317950,3,2.5,1980,4500,2,1980,0,2012
0426069095,542950,3,2.5,2070,39768,2,2070,0,1988
6752000330,490000,3,1.75,1490,11360,1,1490,0,1975
9834200555,760000,4,3.5,3090,4060,2,2420,670,1992
0726059344,475000,3,2.25,1580,8659,1,1220,360,1961
8106100085,1.7025e+006,5,4.5,5190,23716,2,3390,1800,1987
3831250150,435000,3,2.75,2692,6197,2,2692,0,2007
7852020760,399000,3,2.5,1740,3690,2,1740,0,2000
3142600120,627000,3,2,1940,3800,1,1050,890,1927
7831800495,346500,4,2.5,2150,5100,1.5,1290,860,1991
4037000065,412000,3,1.5,1320,8000,1,1320,0,1957
7574910450,845000,4,2.5,3360,40471,2,3360,0,1994
6703700025,373000,3,1.75,1850,9655,1,1100,750,1959
5418500970,725000,4,2.25,2880,8882,2,2480,400,1965
5379806180,376000,6,2.5,2420,11662,1,1420,1000,1965
3332000061,552500,3,1,2020,4120,1.5,1520,500,1929
7635800600,365000,5,2,2280,19000,1.5,2280,0,1924
1825079086,700000,4,2.5,3010,46173,2,3010,0,1996
4399200085,315000,4,2.25,2550,9736,1,2550,0,1967
7131300031,262500,4,2,1540,5110,1,1540,0,1957
2719100355,660000,3,2.25,2280,6150,2,2280,0,1984
2517010120,340000,4,2.5,2450,6941,2,2450,0,2006
5700000600,660500,5,2.5,2950,5500,1.5,1720,1230,1918
5075400035,280000,1,1,690,1950,1,690,0,1928
5141000571,267000,1,1,800,2480,1,800,0,1919
3664500300,230000,2,1,1470,25661,1.5,1470,0,1932
2607730490,417000,3,2.25,1840,11403,2,1840,0,1993
0088000790,252000,3,1,1170,9730,1,1170,0,1968
4083303540,791000,5,1.75,2344,4800,1.5,1544,800,1921
6430500219,415000,1,1,1230,3774,1,830,400,1924
0203900610,339000,3,1.75,1150,13278,1,1150,0,1966
6083000123,158000,3,1,1140,10477,1,1140,0,1942
2490200620,535000,3,1,1660,5100,1,1260,400,1957
9528102870,818900,3,1,1080,4120,1,980,100,1919
2436700610,550000,4,2,1720,4000,1,1420,300,1950
7655900031,240000,2,1,590,8717,1,590,0,1953
7011201333,590000,3,3.25,1290,1230,2,1090,200,2008
9412200730,369300,3,1.5,1480,21320,1,1480,0,1967
3024079096,510000,4,2.5,2600,118666,1,1400,1200,1981
5423600040,542500,3,2.5,2040,10086,2,2040,0,1987
3291800120,262500,3,1,970,7854,1,970,0,1980
3052700921,900000,6,3,2620,4350,1,1760,860,1957
2424059119,1.1e+006,4,3.5,4560,41636,2,4170,390,1995
4335000145,368000,3,1.75,1750,14400,1,1750,0,1951
1980200384,825000,4,3.5,3620,6499,2.5,3620,0,2003
5637200150,343500,3,2,1660,7509,1,1660,0,2002
8864000970,273500,4,1,1360,6000,1,1020,340,1944
3885808210,1e+006,3,2.5,2044,5610,2,2044,0,1996
7986400265,770000,5,3,2370,6000,1.5,1340,1030,1926
9459200120,400000,3,2,1170,3868,1.5,1170,0,1925
1311200120,225000,3,1,1660,7210,1,1100,560,1963
3649100031,345000,4,1,2020,18150,1,2020,0,1955
2475400120,450000,3,2.5,2530,8116,2,2530,0,2001
6365900065,334850,2,1,870,5635,1,870,0,1948
3959400645,605000,5,3,3670,9600,1,1980,1690,1955
4139660040,760000,5,3.5,3180,14000,2,3180,0,1997
3241600027,390000,2,1.5,1870,12960,1.5,1350,520,1926
8946400100,488000,3,2.5,1940,5660,2,1940,0,2001
3625059152,3.3e+006,3,3.25,4220,41300,1,2460,1760,1958
0624110110,1.063e+006,5,4.5,4820,13165,2,3950,870,1990
0522079015,608000,3,2,2400,217800,2,1590,810,1975
3204300455,1.385e+006,3,2.25,2930,6000,2,1920,1010,2000
5414100040,299950,2,1,800,3000,1,800,0,1904
1930301015,818000,3,3.25,2200,4800,2,1910,290,1943
1898200100,355000,3,2.5,2400,9701,1,2400,0,1990
9471200065,1.855e+006,5,3.25,5570,9600,2,3860,1710,1952
0510003085,660000,3,3.25,1980,2850,3,1980,0,1987
2579500110,2.367e+006,3,2.25,3530,17450,1,1840,1690,1930
1762600090,1.211e+006,4,2.5,3430,35120,2,3430,0,1984
6700390090,255950,3,2.5,1720,3676,2,1720,0,1992
6817801020,475000,3,1.5,1930,11092,1,1500,430,1983
7931000053,362950,4,1.75,2140,159865,1,1140,1000,1960
1828000620,452000,3,1.75,1110,9012,1,1110,0,1966
2423400040,315000,3,1.75,1970,8200,1,1270,700,1964
6064800730,330950,3,2.5,1630,2844,2,1630,0,2003
3388300590,535000,5,2.25,2520,49222,2,2520,0,1978
1591600506,479000,4,2.25,2270,9464,1.5,1520,750,1940
6798100661,340000,3,2.5,1212,1174,3,1212,0,2004
8732800100,312000,4,2,1890,8362,1,1890,0,1966
2025701080,305000,3,2.25,1370,6600,2,1370,0,1993
4345000490,270000,3,2.5,1770,7336,2,1770,0,1996
2771104010,529999,3,2.5,1710,1664,2,1300,410,2003
3307700405,587100,2,1,1190,6967,1,1190,0,1946
6817800910,459800,3,2,1690,16061,1,1690,0,1984
0259801140,451000,4,1.75,1680,7800,1,1330,350,1966
1176001293,2.475e+006,3,3.25,4340,4947,2,3060,1280,1993
0820079101,525000,3,2.25,2040,435600,2,2040,0,1983
0040001065,250000,2,1,1110,26051,1,1110,0,1951
3330501975,475000,5,2,2040,6180,2,2040,0,1908
3021059175,235000,4,1.5,1920,11595,1,1920,0,1962
8092500720,230000,3,1.5,1330,9548,1,1330,0,1967
9828702120,581000,4,1,1630,2566,1.5,1630,0,1921
6751300375,415000,3,1,1520,9030,1,1520,0,1956
6751300375,522500,3,1,1520,9030,1,1520,0,1956
6073300790,383000,3,1.5,1340,7725,1,1340,0,1967
8074400035,315000,3,1.75,2500,8289,1,1250,1250,1958
2254501335,591000,3,2,1460,3600,2,1460,0,1902
7504021510,750000,4,2.25,3140,12150,2,3140,0,1979
7625701386,430000,3,1.75,2150,4333,1,1200,950,1956
1775500371,712000,4,2.5,3140,32336,1.5,3140,0,1995
3244500037,510000,3,2.5,2310,53578,1,1340,970,1981
9828701745,480000,2,1,710,4800,1,710,0,1950
1994200040,538000,3,1,1460,7200,1,1260,200,1906
8122100265,464000,2,2.75,730,5000,1,730,0,1929
7202290180,476000,3,2.5,1440,3840,2,1440,0,2001
4025300360,349500,3,2,1130,16875,1,1130,0,1947
2557000540,270000,3,2.25,1810,8262,2,1810,0,1981
9388100015,740000,3,2.5,2710,18480,2,2000,710,1978
6305900300,395000,4,2.5,2740,8336,2,2740,0,1990
7202340530,498000,3,2.5,1690,4088,2,1690,0,2004
7849202296,339900,3,2.5,1470,4675,2,1470,0,1999
0255520150,539000,3,2.5,2830,9972,2,2830,0,2006
3578401770,400000,3,1,1410,9704,1,1140,270,1983
0984000410,225000,3,2.5,2170,11745,1,1410,760,1967
9834200925,330000,3,2.25,1340,4080,1.5,1170,170,1907
2225039103,1.3878e+006,3,3,2480,5500,2,1730,750,1950
6445800015,490000,3,2.75,1990,31200,1,1990,0,1986
1311800040,260000,4,2.75,2240,7200,1,1140,1100,1967
1473120730,469900,4,2.5,2990,8913,2,2990,0,1991
6820100035,493000,6,1.75,2120,3801,1.5,1220,900,1925
1824079107,740000,4,2.25,2920,46355,2,2920,0,1998
2891000610,148900,4,1.75,1700,6000,1,1700,0,1967
6600220090,475000,2,2.5,1620,14467,2,1620,0,1981
4447300165,415000,2,1,760,4000,1,760,0,1944
2891000450,229500,3,1,1230,6000,1,1230,0,1967
9286000110,1.355e+006,5,3.75,4960,13990,2,3760,1200,2001
2558160220,385000,4,2.5,2030,11375,1,1330,700,1969
2422000067,230000,3,2.25,1830,11331,1,1250,580,1965
2887701970,425000,2,1,970,2700,1,770,200,1926
8581400015,189900,2,1,1000,4179,1,1000,0,1914
7972603950,238000,2,1,750,6480,1,750,0,1943
7882600332,968060,4,2.5,2620,16200,1,1570,1050,1950
5078400210,921000,4,1.5,2220,9496,1,1490,730,1954
1180008355,380000,5,1.75,3000,6000,1,1500,1500,1958
2781600195,285000,1,1,1060,54846,1,1060,0,1935
3342100995,449000,4,2.5,1980,5400,2,1980,0,1998
2818600115,625000,4,1,1600,5500,1.5,1600,0,1946
8732020720,318989,4,2.25,2000,9000,1,2000,0,1978
1563100557,445000,3,1.5,1310,1266,2,1120,190,2002
9533100145,750000,3,1,1120,8549,1,1120,0,1952
3761700067,959000,3,2.5,3320,11875,1,3320,0,1979
8029500360,330000,3,2.5,2370,9102,2,2370,0,1990
7011201106,425000,2,1.5,830,1241,2,830,0,2005
3235100110,280000,3,1,940,7913,1,940,0,1948
2623089141,476500,4,2.5,2250,50155,2,2250,0,1998
1241500147,556000,3,2.25,2020,3600,2,2020,0,1998
1524079188,1.862e+006,4,5.25,5240,320917,2,5240,0,2006
9262800208,637000,4,3.5,4083,68377,2,4083,0,2005
1062100115,405000,3,2,1450,6081,1,1450,0,1969
6381500265,397000,5,1,1170,6757,1,800,370,1944
7203220300,895990,4,2.75,3555,6565,2,3555,0,2014
4027701220,259000,3,2,1610,14046,2,1610,0,1933
0114100758,420000,2,1,960,112384,1,960,0,1955
9376301110,518000,3,2.5,1680,2096,2,1380,300,2008
9371700085,425000,3,1.75,1380,8182,1,1380,0,1942
2122049096,182500,2,1,1040,13920,1,1040,0,1973
0546000245,549900,3,1.5,1380,3031,1.5,1380,0,1929
2783600210,445000,3,1.75,1850,16863,1,1280,570,1980
5210200184,452000,2,1.75,1740,5400,1,990,750,1946
2125049133,715000,5,1.75,1920,6500,1,1260,660,1951
7940710100,559000,3,2.5,2010,5200,2,2010,0,1989
6072800246,3.3e+006,5,6.25,8020,21738,2,8020,0,2001
5466700450,250000,4,1.75,1860,7350,1,1090,770,1977
1425039029,1.23e+006,5,4,4390,6656,2,2930,1460,2008
0422069067,276500,4,2.25,2380,128937,1,2380,0,1960
2472920740,440000,4,2.5,2880,7386,2,2880,0,1987
2338800100,543200,6,2.25,2820,15600,1.5,1970,850,1940
3524039060,250000,1,1,750,4000,1,750,0,1918
7539900040,625000,4,2.5,1750,9000,1,1410,340,1977
1646502055,530100,3,1,1540,3399,1.5,1200,340,1926
1025049268,549900,2,1.75,1140,936,2,940,200,2014
0324059076,430000,4,1.5,1560,6534,1,1560,0,1962
1853080730,835000,3,2.5,2960,6856,2,2960,0,2009
6708200040,409500,4,2.75,2140,13000,1,1320,820,1968
3438501452,329000,4,2.5,1600,6765,1,830,770,1947
9287802380,940000,4,2.75,2080,4000,1.5,2080,0,1912
2652501513,539950,3,2,1560,3200,1.5,1560,0,1910
2421059125,579950,4,2.5,2880,213444,1,2140,740,1984
1250202990,881000,5,3,2510,4125,1.5,1590,920,1925
6914700165,362500,3,1,960,5424,1.5,960,0,1916
0920069052,243950,2,1,1120,35500,1,1120,0,1961
7853310590,658000,4,2.75,3310,6166,2,3310,0,2008
1898600100,218250,3,1.5,1080,9774,1,1080,0,1968
5611500100,655000,4,2.5,2860,12394,2,2860,0,1999
1796370590,255000,3,2,1490,7599,1,1490,0,1990
7831800110,215000,3,1,1210,7175,1,1210,0,1918
4218400175,1.265e+006,3,1.75,2240,5657,1.5,1910,330,1941
5317100750,2.92e+006,4,4.75,4575,24085,2.5,3905,670,1926
3365900175,424305,3,2.5,1600,5960,2,1600,0,1910
7649900175,494000,4,1.75,2090,4300,1.5,1250,840,1925
8159600360,560000,4,2.5,2260,3713,2,2260,0,2003
9272202260,130000,3,1,1200,7000,2,1200,0,1908
2820069048,468000,4,2.5,2480,176418,1.5,2480,0,1927
6744700343,480000,5,3,2240,15435,1,1390,850,1952
0925049318,475000,3,1.75,1550,4054,1.5,1550,0,1926
6648700150,285000,4,1.75,2130,8151,1,1330,800,1967
0510001400,765000,5,3,2870,5700,1,1950,920,1964
7606200090,208000,2,1,1160,5750,1,1160,0,1924
8562890590,372000,3,2.5,2430,5000,2,2430,0,2001
0441000115,470000,2,1,900,5512,1,900,0,1947
3876200330,451000,5,2.75,2830,8925,1.5,2830,0,1967
1508210100,442200,4,1.75,1620,8132,1,1620,0,1974
2944500330,330000,4,2.5,2510,8580,2,2510,0,1991
4302200625,335000,3,1.75,1790,5120,1,940,850,1949
2722049246,280000,3,2,1640,13249,1,1640,0,1995
0142000175,625000,3,1.75,2240,6050,1,1250,990,1950
9558041130,345000,3,2.5,1870,3584,2,1870,0,2003
5112800210,255950,4,1,1500,11050,1,1500,0,1964
2461900850,570000,4,1,1490,6000,1.5,1490,0,1918
0647100096,685000,3,1.5,2230,8558,2,2230,0,1960
2787311110,273148,3,1.75,1710,7210,1,1240,470,1974
1545801500,246500,3,2.5,1620,7686,2,1620,0,1989
3811300110,349950,5,2.5,2250,7176,1,1310,940,1983
7519001321,545000,4,2,1700,2350,1,850,850,1926
8641500252,403000,3,2.5,1502,1400,3,1502,0,2005
8562891240,299950,4,2.5,1900,4054,2,1900,0,2003
8644210110,792000,3,2.5,3320,12840,1,2600,720,1990
8024202380,418000,5,2.5,1980,10205,1,1080,900,1929
5006000035,332500,4,1,1670,8102,1.5,1670,0,1944
0421069081,337000,3,2.5,2235,43560,1,990,1245,1975
5053300015,212000,2,1,1070,7386,1,1070,0,1949
8857320120,542000,2,2.25,1800,2819,2,1800,0,1979
7852110690,622500,4,2.5,2980,8107,2,2980,0,2000
6084600330,260000,3,1.75,1670,8511,1,1340,330,1985
5561000330,525000,3,1.75,2620,38350,1,1320,1300,1977
2225059273,975000,5,3.5,5470,35071,2,4590,880,1976
1370803445,1.14e+006,4,1.75,3080,6500,1,1700,1380,1941
1236300268,500000,3,1,940,10360,1,940,0,1964
7752700110,554000,5,2.25,1870,11411,1,1170,700,1961
2781250230,343000,4,2.5,2070,4500,2,2070,0,2004
4027701055,515000,2,1.75,950,15219,1,950,0,2009
2755200040,492000,2,1,1290,6272,1,890,400,1922
2193320450,655000,4,3,2570,8022,1,1370,1200,1984
2895550330,290000,3,2.5,1600,6848,2,1600,0,2000
8712100790,952500,4,1.5,2550,5055,2,2550,0,1910
7883603700,235000,2,1,1010,7500,1,1010,0,1941
3438502731,323000,3,1.5,1720,7110,1,1720,0,1955
2025049161,1.05e+006,3,2.5,2200,1970,2,1610,590,2008
1222029077,265000,0,0.75,384,213444,1,384,0,2003
5706500385,200000,2,1,1400,9600,1.5,1400,0,1941
4024101254,419995,3,2.25,1830,7500,1,1330,500,1968
7923250090,1.5e+006,3,3,3110,9015,1,1590,1520,1980
6675500082,455000,3,2.5,1600,7829,2,1600,0,1987
4046710180,660000,3,3.5,3600,37982,2,3600,0,1996
1771000760,319000,3,1,1390,12823,1,1390,0,1968
3421069044,390000,3,1.75,2092,250905,1,2092,0,1981
6600000330,718500,3,1.5,1200,6240,1,1030,170,1952
2041000025,474000,2,1,1090,3160,1,840,250,1926
2215500230,615750,4,2,2140,6360,2,1840,300,1945
6639900176,551000,3,2.5,2010,17362,2,2010,0,1994
0104510180,230000,3,2.25,1500,7210,1,1150,350,1984
7202360760,790000,4,2.5,3500,9198,2,3500,0,2004
3879901285,1.23e+006,3,2.5,2660,1967,3,1870,790,2007
1559900110,325000,3,2.25,1440,6443,2,1440,0,1995
7202260040,705000,4,2.75,2780,6207,2,2780,0,2001
7334600730,259000,4,1.75,1580,8856,2,1580,0,1979
1723049419,306000,3,1.5,1250,8700,1,1250,0,1959
3438501081,315000,3,1,970,6828,1,970,0,1928
2916200054,392500,3,1,1100,7650,1,1100,0,1952
3024059149,1.065e+006,4,2.25,3240,12930,2,2730,510,1968
1862400528,350500,2,2.5,1290,1445,3,1290,0,1999
6329000385,825000,4,3.5,3810,9792,2,3810,0,1938
7812800215,235000,4,1,1500,6360,1.5,1500,0,1944
2324079057,650000,3,2,2660,257875,1,1530,1130,1976
1982201485,675000,4,3,2400,3340,1,1200,1200,1964
0740500040,265000,4,1,1860,8505,1,1860,0,1955
3025049052,822500,2,1,1450,7098,1,1450,0,1924
5244801255,705000,3,2.75,2260,4000,2,1540,720,1956
2397101606,2.63e+006,6,4.75,5540,7200,2.5,3950,1590,1909
7234601445,685000,2,1.5,1300,1676,1,1300,0,1943
3693901105,630000,4,2,1610,5000,2,1610,0,1946
3124059006,1.25e+006,4,3.25,3820,24166,2,3310,510,1990
2523039310,359000,4,2.5,1820,11325,1,1390,430,1976
5469650040,784500,4,5,5820,13906,2,3750,2070,1993
5021900945,850000,3,2,2470,8800,2,2470,0,1961
1152700220,410000,3,2.5,3040,6054,2,3040,0,2005
1423900220,252000,4,1.75,1120,8250,1,1120,0,1966
3425059066,618000,5,1.75,1880,18295,1,1880,0,1955
5347200165,265000,3,1,1070,4800,1,970,100,1947
5145100300,465000,3,2,1560,8509,1,790,770,1969
6141100395,240000,2,1,870,6552,1,870,0,1947
5153200506,217000,3,1,1000,12000,1,1000,0,1959
9122000385,415000,4,2.25,2520,4200,1.5,1510,1010,1909
3279000120,274000,2,2,1700,7992,1,950,750,1980
3438503223,420000,5,3,2150,6117,1,1370,780,2003
6788201240,1.0625e+006,4,2.75,1590,6000,1.5,1590,0,1925
4139900120,1.415e+006,4,5.25,4670,43950,2,4670,0,1989
1868900775,618500,3,2,1800,5000,1,1080,720,1942
0764000180,295000,3,1.5,1670,10800,1,1670,0,1956
3578400910,400000,3,2,1010,12252,1,1010,0,1980
5631500191,595000,3,2.5,2550,6677,2,2550,0,2002
6448000100,1.728e+006,4,3,3700,20570,1,1850,1850,1976
1545801340,261000,3,1.75,1350,7686,1,1350,0,1987
5244800915,780000,5,2.5,1660,4000,1.5,1660,0,1929
4217400590,589000,3,1.5,1390,5040,1,1090,300,1947
1683600110,230000,3,1.75,1720,9125,1,1140,580,1981
3630090110,690000,4,3.5,2980,2147,2.5,2490,490,2006
1785400210,524000,4,2.25,2190,15491,2,2190,0,1981
3319500317,380000,2,2.5,1230,987,2,1060,170,2011
2492200256,357500,3,1,1000,4080,1,740,260,1945
3797300110,330000,3,2,2500,10697,1,2500,0,1994
1870400615,635000,5,1.75,2240,4750,1,1120,1120,1920
8823901445,934000,9,3,2820,4480,2,1880,940,1918
3630000150,358500,2,1.75,1400,865,2,1110,290,2005
5727500301,401000,3,1.5,1470,6867,1,1470,0,1955
4167960330,270000,3,2,1820,7750,1,1820,0,1992
2484700155,705000,4,2,2060,6000,1,1370,690,1954
4046700300,325000,3,2,1670,17071,1,1100,570,1988
4365200865,384950,3,1,1540,7740,1,1540,0,1909
6713700205,310000,3,1,1210,9730,1,1210,0,1953
0293800900,829950,4,2.5,3430,42775,2,3430,0,1992
3375800220,353000,3,2.5,2550,6021,2,2550,0,2002
8898700820,170500,2,1,1060,7700,1,820,240,1981
2725069156,885250,4,2.5,3670,49658,2,3670,0,1999
8043700300,2.7e+006,4,3.25,4420,7850,2,3150,1270,2001
2372800100,245000,3,1.5,1550,9126,1,1550,0,1957
7518501822,469000,3,2.5,1190,1290,3,1190,0,2008
1928300620,455000,3,1,1300,3550,1.5,1300,0,1927
1402950100,305000,4,2.5,2430,5959,2,2430,0,2002
2616800600,840000,7,4.5,4290,37607,1.5,4290,0,1982
2597530760,905000,5,3.5,3500,10155,2,2570,930,1996
7345200650,219200,3,2,1680,7000,1.5,1680,0,1968
0259800750,455000,3,1.5,1250,8004,1,1250,0,1965
0723049197,195000,2,1,1020,8100,1,1020,0,1940
2883200775,799000,3,1,1510,4178,2,1510,0,1902
3995700245,285000,2,1,910,8155,1,910,0,1948
1775900220,300000,3,1.5,1320,15053,1,1320,0,1979
7999600180,83000,2,1,900,8580,1,900,0,1918
6145601745,220000,2,1,890,4804,1,890,0,1928
0818500100,174500,2,2.5,1240,2689,2,1240,0,1986
3904920730,695000,4,2.5,2960,10760,2,2960,0,1987
3211000040,255000,3,1.5,1020,11410,1,1020,0,1959
9557300040,539000,5,2.25,2590,7245,1,1510,1080,1973
7011201482,552700,2,1,1100,2800,1,1100,0,1925
5315100667,571500,3,1,1300,6710,1,1300,0,1952
8598900157,263700,3,1,1200,6561,1,1200,0,1950
1346300150,3.3e+006,8,4,7710,11750,3.5,6090,1620,1904
9268710220,186950,2,2,1390,1302,2,1390,0,1986
2224079086,520000,3,1.75,1430,53628,2,1430,0,1985
1761600150,358000,3,1.5,1250,7194,1,1250,0,1969
2123049086,210000,2,0.75,840,49658,1,840,0,1948
4389201095,3.65e+006,5,3.75,5020,8694,2,3970,1050,2007
2802200100,543000,4,2.25,2060,8767,2,2060,0,1983
6706000040,330000,4,2.25,2000,10679,1,1350,650,1960
9828701690,529000,3,2,1530,3400,1,990,540,1907
7891600165,295000,1,1,700,2500,1,700,0,1907
1238500978,365000,3,1,950,8450,1,950,0,1962
8673400141,473000,3,3,1380,1081,3,1380,0,2005
9421500150,403500,3,1,1830,8004,1,1200,630,1960
0148000035,544000,3,1.5,1790,8203,1.5,1790,0,1910
2436700395,621000,3,1,1340,4000,1.5,1340,0,1927
8010100040,672600,3,2.25,1520,5750,2,1400,120,1908
1193000220,689800,2,1.75,1370,3125,1,1090,280,1950
8827901415,613000,3,1.5,1470,4480,1,1130,340,1918
7732410220,808000,4,2.25,2500,8866,2,2500,0,1987
0415100015,301000,3,1,1060,9241,1,1060,0,1956
2130400150,340000,3,1.75,1210,9635,1,1210,0,1987
1555200590,206000,3,1,920,8400,1,920,0,1963
2174503500,550000,3,1.5,1340,6000,1,1340,0,1960
6371500120,325000,2,1,960,4800,1.5,960,0,1912
3904900610,475000,3,2.5,1630,7586,2,1630,0,1986
9527000490,432100,3,1.75,1840,7350,1,1310,530,1976
2457200120,359000,3,2,3085,7280,1,1560,1525,1959
3501600100,490000,3,1,920,4800,1,780,140,1926
1245001295,648360,4,1.75,2260,7005,1,1130,1130,1947
9536601295,340000,3,1.75,1730,11986,1,1730,0,1918
2205700180,545000,3,2,1610,8069,1,1090,520,1955
0623049232,115000,2,0.75,550,7980,1,550,0,1952
9413600100,705640,3,2.25,2400,12350,1,1420,980,1968
6064800410,300000,3,2.25,1960,1585,2,1750,210,2003
8964800975,1.65e+006,4,2.75,3190,14904,1,1940,1250,1949
4473400155,1.1375e+006,4,3.5,3160,4200,2,2180,980,1999
7657000210,280000,3,1.75,1550,7410,1.5,1550,0,1944
8732040180,245000,4,1.75,1930,7650,1,1280,650,1981
9547202950,564000,4,1,1170,4590,1.5,1170,0,1925
1370802770,849000,3,1.75,2520,4534,1,1460,1060,1954
3885803465,698000,3,1.75,1220,7447,1,1220,0,1964
2896610210,319000,3,1,960,8556,1,960,0,1971
3760500455,1.45e+006,3,3.5,4110,15720,1,2230,1880,2000
3324069541,695000,4,3.5,3310,21050,2,2400,910,1992
0003600072,680000,4,2.75,2220,5310,1,1170,1050,1951
2722049218,287500,4,2.25,2250,12000,2,2250,0,1985
1225039052,465000,3,3.25,1510,1850,2,1230,280,2001
8807810090,335000,3,1,1350,14212,1,1350,0,1981
9508850120,602000,4,1.75,2420,37800,1,1880,540,1981
5126300650,482000,3,2.5,2950,6545,2,2950,0,2003
6303400965,220000,5,1,1260,8382,1.5,1260,0,1918
7116500925,206000,4,2,1700,6025,1,1700,0,1978
9241900115,1.1e+006,4,3,3320,5760,2,2120,1200,1954
7202330410,491150,3,2.5,1470,3971,2,1470,0,2003
5151600300,390000,4,2.75,2500,12848,1,2120,380,1975
1332200100,393000,4,2.5,2641,8091,2,2641,0,1998
1939130730,635000,4,2,2260,8457,2,2260,0,1992
0472000015,490000,2,1,1160,5000,1,1160,0,1937
3667500015,770000,4,3.5,3680,2242,2.5,2670,1010,1930
6430000945,665000,2,2,1615,4590,1.5,1615,0,1906
0322059161,287000,3,1,1250,26862,1,1250,0,1965
7905200205,410000,3,1,1230,7020,1,1090,140,1924
1772600665,562000,3,2,2510,5200,1,1470,1040,1925
0203101530,475000,2,2,1540,54450,2,1540,0,1983
0820000018,387500,3,3.25,1860,2218,3,1860,0,2001
1560800110,580000,5,2,2700,10875,1,1540,1160,1962
2869200110,930000,3,2.5,3290,6830,2,3290,0,2000
6151800300,625000,3,1.75,2700,18893,1,2110,590,1948
4475000180,325000,3,2,1570,5600,1,1570,0,1999
3223059206,235000,3,1.75,1950,8712,1,1950,0,1960
5102400025,450000,2,1,1380,4390,1,880,500,1931
0194000145,745000,4,2.75,2410,5650,1.5,2070,340,1909
5560000540,223000,4,2,1200,8470,1,1200,0,1961
3326049077,630000,4,1.75,1770,12278,1,1350,420,1937
3126049517,413450,3,2.5,1540,1614,3,1470,70,2008
2568200740,720000,5,2.75,2860,5379,2,2860,0,2005
2622059138,339000,3,1.5,1740,21980,1,1740,0,1973
6738700205,1.1155e+006,4,3.5,2830,4000,1.5,1840,990,1919
1778350150,839000,5,4,4280,11307,2,2710,1570,1996
6613000930,2.95e+006,4,3.25,3890,25470,2,3030,860,1923
0324069058,568000,4,2,2340,50233,1,1170,1170,1966
4345300180,269000,3,2,1410,10577,1,1410,0,1994
7525100590,382000,2,2,1350,2560,1,1350,0,1974
0955000453,574000,2,2.25,1100,1114,2,900,200,2009
7852150720,405000,3,2.5,2070,4697,2,2070,0,2002
9545220100,572000,3,2.5,2360,9938,1,1690,670,1987
7504000230,675000,4,2.25,2760,12100,2,2760,0,1976
7657000540,165000,4,1,1220,7980,1.5,1220,0,1944
7657000540,260000,4,1,1220,7980,1.5,1220,0,1944
7893203770,196000,3,1,1220,6719,1,1220,0,1953
8035350120,515000,3,2.5,3020,12184,2,3020,0,2003
8820902350,810000,4,3.5,3470,7396,2,2520,950,1979
5089700300,365650,4,2.25,2380,7700,2,2380,0,1977
7234601541,651000,3,3,2260,1834,2,1660,600,2002
7972603931,240000,2,1,720,6345,1,720,0,1943
0318390180,299000,3,2,1730,6007,1,1730,0,2004
2597520900,768000,3,2.5,2660,10928,2,1830,830,1988
5652600556,397380,2,1,1030,5072,1,1030,0,1924
8935100100,476000,4,3,2890,6885,1,1590,1300,1945
4154301371,315000,3,1,890,5200,1,890,0,1957
1105000787,240000,3,2.25,1410,7290,1,940,470,1980
2492201005,325000,2,1,810,4080,1,810,0,1941
9265410090,160000,3,1.75,1370,8006,2,1370,0,1990
2619950740,435000,3,2.5,2260,5100,2,2260,0,2007
9412200330,427500,3,1.75,1430,16200,1,1430,0,1967
1079450410,450000,5,2.5,2510,10240,1,1410,1100,1984
9238900850,688000,3,1.5,1760,4880,1.5,1290,470,1928
2112701165,285000,4,1,1430,3600,1,980,450,1947
2767604067,530000,3,3.25,1510,1125,3,1510,0,2006
0522049122,195000,4,1.75,1320,7694,1,1320,0,1928
8857600360,250200,3,1.5,1180,7384,1,1180,0,1959
4389200761,1.1e+006,3,2.25,1560,8570,1,1080,480,1977
6421000330,732500,3,2.5,2470,10321,2,2470,0,1988
2154900040,194250,3,2.25,2190,8834,1,1390,800,1987
0259801030,526000,4,2,1610,8000,1,1190,420,1966
0326049038,520000,4,2.75,2700,9882,2,2700,0,1958
6384500590,526000,3,1.75,1530,6125,1,1120,410,1958
3023069166,1.13525e+006,5,4,7320,217800,2,7320,0,1992
3826000735,202000,2,1,920,7569,1,920,0,1950
7852110740,645500,4,2.5,2990,8622,2,2990,0,2000
3222049087,570000,1,1,720,7540,1,720,0,1905
0726049131,325000,3,2,1750,9000,1.5,1750,0,1936
9424400110,725000,2,1,2410,5930,2,1930,480,2007
0193300120,192000,3,1.75,1240,10361,1,1240,0,1987
1245001751,560000,2,1,1010,9219,1,1010,0,1960
1386800054,283450,5,2.75,2770,6116,1,1490,1280,1979
6814600150,863000,4,1.75,2800,5400,1,1400,1400,1924
9828200790,815000,4,2,1400,4800,2,1400,0,1986
9476200650,245000,2,1,1020,7679,1,1020,0,1942
9533600100,1.315e+006,4,3,2860,10292,1,2860,0,1953
4139430410,1.156e+006,4,3.5,4270,12305,2,4270,0,1994
7852030330,480000,3,2.5,2270,4488,2,2270,0,1999
7202270930,600000,4,2.5,2560,5593,2,2560,0,2001
0223039254,329950,2,1,900,5220,1,900,0,1956
7843500090,299500,4,2.5,2010,12085,2,2010,0,1986
2491200330,460000,3,2.5,1690,5131,1,1690,0,1941
8113101582,515000,5,3.5,2310,5249,2,1560,750,2000
0993002225,405000,3,2.25,1520,1245,3,1520,0,2004
9530100921,483000,4,1.5,1220,3780,1.5,1220,0,1927
3235390100,377000,4,2.5,2170,11511,2,2170,0,1992
5122400025,568000,4,1.75,2790,17476,1,1450,1340,1956
9297300750,355000,2,1.75,1760,4600,1,850,910,1926
3856900590,640000,4,1.75,2100,3000,1.5,1500,600,1911
4024700100,270000,4,1,1430,5909,1,1070,360,1947
0114100131,559950,5,3.5,2450,8193,2,2450,0,2005
2296700330,515000,4,3,1820,8261,1,1420,400,1969
1995200215,352000,4,1.75,1850,5712,1,1850,0,1954
2287600035,595888,3,1.75,1870,9000,1,1870,0,1958
2923501130,588000,4,2.25,2580,7344,2,2580,0,1977
2485000076,1.05e+006,4,3.25,3680,8580,1,1840,1840,1959
9264921020,260000,3,1.5,1750,7000,2,1750,0,1983
5318100965,1.6e+006,4,3.5,3890,3600,2,2860,1030,2005
3501600215,380000,2,1,1000,4800,1,1000,0,1952
8682230610,802000,2,2.5,2210,6327,1,2210,0,2003
1337800665,1.325e+006,4,3.25,2850,4800,2.5,2700,150,1905
7960100220,710000,4,2.75,2460,3600,2,1640,820,1907
1549500272,600000,3,2.5,2630,77972,2,2630,0,2004
9547202380,707900,3,1,1750,5355,2,1750,0,1929
3518000180,179950,2,1,1100,7323,1,780,320,1982
6792100090,683000,4,2.5,2620,10489,2,2620,0,1990
5702330120,222400,3,2,1200,9566,1,1200,0,1995
1189000910,517000,2,1.5,1920,3408,1,960,960,1912
6204200590,410000,3,2.75,1690,5763,1,1180,510,1985
4443801340,480000,3,1.75,1680,2552,1,840,840,1952
2473370750,430000,3,1.75,3440,10428,1.5,3440,0,1974
2644900109,439950,5,1.75,2190,7500,1,1290,900,1979
0293620220,797500,4,2.5,3270,8223,2,3270,0,1998
2624049115,379000,4,1.5,1280,5460,1.5,1080,200,1920
7942600910,575000,1,1,1310,8667,1.5,1310,0,1918
0643000110,247500,3,1,1660,11060,1,1110,550,1962
9485951460,385000,4,2.75,2700,37011,2,2700,0,1984
6378500230,423000,4,1.75,1940,6909,1,970,970,1941
0430000175,550000,3,1.75,1520,5618,1,1170,350,1953
1493300115,415000,4,1,1620,4329,1.5,1620,0,1927
2024059059,693000,3,2.25,2090,45535,1,1280,810,1952
2922701085,543000,2,1,1070,4700,1,1070,0,1910
4058801780,465000,5,1.75,2000,10246,1,1200,800,1953
2114700384,280000,3,2.5,1020,2217,2,720,300,2004
9829201020,1.388e+006,3,1.25,2400,6653,3,2400,0,1992
6918720100,665000,6,3,2480,9720,2,2480,0,1972
1450100330,237950,3,1.75,1310,7314,1,1310,0,1960
0518000040,440000,4,2.75,2420,10200,1,1220,1200,1962
4242900245,618000,2,1,1890,4700,1,1030,860,1928
1231001130,572000,3,2.25,1860,4000,1.5,1020,840,1920
7445000115,725000,3,1.5,2500,4774,1.5,1450,1050,1940
7802900504,454000,3,1,1970,22144,1,1970,0,1970
4317700085,535000,4,1,1660,10656,1.5,1180,480,1920
8732040580,249000,3,2.5,1850,7200,1,1500,350,1979
3223039149,395000,4,2.75,1970,37026,1,1970,0,1961
4073200757,690000,3,2,1890,6620,1,1890,0,1954
3226049054,526500,3,1.5,1310,7236,1,1170,140,1928
5490700035,325000,4,1.5,1870,7220,2,1870,0,1956
9834200975,495000,3,3,1520,4080,2,1520,0,1948
3305100210,825000,5,3,3070,8474,2,3070,0,2011
3123039042,383000,3,1.5,1400,14850,1.5,1400,0,1910
1105000360,320000,3,1.75,1960,11931,1,980,980,1954
1724079048,475000,3,2.5,2680,87117,1,1340,1340,1989
7437100770,275000,3,2.5,2030,6326,2,2030,0,1993
8925100115,1.15e+006,2,2.25,2320,9300,1.5,1920,400,1937
4019300051,455000,3,1.75,1760,11371,1,1760,0,1959
5300200085,262000,5,1,1870,7800,1,1580,290,1962
9417400110,390000,4,1,1280,4840,1,940,340,1950
9264920870,300000,3,2.25,1730,10030,1,1730,0,1985
9169600209,746300,3,1.75,2060,5721,1,1140,920,1964
6123000090,267000,3,1.5,1030,8223,1,1030,0,1952
2592401080,525000,3,2.5,1720,7950,1.5,1720,0,1972
2423020090,570000,3,1.75,1210,7350,1,1210,0,1977
2968801130,360000,4,2.25,2620,8100,1,1550,1070,1964
3325069064,1.052e+006,3,1,1860,44431,1,1860,0,1947
3629910210,699950,3,2.5,2510,4106,2,2510,0,2003
0622079089,375000,4,2.5,2040,109336,1.5,2040,0,1973
1919800090,625000,4,1.75,2410,6770,1,1220,1190,1924
9274200850,464050,2,1,780,2750,1,780,0,1928
1737320120,470000,5,2.5,2210,9655,1,1460,750,1976
2473100450,330000,4,2,1590,9100,1,1040,550,1967
7923200150,537000,4,1.75,2230,7957,1,2230,0,1967
7524600120,250000,3,2,1560,32137,1,910,650,1976
0424069206,835000,4,2.5,2950,48351,2,2950,0,1986
9523103590,770000,4,1,1480,3750,1.5,1480,0,1912
0161000120,650000,4,2,2850,4497,1.5,1730,1120,1910
1623049241,335000,3,1.75,2390,30409,1,1560,830,1953
7229700165,350000,3,1.75,1740,29597,1,1740,0,1965
3031200205,415000,5,2.75,2060,8906,1,1220,840,1978
2600100110,788000,4,2.5,2680,8778,2,2680,0,1977
5652601140,640000,4,2.75,3150,7379,1.5,2430,720,1915
2473530100,388000,4,2.5,2440,7155,2,2440,0,1993
3558900590,360000,6,1.75,2230,10080,1,1390,840,1969
3558900590,692500,6,1.75,2230,10080,1,1390,840,1969
8121100395,425000,4,1.5,1600,6180,1.5,1600,0,1946
8121100395,645000,4,1.5,1600,6180,1.5,1600,0,1946
7100000110,340000,3,1,1580,8308,1.5,1580,0,1948
0925069042,713000,4,3.25,2840,54400,1,2840,0,1984
7568700740,430000,3,2.75,2550,11160,2,2550,0,1994
7205510230,280000,3,2.25,1700,7210,1,1250,450,1974
9268700040,215000,3,2,1470,2052,1.5,1470,0,1986
2473480210,306000,3,2.5,1680,11193,2,1680,0,1984
4024100120,299900,3,1,1110,8593,1,1110,0,1979
4038200120,534000,5,1.75,2120,8625,1,1200,920,1959
4218400395,1.16e+006,3,2.75,2380,5572,2,1930,450,1939
0669000210,1.165e+006,3,2.5,2670,5000,2,2000,670,1942
6018500015,199990,2,1,890,6430,1,890,0,1935
2600140120,946000,4,3,3140,9058,1,2140,1000,1989
6381500090,295000,4,1,1260,7800,1.5,1260,0,1947
4109600306,475000,2,1,920,5157,1,920,0,1909
2624079010,750000,5,3.5,2990,212137,2,2450,540,1994
7204200025,1.225e+006,4,2.5,3120,49456,2,2590,530,1974
8856003525,183500,3,1,1010,7520,1,1010,0,1975
1695900025,450000,2,1,1010,3627,1,1010,0,1924
3331001285,180000,3,1,1020,5500,1.5,1020,0,1961
0239000155,707000,5,4.5,3540,21217,2,2940,600,1926
1721801280,230000,2,0.75,900,3527,1,900,0,1939
5557700210,192500,3,1,1100,9750,1,1100,0,1966
5416500040,309000,3,2.5,1990,3614,2,1990,0,2005
3271300155,759000,3,1.5,1980,5800,1,1520,460,1949
3303980210,1.115e+006,4,3.75,4040,14212,2,4040,0,2002
1944900090,462000,5,1.75,1250,10530,1,1250,0,1966
7663700401,229000,4,1.5,1820,22814,1.5,1820,0,1920
5694500386,399950,2,2.25,1140,1184,2,1010,130,1999
7227800180,325000,5,2,1730,10532,1,1730,0,1943
2767604558,512000,2,2.25,1170,1313,3,1170,0,2007
5422950040,410000,5,2.75,2910,5802,2,2910,0,2006
2660500283,210000,2,1,970,5500,1,970,0,1956
3308010040,325000,4,2.25,2130,8499,1,1600,530,1975
5423030040,685000,3,2.5,2520,10175,1,1630,890,1979
8604900245,488000,2,2,1360,4688,1,780,580,1944
7349650230,247500,3,2.25,1620,6000,1,1280,340,1998
8902000175,489000,4,2,2120,11479,1,1060,1060,1940
0582000065,725000,4,1.75,2700,6000,1,1450,1250,1953
2123049194,199950,3,1.5,1370,10317,1.5,1370,0,1958
1830300090,670000,5,3,2520,13001,2,2010,510,1973
7522600110,275000,3,2,1540,10410,1,1540,0,1967
5457800740,1e+006,3,1.75,2610,6360,2,2130,480,1924
5115000100,255000,3,2,1490,8371,1.5,1490,0,1984
4038400150,465000,3,1.75,2760,9137,1,1380,1380,1960
1796500100,259000,3,1.75,1260,3604,1,1260,0,2012
8956000100,695000,3,3.5,2630,4713,2,2030,600,2008
3876313120,505000,3,1.75,1800,7210,1,1370,430,1976
6819100040,631500,2,1,1130,2640,1,1130,0,1927
5318101185,630500,3,1,1180,3600,1.5,1180,0,1926
0424069112,999000,4,2.75,2800,19168,2,2800,0,1992
2533300025,740000,3,1.5,1830,4000,1,1350,480,1910
5101404482,650000,3,2.5,2220,6380,1.5,1660,560,1931
8682231210,554000,2,2,1870,5580,1,1870,0,2004
1525069021,400000,3,2.5,2580,214315,1.5,2580,0,1946
5076700115,529941,3,2,1660,10000,1,1010,650,1961
3332000615,310000,3,1,1330,3740,1.5,1330,0,1903
3332000615,389000,3,1,1330,3740,1.5,1330,0,1903
5569620410,731781,3,3,2630,4972,2,2630,0,2006
3009800015,502501,2,1,1100,4750,1,1100,0,1946
6189600040,443000,3,1.75,1810,7950,1,1810,0,1968
9834200365,607000,3,2,2060,4080,1,1060,1000,1921
1959701800,2.1475e+006,3,3.5,4660,5500,2,3040,1620,1909
8917100153,585000,4,2.5,2370,15200,1,1660,710,1975
2344300180,1.027e+006,3,2.5,2430,10500,2,2430,0,1989
3216900100,315000,3,2.5,1880,7000,2,1880,0,1993
0425000065,180000,2,1,1150,5695,1,1150,0,1958
2426069085,322500,3,2,1350,14200,1,1350,0,1989
7199350600,568500,3,2.75,2180,7519,1,1310,870,1981
6909700040,813000,4,2.75,3370,6675,1,1920,1450,1948
4147200040,1.085e+006,5,2.25,3650,13068,1,1850,1800,1976
1062100100,424000,4,2,2100,4857,2,2100,0,1965
2124049254,235000,2,1,670,5600,1,670,0,1903
6841700100,740000,3,3.5,2420,4000,2,1820,600,1907
7544800195,415000,1,1,760,3000,1,760,0,1900
8807810110,432000,3,2.75,2200,14925,1,1100,1100,1982
1126059201,1.26889e+006,5,3.25,4410,35192,2,3880,530,1990
1422200090,676500,3,1.75,1300,2446,1,880,420,1961
0871000065,419000,2,1,720,4592,1,720,0,1943
4054710090,650000,3,2.5,2180,37042,2,2180,0,1998
8075400360,239000,2,1,1130,15190,1,1130,0,1954
9551202875,900000,4,2.5,2230,4372,2,1540,690,1935
4027700930,330000,5,1.75,2100,7347,1,1070,1030,1981
1535204165,510000,3,1.75,2060,58341,1,1100,960,1982
3303860590,465000,4,2.5,3060,6000,2,3060,0,2012
1925069066,1.7e+006,3,2.75,2810,18731,2,2810,0,1974
6137610540,490000,3,2.25,2550,8588,1,2550,0,1989
2525049263,2.68e+006,5,3,4290,20445,2,4290,0,1985
0126059310,1e+006,3,2.25,3040,52302,1,3040,0,2005
4254000540,469950,4,2.75,2530,14178,2,2530,0,1997
5101405067,536000,3,1.75,1300,5413,1.5,1300,0,1925
5468000180,244950,4,2.5,1790,19177,1,1790,0,1966
1930301220,575000,3,1,1530,2400,1,890,640,1928
9282801450,361000,5,2.75,2380,7500,1,1300,1080,1984
4037000925,650000,5,2.25,2400,13450,1,1200,1200,1957
3336000230,230005,2,1,1030,6000,1,830,200,1951
3621059043,293000,4,2.5,3250,235063,1,3250,0,1973
0126049231,445000,3,3,1970,24318,1,1970,0,2010
3331000220,280000,4,1.5,1940,6386,1,1140,800,1954
3904900230,520000,3,2.25,1850,10855,1,1370,480,1985
0525069133,780000,4,3.25,3900,40962,2,3900,0,1991
2721049061,625000,3,1.75,3160,76230,1,2160,1000,1978
5381000411,239950,3,1.75,1440,7200,1,1440,0,1986
0603000150,335000,3,1.5,2040,6000,1,1340,700,1957
3904960690,612000,3,2.5,2120,7401,2,2120,0,1989
7686202730,200000,2,1,830,8000,1,830,0,1954
9264910300,345000,3,1.75,3140,8571,1,1670,1470,1985
1437910090,520000,4,2.5,2410,6440,1,1550,860,1974
2652500740,855000,4,2.25,2190,4080,2,1800,390,1918
9274200735,567500,4,1.75,2190,5060,1,1190,1000,1950
1745000090,208000,3,1.5,1210,7247,1,1210,0,1967
5101405338,452000,3,1.75,1880,16239,1,880,1000,1922
9348500220,555000,3,3,2410,12183,2,2410,0,1988
1066600090,519000,5,2.75,2620,8861,1,1350,1270,1979
3331500455,474950,3,2.25,1850,2575,2,1850,0,2013
1427300120,419000,3,2.25,1760,16418,1,1190,570,1990
1861400068,390000,2,1,860,1800,1,860,0,1909
4040500100,539000,7,2.25,2620,6890,2,2620,0,1961
6117501250,569000,4,1.75,2400,21196,1,1590,810,1956
9523103990,611000,3,1,1850,5000,1.5,1850,0,1922
3221069054,760000,3,2.5,4040,147856,2,4040,0,2004
8838900032,732000,3,2,1940,55756,1,1940,0,1954
1455100355,1.675e+006,3,2.5,3490,8343,2,2150,1340,1939
1853080120,919950,5,2.75,3170,7062,2,3170,0,2014
2806800120,400000,4,2.5,2530,7563,1,1440,1090,1978
3216000090,785000,4,2.5,3230,21781,2,3230,0,1993
1525059165,835000,3,2.25,2120,54014,2,2120,0,1964
8901000835,640500,2,1.75,1640,6750,1,1340,300,1939
8001400300,310000,4,2.5,2130,9013,2,2130,0,1988
1138000450,355000,4,1,1440,7215,1.5,1440,0,1969
2485000100,685000,3,1.75,1940,7313,1,1440,500,1960
7689600215,202500,3,1,1120,8576,1,1120,0,1943
7852010940,540000,3,2.5,2400,5817,2,2400,0,1998
0739980360,295000,4,2.5,1810,4871,2,1810,0,1999
1102001055,518000,3,1,1270,6612,1.5,1270,0,1927
2781250970,250000,2,1.75,1350,4023,1,1350,0,2005
3624079067,330000,2,2,1550,435600,1.5,1550,0,1972
4443800785,481000,2,1,1620,3880,1,920,700,1924
3303900090,898000,3,2.25,2650,12845,1,1770,880,1977
0686530530,570000,5,1.75,2510,9750,1.5,2510,0,1969
4254000220,475000,4,2.5,2040,16200,2,2040,0,1997
7575600610,265000,3,2.5,1660,5250,2,1660,0,1988
7631800110,380000,3,2.5,1980,17342,2,1580,400,1984
7732410120,790000,4,2.5,2690,8036,2,2690,0,1987
2493200040,620000,2,2.25,2910,6110,2,2910,0,1985
2568300040,709050,4,3.5,2720,9000,2,2670,50,1997
1781500385,296500,3,1,1280,5100,1,1280,0,1948
0626710220,475000,3,2.5,2160,35912,2,2160,0,1982
9414500230,440000,3,2.25,1760,10835,1,1290,470,1976
6638900405,405000,2,1,800,6016,1,800,0,1942
7327902612,269500,2,1,930,4000,1,730,200,1943
7923600330,520000,5,1.75,2040,5280,1,1020,1020,1961
2011400782,229500,1,1,1180,22000,1,1180,0,1948
0821049149,335000,4,1.75,2000,10890,1,1390,610,1961
4054700300,680000,4,2.75,3310,50951,2,3310,0,1998
3931900580,1.389e+006,4,3.5,3130,3900,2,2550,580,2008
2485000165,740000,4,2.5,2300,9900,1,1600,700,1961
1117000150,270000,3,2.25,2140,9990,1,2140,0,1962
4321200600,510000,4,2,2210,5572,1.5,1760,450,1911
0123039364,300000,2,1,970,13700,1,970,0,1949
2175100205,1.29889e+006,5,2.25,2690,10800,1,2020,670,1956
8813400165,675000,4,2,1890,5188,1.5,1670,220,1940
2597531020,925850,6,3.25,3140,14923,2,3140,0,1991
0723069013,255500,2,1,1440,43560,1,1150,290,1965
1137800230,450000,3,2.5,2910,17172,2,2910,0,1989
3221069057,280000,3,1,1310,22652,1,1310,0,1968
3832500230,245000,4,2.25,2140,8800,2,2140,0,1963
1138010220,344950,3,1,1090,6712,1,1090,0,1972
3205500230,381000,3,1.75,1330,7216,1,1330,0,1969
4389201241,1.945e+006,4,4,4690,6900,2,3480,1210,2001
9808700025,1.5e+006,3,1.5,1910,21374,1,1910,0,1955
4399210110,232603,3,1.75,1750,11461,2,1750,0,1976
7972602490,220000,5,2.5,1760,10200,1.5,1760,0,1925
2128000180,600000,4,1.75,1810,7700,1,1390,420,1977
4345000090,239000,3,2.5,1360,5754,2,1360,0,1994
6413100242,400000,3,1.75,1730,9211,1,1730,0,1961
4218400455,2.18e+006,6,2.75,4710,11000,2,3690,1020,1931
1568100220,350000,3,1,1010,8551,1,1010,0,1953
1626069220,562000,3,2.5,2400,97138,2,2400,0,1983
3342103149,380000,3,1.5,1540,8400,1,1540,0,1968
8127700410,511200,4,1.75,1480,7875,1,740,740,1927
3629970090,680000,4,2.5,2520,5000,2,2520,0,2004
8910500237,350000,3,3.25,1210,941,2,1000,210,2002
0621069218,410000,5,2.5,2670,184140,1,1410,1260,1980
3394100230,1.05e+006,4,2.5,3030,12590,1.5,3030,0,1988
8682211030,391265,3,2,1440,3900,1,1440,0,2002
5427100150,1.41e+006,4,2.25,3250,16684,2,3250,0,1979
7579200600,575000,3,2,1750,5750,1,870,880,1956
7302000610,316000,4,1.5,2120,46173,2,2120,0,1974
3004800175,165000,3,1,1050,5156,1.5,1050,0,1919
2397101055,850000,3,2.25,1950,3600,1.5,1430,520,1911
2354300845,210000,3,1,1020,6000,1,1020,0,1900
0984220330,325000,4,2.5,1820,9161,1,1220,600,1975
7273100026,682000,4,2.5,2390,53941,2,2390,0,1989
6386200100,430000,3,2.5,1400,7508,2,1400,0,1987
9324800025,325500,3,1.5,1540,8110,1,1190,350,1959
4058800930,385000,3,1.75,2370,6360,1,1280,1090,1954
1972201161,435000,1,1,670,1800,1,670,0,1905
2202500025,550000,4,1,2420,15520,2,2420,0,1945
4077800258,400000,3,1,1000,7800,1,860,140,1930
2558700220,503000,4,2.75,2100,7350,1,1240,860,1978
0290200230,676000,4,2.5,2800,5368,2,2800,0,2003
1951100100,180000,3,1,940,11055,1.5,940,0,1959
9499200220,234000,3,2,1640,5280,1.5,1640,0,1910
0999000215,734200,4,2.5,2760,5000,1.5,1680,1080,1928
0822069118,920000,3,3.25,3660,66211,2,3660,0,2003
2425049066,1.92e+006,4,2.5,3070,34412,1,2070,1000,1950
7950700110,224000,3,1.75,1100,10125,1,1100,0,1969
9253900408,1.4e+006,3,2.75,3130,19530,1,1690,1440,1947
3313600077,185000,3,1,1320,7155,1,1320,0,1961
0452001540,554600,3,1.75,1470,5000,1.5,1470,0,1900
3832710210,268000,3,1.75,1480,8009,1,980,500,1980
8563000300,675000,4,2.25,2260,8715,1,1530,730,1976
1313000650,620000,4,2.25,2210,10039,1,1710,500,1967
3424069066,396450,3,1.75,1540,12446,1,1540,0,1967
2206500300,565000,5,1.75,1910,9720,1,1390,520,1955
3083001095,410000,3,1.75,1760,3520,1,1160,600,1966
0809002290,1.19e+006,4,3,2240,6000,1.5,1270,970,1914
6669070220,716125,3,2.25,2110,7279,1,2110,0,1984
2325069054,225000,2,1,1396,111949,1,1396,0,1940
8820901792,640000,4,2.75,3040,7274,2,2320,720,1986
3488300110,374000,2,1,1140,5650,1,980,160,1920
3971700330,415000,4,2,1780,12161,1,1160,620,1950
5561400220,592500,4,2.5,3370,35150,1,1770,1600,1993
2979800762,365000,3,2.5,1484,1761,3,1484,0,2003
6600220300,600000,4,2.5,2230,12753,1,1180,1050,1981
2817910220,465000,4,2.5,2820,39413,2,2820,0,1989
7696620100,254999,3,1,1580,7560,1,1000,580,1976
7760400900,279000,4,2.5,2040,8076,2,2040,0,1994
3353404265,460000,3,2.5,2720,40813,2,2720,0,2001
9828702666,507000,4,2.25,1490,956,2,1020,470,2005
1823059223,291000,3,1.75,1560,9788,1,1560,0,1964
2197600388,350000,2,1.5,830,1077,2,830,0,2006
4239400300,90000,3,1,980,2490,2,980,0,1969
1328300820,329000,3,1.75,1980,7000,1,1360,620,1977
7805450870,909000,4,2.5,3680,11648,2,3680,0,1986
0419000035,187000,2,1,860,5400,1,860,0,1953
3131201105,580000,3,1.75,1850,5100,1,1020,830,1909
0112900110,345000,3,2.5,1620,5992,2,1620,0,2001
5249802240,497000,4,2.5,2240,7200,2,2240,0,1995
7950302345,345000,3,1,1010,3060,1.5,1010,0,1904
2473371570,313500,3,1.75,1610,7350,1,1610,0,1974
3982700088,910000,3,2.5,2720,7250,2,2720,0,1990
3448000755,399950,3,1.5,2080,5244,1,1190,890,1959
1446400615,268000,4,2,1930,6600,1,1030,900,1967
2484700145,559000,4,1.75,2250,8458,1,1450,800,1954
1753500100,309000,3,2.25,1980,8755,1,1300,680,1963
7853300770,410000,3,2.5,1960,4400,2,1960,0,2006
7236100015,259000,3,1,1320,8625,1,1320,0,1957
1959701695,950000,5,2,2940,5500,2,2340,600,1909
4024101421,320000,4,1,1460,7200,1.5,1460,0,1955
0327000165,1.15e+006,4,2.5,2330,30122,1,1490,840,1951
7893800534,394250,3,2,2620,10107,1,2620,0,1982
6430500191,315000,1,1,700,3876,1,700,0,1910
2354300835,480000,2,2,1140,12000,1,1140,0,1943
9510300220,556000,3,2.5,2750,35440,2,2750,0,1994
7852130410,450000,3,2.5,2480,5647,2,2480,0,2002
5101406522,420000,3,1.5,1130,5413,1,940,190,1946
2768200090,890000,6,3.75,2770,5000,1,1870,900,1969
1761300650,295000,4,2,1710,8814,1,1030,680,1975
1081330210,410000,4,2.25,2150,27345,2,2150,0,1976
4137070090,308900,3,2.5,2250,7294,2,2250,0,1994
0327000100,1.161e+006,4,2.5,2960,26742,1,1480,1480,1949
8682281510,665000,2,2.5,2300,6984,1,2300,0,2006
3297700100,577000,3,1.75,1740,5500,1,970,770,1953
7518506717,959000,3,2.5,2830,3750,3,2830,0,2014
0065000210,471000,2,1.75,1240,6417,1,1240,0,1924
3905040590,560000,3,2.5,2180,7169,2,2180,0,1990
5451210150,955000,5,2.25,2510,9887,2,2510,0,1972
1778360150,1.24e+006,7,5.5,6630,13782,2,4930,1700,2004
6649900301,579000,3,2.5,2300,18540,1,1800,500,1961
9264901490,335000,4,2.25,3220,7889,2,3220,0,1978
7853220910,485000,3,2.5,2270,7887,2,2270,0,2004
9346700150,552000,3,2.5,1840,9900,1,1840,0,1978
2327000110,950000,4,3.25,3820,15293,2,3820,0,2003
7137900490,203700,3,2,1660,7958,1,1130,530,1983
9264960850,412000,4,3.5,3360,9767,2,2450,910,1990
1545808960,237500,3,2,1350,8960,1,1350,0,1986
0486000085,866800,4,3.5,2970,5000,2,2200,770,2001
7977200945,425000,3,1,1000,5100,1,860,140,1946
3056700150,200000,3,2,1190,6833,1,1190,0,1995
7896300150,280000,3,1.75,1670,6034,1,990,680,1957
7399100210,140000,3,1.5,1200,2002,2,1200,0,1966
2473370110,370000,5,2.5,2250,10400,1,1280,970,1973
2770605420,550000,2,0.75,1040,4000,1,930,110,1909
7856400300,1.4116e+006,2,2.5,3180,9400,2,2610,570,1985
7856400300,1.505e+006,2,2.5,3180,9400,2,2610,570,1985
7923700330,510000,4,1.5,2040,8800,1,1020,1020,1961
5632500110,351000,3,1,1160,10518,1,1160,0,1960
0723049219,210000,3,1,880,10800,1,880,0,1942
2320069111,449999,4,1.75,2290,36900,1.5,1690,600,1938
7972604345,137000,3,1,950,7620,1,950,0,1954
3222069156,270000,3,1,1010,14510,1,1010,0,1974
1722069097,540000,3,2.5,3100,100188,1,1820,1280,1981
4022905473,565000,5,3,2560,12480,1,1590,970,2012
5318101695,940000,4,1.5,2430,3600,2.5,2430,0,1980
5216200090,385000,2,1,830,26329,1,830,0,1928
9526500090,400000,3,3,2090,7634,1,1450,640,2001
0423059039,365000,3,2,2030,8649,1,2030,0,1998
6909700437,353250,2,1,1060,1600,2,1060,0,1979
1205000215,455000,2,1.5,1090,6750,1,950,140,1942
3223039229,475000,4,3.5,3400,234352,2,2500,900,1991
4077800474,571500,4,1.75,1920,7455,1,960,960,1939
1604600227,441000,2,1,1150,3000,1,780,370,1915
9542200220,810000,6,2.75,3970,9500,1,2180,1790,1970
6600220490,550000,3,2.25,1880,11556,2,1880,0,1987
2138700141,736000,2,1,1500,4000,1,1100,400,1933
4046600820,375000,3,1.75,2190,17550,1,2190,0,1989
9430100360,717500,3,2.5,2530,9932,2,2530,0,1995
2447500015,581000,2,1.75,1930,11200,1,1430,500,1951
1524039043,629000,3,2,1510,4560,2,1510,0,1909
2303900100,3.8e+006,3,4.25,5510,35000,2,4910,600,1997
8651400230,225000,3,2,1100,5200,1,1100,0,1969
7437100210,315000,3,2.5,1730,6368,2,1730,0,1993
3630020150,425000,3,2.5,1480,1386,3,1480,0,2005
1773600691,346500,3,1,1150,11802,1,1150,0,1932
5448300150,550000,3,2.25,1950,26500,1,1570,380,1965
2260000210,565000,3,1.75,2380,10450,1,1400,980,1977
6815100085,1.001e+006,4,2,3100,8000,1.5,2040,1060,1939
5141000720,400000,2,2,2010,3797,1.5,1450,560,1922
9276200455,724950,4,2,2270,5760,2,2270,0,1909
5459500165,623000,3,1.75,2050,16313,1,2050,0,1973
9828701295,295000,2,1,650,5400,1,650,0,1950
0164000261,700000,4,3.25,2780,7875,2,2780,0,2006
2767704682,482000,2,1.5,1300,1229,2,1160,140,2000
6791050450,770000,3,2.5,2730,11380,2,2730,0,1995
1221039066,310000,4,2.5,3140,22100,1,1820,1320,1960
0686300450,720000,4,2.25,2410,8400,2,2410,0,1965
3822200087,355000,3,1,1180,5965,1.5,1180,0,1928
6669250100,512000,4,2.5,2600,4506,2,2600,0,2005
1453602310,303000,2,1.5,1400,1650,3,1400,0,1999
0984200690,299000,5,2.5,2220,9360,1,1110,1110,1968
5468770180,285000,3,2.5,1660,6263,2,1660,0,2003
5459500100,680000,3,1.75,2330,9652,1,1590,740,1968
2968801605,285000,4,1.75,1440,6720,1,720,720,1954
2141310580,707000,4,2.25,2920,17023,1,1690,1230,1977
2325039067,690000,3,2,1760,6428,1,980,780,1942
2426059103,872000,4,2.25,2860,40284,2,2860,0,1983
3541600450,290000,4,1.75,2090,12750,1,1360,730,1967
5631501161,425000,4,1.75,1910,16785,1,1110,800,1981
3224510300,925000,3,2.75,3280,10558,1,2040,1240,1979
4027700466,340500,3,1,1770,12458,1,1770,0,1957
1702901500,365000,2,1,920,6600,1,920,0,1910
8146300205,725000,3,1.75,1690,8489,1,1690,0,1959
3526039019,811000,3,3,2470,7410,2,1860,610,1977
5230300210,299000,3,1,1040,9514,1,1040,0,1969
7907600100,287500,4,2,1220,9147,1,1220,0,1953
9322800210,879950,4,2.25,3500,13875,1,1830,1670,1938
3352400661,135900,2,1,760,3800,1,760,0,1950
3625710100,1.225e+006,4,2.25,3070,16028,1,1870,1200,1976
3626039207,522500,4,1.75,2100,6480,1,1300,800,1947
7568700215,399500,4,1.5,1660,6617,1,1660,0,1947
1604600540,450000,3,1,1430,5960,1.5,1430,0,1917
1421039067,218000,4,1,1620,17500,1,1620,0,1962
7137970210,289999,3,2,1490,9285,1,1490,0,1995
2767603255,540000,2,1,1170,4750,1,1170,0,1903
3575303700,324950,3,1,1240,7500,1,1240,0,1976
1702901340,718500,3,2,2910,6600,2,1920,990,1900
2320069014,495000,3,2,2660,192099,1,2660,0,1964
3141600600,260000,6,2,2220,8797,1,2220,0,1977
2201501015,430000,4,1.5,1920,10000,1,1070,850,1954
3782760040,402500,3,3.25,2780,4002,2,2780,0,2009
6613001241,1.415e+006,4,3,3110,4408,2.5,2510,600,1931
3276980120,275000,3,2.25,1820,9766,1,1450,370,1987
1321400650,250000,3,2.25,1765,7652,2,1765,0,1996
0643300180,665000,3,2.75,1800,9550,1,1320,480,1966
0322059210,425000,3,2.5,2650,144183,1,2650,0,1967
9551201560,760000,2,1,1410,3600,1.5,1310,100,1925
7202330330,447000,3,2.5,1650,3076,2,1650,0,2003
5153900150,205000,3,1,1180,8240,1,1180,0,1967
1788700230,191000,3,1.5,800,8850,1,800,0,1959
0049000051,350000,2,1.75,1430,7921,1,1430,0,1983
3343301393,789888,5,3.5,3300,7860,2,2410,890,2001
2832100215,443000,2,1,1220,10170,1,980,240,1948
1980200015,695000,4,3.5,3530,7202,2,2660,870,2000
1825049013,560000,4,2,1380,4048,1.5,1380,0,1906
7550800015,550000,3,1.75,1410,5000,1,810,600,1923
8682230760,850000,2,2.5,3360,6750,2,3360,0,2004
8645511500,352750,4,2.75,2270,24237,1,1360,910,1977
8567450220,550000,4,2.5,2890,9045,2,2890,0,2001
1556200205,774900,5,1,1750,3861,1.5,1750,0,1903
9476200580,250000,3,1,1010,8711,1,1010,0,1944
8965410150,962800,4,2.5,3780,23623,2,3780,0,1997
5031300011,299500,3,1.75,1880,11700,1,1880,0,1968
5101408735,250000,2,1,800,5220,1,800,0,1943
2623069010,745000,5,4,4720,493534,2,3960,760,1975
2624089040,279475,2,1,1060,10600,1.5,1060,0,1968
3345700165,450000,3,2.25,2530,27227,2,2530,0,1987
0379000051,307700,5,2.25,1980,13132,1,1260,720,1962
0871000155,665000,3,1,1650,5102,1,1300,350,1953
7852020580,375000,3,2.75,1890,3930,2,1890,0,1999
7298050110,420000,4,2.5,3360,11637,2,3360,0,1990
2114700615,148000,2,1,630,4200,1,630,0,1930
0809001965,707000,3,1.5,1980,4000,2,1980,0,1919
9557200090,399000,3,1,990,4250,1,840,150,1924
5126210360,570000,4,2.5,3420,115434,2,3420,0,1989
3528000210,853000,4,2.25,3440,35025,2,3440,0,1988
0424059052,400000,3,1,1300,14138,1,1300,0,1943
0594000115,615000,2,1.75,2040,28593,1.5,2040,0,1919
2207100740,463000,3,1,1250,7700,1,1250,0,1955
7784000100,600000,4,2.5,1960,14242,1,1290,670,1958
3732800495,429000,5,2.5,2720,8120,1,1360,1360,1970
2025059131,980000,4,4.25,3250,11780,2,2360,890,1944
6699000740,359500,6,3.75,3190,4700,2,3190,0,2003
8651610580,715000,4,2.5,2570,7980,2,2570,0,1998
5412300100,240000,3,1.75,1420,6984,1,980,440,1980
8096600100,455000,4,2,2120,9442,1,1060,1060,1968
0722079015,610000,3,2.5,2080,167270,1,2080,0,2000
0339350150,675000,3,2.75,2740,5735,2,2740,0,2004
2560805440,283500,3,1.75,1250,5375,1,1250,0,1985
7131300047,235000,2,1,2150,4500,1.5,1260,890,1917
3459600180,827000,4,2.5,3230,12100,1,1870,1360,1977
7663700663,353000,2,1,860,8511,1,860,0,1949
5415350770,747500,4,2.5,2810,11902,2,2810,0,1993
3083000940,341000,2,1,1040,4000,1,1040,0,1914
1670400090,182000,3,1,1160,18055,1,1160,0,1950
2781250610,250000,3,2,1470,2781,2,1470,0,2003
3764500090,655000,4,3.5,2350,13402,2,1670,680,1994
7401000040,405000,3,2.25,1660,8307,1,1660,0,1961
4323700230,390000,4,1.75,2020,9750,1,1100,920,1975
3500100047,275400,2,1,890,8180,1,890,0,1947
3885807362,791000,3,2.25,2430,5500,2,1810,620,1989
7199340650,424500,3,1.75,1460,7700,1,1460,0,1979
5014000120,430000,3,1,980,7200,1,980,0,1950
3758900037,865000,4,2.5,2580,10631,2,2580,0,1992
2724201202,163000,2,2,1250,7543,1,1250,0,1962
7855600730,920000,4,2.75,3140,9085,1,1570,1570,1961
7151700360,1.02895e+006,5,3.25,2680,3011,2,1870,810,1910
3811300090,325000,3,1.75,1810,8048,1,1290,520,1983
0538000450,315000,5,2.5,2090,4698,2,2090,0,1998
6303400475,227000,4,1,1120,8763,1,1120,0,1971
3388110230,179000,4,1.75,1790,7175,1.5,1410,380,1900
9834201215,276000,2,1,870,2676,1,820,50,2004
0844000375,335000,4,1.5,3160,19745,1.5,1840,1320,1968
3816700150,430000,3,2,2350,12480,1,1600,750,1981
7237301210,266490,3,2.5,1810,4113,2,1810,0,2004
0130000175,655000,4,2.75,3160,8197,1,1580,1580,1962
9468200175,635500,3,2,1660,3600,1,1000,660,1939
8643200061,235000,5,2.5,2500,9583,1,1300,1200,1979
7805460760,885000,3,2.5,2880,11443,2,2880,0,1986
6713700155,352500,3,1,1470,8400,1,1470,0,1953
3236500220,450000,3,2.5,1460,7573,2,1460,0,1983
3625049042,3.635e+006,5,6,5490,19897,2,5490,0,2005
7935000450,1.05e+006,3,2.25,2480,15022,1,1330,1150,1967
1324300018,476000,2,2.25,1140,1332,3,1140,0,1999
4123820450,375000,3,2.5,1830,13042,2,1830,0,1990
9325200120,600600,4,3.5,3110,6829,2,3110,0,2014
3918400097,567000,4,1.75,2630,11213,1,1430,1200,1948
8126300410,650000,4,1.75,2390,12000,1,1470,920,1979
7227800040,190000,5,2,1750,10284,1,1750,0,1943
1020069042,858000,4,3.5,4370,422967,1,2580,1790,1978
3213200245,435500,1,1.75,1020,4512,1,770,250,1937
0455000760,685000,3,2,2500,6733,1,1770,730,1979
0104510230,252000,3,2,1540,7210,2,1540,0,1984
4140090110,512500,4,2.25,2200,6900,2,2200,0,1975
6072500490,423800,3,2.5,1940,7415,2,1940,0,1965
6705120100,460000,3,2.25,1453,2225,2,1453,0,1986
3764390100,434000,3,2.75,1830,3200,2,1830,0,1991
2988800011,244000,3,1,2000,15900,1,1000,1000,1948
1073100065,348125,3,1,1400,8451,1.5,1400,0,1953
1136100062,585000,4,3.25,2400,29252,2,2400,0,1982
3356402020,230000,3,1,1390,16000,1,1390,0,1960
8039900180,450000,3,2,1680,11250,1,1680,0,1967
4174600391,393000,5,2,1820,5054,1,910,910,1970
6865200981,517000,2,1,1140,3750,1,1140,0,1925
1236900090,400000,3,1,1060,12690,1,1060,0,1969
0925069152,890000,2,1.75,3050,50965,2,3050,0,1991
9456200405,205950,3,1,970,11963,1,970,0,1970
2420069220,209000,3,1,1320,3954,1.5,1320,0,1912
6381501965,430000,4,1.75,1890,6000,1,1110,780,1947
9191201325,534000,4,1.75,2040,2750,1.5,1260,780,1926
9547202245,735000,4,3,2370,3672,1.5,1650,720,1916
1924069115,873000,3,2.25,2720,54450,2,2720,0,1997
8121200970,475000,4,2.25,1970,7532,1,1390,580,1983
0323049176,325000,3,1.75,2180,10230,1,1090,1090,1961
0826079047,500000,3,2.25,2990,216057,2,2990,0,1994
8078550610,279000,4,2.75,2180,8475,1,1330,850,1987
3904930530,350000,3,2,1440,5469,1,1440,0,1988
7504020970,660000,4,2.25,3180,13653,2,3180,0,1978
8642600090,324950,2,1.5,1643,14616,1,1643,0,1954
2239000011,500000,4,2,1530,7816,1,1530,0,1955
9382200121,187300,2,1,1310,7697,1,850,460,1950
7942601475,345600,5,3.5,2800,5120,2.5,2800,0,1903
7375300100,400000,3,1.5,1510,7642,1,1510,0,1959
7974200457,935000,5,3,2700,5001,2,2700,0,2009
0923059206,374000,4,1.75,2220,15600,1,1140,1080,1963
0782700150,328000,3,1.75,1440,45302,2,1440,0,1977
2144800146,257500,3,2,1300,9334,1,1300,0,1981
1337800220,1.003e+006,4,2.5,2230,3600,2,1630,600,1906
3530410081,216500,2,1.75,1390,4482,1,1390,0,1980
1525059198,1.185e+006,3,2.25,2760,40946,2,2760,0,1978
8665000040,360000,4,2.5,3200,7282,2,3200,0,2007
5016001619,699999,3,0.75,1240,4000,1,1240,0,1968
0826069184,535000,3,2.5,1960,47044,2,1960,0,1978
0123039147,464950,3,2,2190,19800,1,2190,0,1994
8089510150,925000,4,2.5,3540,18168,2,3540,0,1996
8818400450,930000,3,3.25,2640,4080,2,1840,800,1912
6324000115,727500,3,2,2660,5000,1.5,1940,720,1910
1133000694,325000,4,1.75,1670,9500,1,1670,0,1976
4441300325,695000,3,3.25,3080,12100,2,2080,1000,1984
3288301010,585000,4,2.75,2890,6825,1,1560,1330,1973
8125200481,319000,3,2.25,1800,9597,1,1200,600,1963
8857600540,265000,6,2.5,2000,7650,1.5,1790,210,1960
1901600090,359000,5,1.75,1940,6654,1.5,1940,0,1953
1901600090,390000,5,1.75,1940,6654,1.5,1940,0,1953
9144300120,374500,3,1,960,9531,1,960,0,1969
3401700031,661000,2,1.5,1750,46173,2,1750,0,1964
5332200375,900000,3,2.5,2320,5000,2,1620,700,1907
8582400015,600000,5,2.5,2380,8204,1,1540,840,1957
4131900042,2e+006,5,4.25,6490,10862,2,3940,2550,1991
3964400120,512500,4,1.75,1620,4240,1.5,1620,0,1916
2212600040,229500,3,1.75,1770,33224,1,1770,0,1968
8562750300,589000,3,2.5,2320,5663,2,2320,0,2003
2705600067,539950,3,2.5,1330,2183,3,1330,0,2014
3023049143,640000,4,2.5,3420,21344,2,3420,0,2002
8944300110,218250,3,1,1270,7344,1,970,300,1967
7277100395,675000,4,3.5,2550,3600,2,1880,670,1997
9407001830,338000,5,2,1860,9000,2,1860,0,1980
4406000620,231750,3,1,1020,7615,1,1020,0,1981
2414600366,199900,1,1,720,7140,1,720,0,1930
0098000870,1.059e+006,4,3.5,4460,16271,2,4460,0,2001
9211500230,263000,4,2.75,1830,7315,1,1250,580,1979
3600600065,279950,3,1.5,1520,7200,1,1160,360,1990
7177300090,395000,3,1.5,1080,2940,1.5,1080,0,1920
6664900410,252500,3,2,1900,8002,1,1900,0,1991
1853000530,1.15e+006,4,3.75,5300,37034,2,5300,0,1989
3751604653,205000,3,1,1370,10708,1,1370,0,1969
8563001130,654000,5,2.5,2960,8968,1,1640,1320,1965
1324079029,200000,3,1,960,213008,1,960,0,1933
1236300214,700000,3,2.5,2190,7982,2,2190,0,2004
2525049086,2.72e+006,4,3.25,3990,18115,2,3990,0,1989
8822900115,306000,2,1.75,1200,2622,1,800,400,1956
3832080610,270000,3,2.5,1780,5015,2,1780,0,2010
1657300450,340000,3,2.25,2630,9916,2,2630,0,1988
1151100035,450000,4,2.5,2300,19250,1,2300,0,1955
3876311490,580000,4,2.75,3210,6825,1,1810,1400,1975
9297300590,435000,4,1.75,2290,4400,1,1290,1000,1959
3260350100,690000,4,2.5,2780,4688,2,2780,0,2003
3886902615,720000,4,2.5,2650,11520,2,2110,540,1988
2193300620,403000,3,2.25,1840,13020,1,1390,450,1980
7016100120,440000,3,2.75,1560,7392,1,1030,530,1972
8857600220,178500,3,1,1200,8470,1,1200,0,1961
1645000580,270000,4,2.5,1900,8282,1,1900,0,1968
4337600205,129888,2,1,710,9900,1,710,0,1943
1545805730,260000,3,1.75,1360,15210,1,1360,0,1987
8650100120,339950,5,2.5,2990,7292,2,2990,0,1990
4047200820,250000,3,1,1640,26127,2,1640,0,1975
1822059156,680000,3,3.5,3650,103672,1,2050,1600,2011
8812401450,660000,10,3,2920,3745,2,1860,1060,1913
1854750090,1.225e+006,3,3.5,3680,11491,2,3680,0,1999
6071200455,550000,3,2,1830,9152,1,1830,0,1959
6790200110,675000,5,2.75,2570,12906,2,2570,0,1987
6710100131,981000,3,3.25,2730,9588,2,1900,830,1984
8856004415,168000,3,1,1150,8000,1.5,1150,0,1913
3276940100,1e+006,4,3,4260,18687,2,4260,0,1996
9407100300,320000,3,1,1260,9600,1,1260,0,1970
1224049095,959000,6,3.25,4440,17424,1,2220,2220,1959
7899800586,372000,4,1,2300,7680,1,1270,1030,1959
2607730110,391500,3,2.5,1920,9625,2,1920,0,1993
1781500180,390000,2,1,1080,4725,1.5,1080,0,1944
2341800195,302000,2,1,890,5000,1,890,0,1947
0052000067,495000,3,3.5,1650,1577,2,1100,550,2012
1972202023,504500,3,2.5,1820,1545,3,1640,180,1998
2919700540,555000,4,1.75,2320,4800,1.5,2170,150,1918
6613000375,1.55e+006,4,3.5,3260,5000,2,2630,630,1937
2391600735,550000,3,1.5,1730,5750,1,1250,480,1947
1337300145,1.8e+006,4,2.5,3320,8325,2.5,3320,0,1905
9164100035,655000,1,1,1660,5422,1,830,830,1908
0821069025,685000,3,2.5,3290,90796,2,3290,0,1992
1566100555,721000,4,2,2280,8339,1,1220,1060,1954
2397100705,1.51863e+006,4,4.25,3650,5328,1.5,2330,1320,1907
0822069066,365000,4,2.5,1620,219542,2,1620,0,1980
3834000820,458000,3,2,2020,8555,1,1220,800,1957
1432700880,280000,2,1,1150,12861,1,1150,0,1959
3658700395,628000,4,1.75,1940,3060,1,1000,940,1911
1564000410,781500,4,2.5,3440,6332,2,3440,0,2001
0984100450,295000,3,1.75,2000,7560,1,1300,700,1968
4449800063,435000,2,1,750,2786,1,750,0,1947
7694600201,300000,3,1.75,1420,7200,1,1000,420,1979
0844001145,208500,2,1,880,4814,1,880,0,1906
8682281960,930000,2,2.5,2680,11214,1,2680,0,2006
1604600790,316000,2,2,860,3000,1,860,0,1906
1796380330,249900,3,2,1310,6738,1,1310,0,1990
3416600490,675000,3,2.25,1780,4252,2,1540,240,1989
3904901520,447000,3,2.25,1440,4667,2,1440,0,1985
1556200155,675000,3,2,1510,3817,1.5,1510,0,1905
0567000401,546000,4,2.5,2100,1397,3,1580,520,2008
6450300673,310000,3,2,1310,1361,3,1310,0,2003
4440400155,190000,3,1,1280,5100,1,880,400,1961
2450000165,650000,3,1.5,1320,8114,1,1320,0,1951
9828701605,585000,3,2.5,1740,2350,2,1130,610,1995
0856000985,1.4308e+006,4,2.5,2910,7364,2,2910,0,2003
7504100360,565000,4,2.5,2500,12090,1,2500,0,1983
7883606725,174900,3,1,1100,6000,1.5,1100,0,1926
2926049564,360000,3,2.25,1381,1180,3,1381,0,2007
7418700040,234000,3,1,960,9624,1,960,0,1953
3756900027,575000,8,3,3840,15990,1,2530,1310,1961
7237300610,315000,3,2.5,2200,5954,2,2200,0,2004
1312900180,225000,3,1,1250,7820,1,1250,0,1967
3824100211,370000,3,1.5,2380,14500,1,1850,530,1961
0455000395,606000,3,1,1500,3920,1,1000,500,1947
2472950120,272500,3,2,1410,7622,1,1410,0,1983
7977201709,475000,3,1.75,1680,3420,1,960,720,1992
5095400040,270000,3,1,1500,13500,1,1500,0,1968
2324039152,624000,4,1.75,2710,9216,1,1440,1270,1961
1442300035,355000,3,1.75,1730,7416,1.5,1730,0,1954
6145601725,345000,3,1,960,3844,1,960,0,1972
7137950210,342000,4,2.5,2380,7792,2,2380,0,1993
2720069019,316000,3,1.75,1120,98445,1.5,1120,0,1917
1560920040,539950,4,2.5,2960,37430,2,2960,0,1990
7812801785,221347,3,2,1580,6655,1,790,790,1944
8860500300,330000,3,2.5,1870,4657,2,1870,0,2000
6142100090,279000,4,2.5,1810,13000,1,1470,340,1977
4083302225,850000,4,3,2550,3784,1.5,1750,800,1900
2591700037,746000,3,1.75,1910,12321,1,1100,810,1952
5458300580,478000,2,2,1200,1867,1,600,600,1924
3362400650,820000,4,2.75,2420,4635,1.5,2420,0,1905
5553300375,2.16e+006,3,3.5,3080,6495,2,2530,550,1996
2024059111,820000,3,3,3850,38830,2,3850,0,2000
6649900090,887000,3,2,3000,22040,2,2470,530,1942
3356403400,159000,3,1,1360,20000,1,1360,0,1953
2771604190,824000,7,4.25,3670,4000,2,2800,870,1964
6638900265,812000,4,2.5,2270,5000,2,2270,0,2014
8731960540,242000,4,2.5,1750,11400,2,1750,0,1975
7853301400,625000,4,2.5,3550,8048,2,3550,0,2007
0123039176,399888,4,1,2370,30200,1.5,1570,800,1948
4178500150,289000,3,2.25,1670,6600,2,1670,0,1990
7702600930,400000,3,2,1860,12944,1,1860,0,2002
3892500150,1.55e+006,3,2.5,4460,26027,2,4460,0,1992
6021500970,345000,2,1,1080,4000,1,1080,0,1940
6021500970,874950,2,1,1080,4000,1,1080,0,1940
9136100056,875000,3,2.75,2280,4280,1,1280,1000,1917
0205000120,628990,4,2.5,2540,32647,2,2540,0,1996
3019300090,535000,2,3.5,2560,5000,1,1280,1280,1944
5492200090,770126,4,2.75,2390,9300,1,1430,960,1979
1777600900,710000,4,2.5,2870,8995,1,1870,1000,1968
9297301050,465000,3,1.75,1510,4800,1,860,650,1925
5745600040,359000,3,1.75,2200,11520,1,2200,0,1952
2114700090,151000,2,0.75,720,5040,1,720,0,1949
2597530650,820000,3,2.5,2970,9600,2,2970,0,1994
1099600620,160000,3,1.5,960,6497,1,960,0,1970
3693901720,535000,4,1.75,1420,5000,1.5,1420,0,1945
7417100123,365000,3,2.25,1800,9010,1,1300,500,1975
8691410730,708000,4,2.5,3090,5600,2,3090,0,2005
3832300090,215000,3,1,1200,7280,1,1200,0,1967
2525049113,1.95e+006,4,3.5,4065,18713,2,4065,0,1987
1523059103,390000,4,2.5,2570,22215,2,2570,0,1958
3187600100,570000,3,2,1530,5401,1,1530,0,1937
1628700107,383000,3,1.75,1500,13430,1,1500,0,1977
1152700120,370000,4,3,2490,5706,2,2490,0,2005
0808300180,454000,4,2.5,3040,12522,2,3040,0,2000
3585300194,1.4e+006,5,3.25,4140,32700,1,2190,1950,1973
3342700610,371000,4,1.75,1690,10854,1,1690,0,1977
7376300085,530000,3,1.75,1430,10350,1,1430,0,1959
6204000040,608000,4,2.75,2490,9714,1,1400,1090,1983
3992700475,450000,3,1.75,1350,7200,1,1350,0,1954
9510920120,780000,4,2.5,3140,14421,2,3140,0,1994
9485920120,290000,4,2.5,2340,52272,2,2340,0,1978
1685200110,225000,3,1.75,1610,14182,1,1100,510,1978
7574910650,805000,4,2.5,3320,38032,2,3320,0,1991
4178600040,660000,3,2.5,2390,15669,2,2390,0,1991
3793700210,299000,3,1.75,1180,13927,1,1180,0,1962
1972200325,530000,2,2.25,1260,1312,3,1260,0,2007
7010701383,680000,3,2.5,1800,4400,1,1350,450,1970
3353401340,199900,4,1.75,1790,12000,1,1790,0,1944
3352401037,224000,3,1.75,1760,6300,1,1060,700,1963
8802400906,244000,3,1.75,1540,8885,1,1440,100,1980
4443800940,485000,4,1.75,1260,3880,1,860,400,1918
2215450100,330000,4,2.5,2240,7589,2,2240,0,1994
8900000100,509000,4,2,1630,1724,1.5,1030,600,1915
8079010220,440000,4,2.5,2350,7203,2,2350,0,1989
8078050120,244000,3,2,1350,8587,1,1350,0,1998
1773101215,399700,4,1.75,1320,4800,1,870,450,1930
2768100205,519000,4,2.5,1950,2617,1.5,1250,700,1910
5537200043,211000,4,1,2100,9200,1,1050,1050,1959
0868000905,950000,3,2.5,3480,7800,1,1750,1730,1941
8635760490,410000,3,2.5,1830,2839,2,1830,0,1999
3052700245,750000,4,2,2640,5000,2,2040,600,1949
9320901250,133400,3,1,900,2550,1,900,0,1978
2420069042,240000,3,2,1553,6550,1,1553,0,1900
6870300090,539000,3,2.5,1710,2300,2,1570,140,2005
1223089066,688000,4,3,3400,292723,2,3400,0,1998
7974200937,465000,3,1.5,1270,5112,1,1270,0,1950
2998300146,936000,3,1.75,2960,12420,1,1480,1480,1952
7202290650,620000,4,2.5,3040,9606,2,3040,0,2003
1326039061,429950,3,1.75,1430,9750,1,1430,0,1962
4142450330,296475,3,2.5,1520,4170,2,1520,0,2004
6139100076,330000,4,2,1820,9450,1,1100,720,1962
8126300360,445000,3,2.25,1800,11200,1,1270,530,1979
1231000645,846000,4,3.25,2720,4000,2,2070,650,2014
8149600265,725000,4,1.75,1980,5850,1,1380,600,1960
9264950410,369000,4,2.5,2550,7349,2,2550,0,1989
9541800065,625000,3,1.75,2210,16200,1,1390,820,1958
7202330790,535000,3,2,2120,4080,2,2120,0,2003
7335400065,229950,4,1.5,1570,6717,1,1570,0,1911
1313500090,229999,3,1.75,1310,6960,1,1310,0,1974
1797500600,850000,5,3.5,3150,4120,2,2460,690,1911
5561301220,589900,4,4.5,3870,35889,2,2530,1340,2001
5700002165,513000,2,1,1840,4322,1,1160,680,1914
9202650040,401000,3,1,1120,8321,1,1120,0,1941
7211401975,260000,3,2.5,1440,2500,2,1440,0,2006
0126039394,525000,4,2.75,2300,26650,1,2300,0,1950
3204800150,470000,3,3.5,2070,11658,1,1370,700,1977
7686204750,205000,4,1.5,1420,8063,1,940,480,1962
7524950900,620000,3,2.25,2010,7495,1,1570,440,1979
7211400850,229000,3,1.5,1200,5000,1,1200,0,1979
8024202520,445000,2,2,1150,6634,1,860,290,1940
7340600068,215000,2,1,1240,7200,1,1240,0,1967
8682260850,504975,2,2.5,1900,4871,2,1900,0,2005
6804600720,495000,4,2.25,2350,10072,2,2350,0,1980
1865820300,205000,3,1,1120,8342,1,1120,0,1976
3163600076,152275,1,1,1020,6871,1,1020,0,1937
5418500650,586000,4,2.25,1930,8338,1,1930,0,1968
8682220230,779950,2,2.5,2680,7625,1,2680,0,2002
3578401210,557000,4,1.75,2660,11315,2,2660,0,1983
9122001225,610000,4,2.25,2200,7200,1,1220,980,1958
5667100025,405000,3,1.5,1010,7683,1.5,1010,0,1953
5089700750,320000,4,2.25,2310,7490,2,2310,0,1980
3331500650,356000,3,1,920,3863,1,920,0,1970
9528102865,794500,5,3,3030,4120,1.5,1930,1100,1913
6928000590,349000,3,1.75,1590,9620,1,1590,0,1988
1423069162,549000,4,2.25,2740,88426,2,2740,0,1991
7877400245,193000,3,1,960,10761,1,960,0,1962
7430500301,700000,3,1.5,2240,7227,2,1440,800,1977
7852010900,523000,3,2.5,2400,6182,2,2400,0,1998
4022900652,565000,5,3.25,2860,20790,1,1800,1060,1965
7852030790,500000,4,2.5,2960,5027,2,2960,0,2000
3528900330,1.45e+006,4,3.25,3770,4103,2,2710,1060,1925
2623069106,710000,6,3.5,3830,68825,2,3830,0,1995
0088000173,333000,4,2,2750,9001,1,2750,0,2008
3179102305,580000,3,1.75,2100,6874,1,1300,800,1943
5379803386,289950,4,1.75,1500,8400,1,1200,300,1956
8127700845,375000,2,1,710,4618,1,710,0,1925
8562901010,505000,2,3,2770,10800,1.5,1910,860,1984
4058200915,324950,3,1.75,2050,6720,1,1050,1000,1939
8861700110,490000,4,2.25,1960,10275,2,1960,0,1965
6822100155,630000,4,2,1770,6000,2,1770,0,1911
3345700215,595000,3,2.75,3290,22649,2,3290,0,1993
0582000644,872500,4,2,1990,6000,1,1260,730,1956
6126601380,490000,2,1,1760,5250,1,1000,760,1951
3303850330,1.9e+006,4,3.25,5080,27755,2,5080,0,2001
3343902281,310000,2,1,1020,8102,1,1020,0,1956
2023059052,450000,3,1,1350,92721,1,1200,150,1946
7504001430,539000,3,1.5,1740,12000,2,1740,0,1974
9290850330,888550,3,2.5,3540,38322,2,3540,0,1989
7955080300,269950,3,2.5,1520,8720,1,1080,440,1981
3980300371,142000,0,0,290,20875,1,290,0,1963
3755100220,300000,3,1.75,1310,9761,1,1310,0,1967
3425059076,780000,2,3.25,3000,24004,1,2410,590,1952
8728550150,545000,3,2.5,2660,20369,2,2660,0,1992
2108500110,278000,3,2.25,2120,9804,2,2120,0,1994
7941130110,342000,3,2.25,1200,2845,2,1200,0,1986
1545807180,190000,4,1.75,1900,9861,1,1900,0,1967
1972200382,387000,2,1.5,1010,948,3,1010,0,1999
2473420100,279950,3,2.25,1850,7480,2,1850,0,1978
0722059020,550000,6,4.5,4520,40164,2,3580,940,1953
1626079154,439000,3,2,2010,251341,2,1510,500,2003
1152000040,774888,3,2.25,2420,23507,1,2420,0,1969
5152960330,480000,5,2.5,2732,9500,1,1870,862,1975
6431000206,835000,4,2,1910,6960,1.5,1910,0,1941
2397101185,1.5e+006,5,3.5,3520,5400,2,2400,1120,2008
2922700865,771000,4,2,2220,3760,1.5,1370,850,1929
3271800870,1.225e+006,4,2.25,2020,5800,1,1760,260,1941
1562200090,600000,4,2.5,2090,7290,1,1420,670,1966
1431700210,305000,3,1,1580,7424,1,1010,570,1962
2566300100,1.388e+006,5,1.75,2650,11340,1,2650,0,1955
5379806155,216500,3,1,1020,11652,1,1020,0,1971
0952006857,370000,3,2.5,1070,1219,2,720,350,2004
3792400110,492650,4,1.75,2120,9786,1,1640,480,1967
3755100540,431200,5,1.75,1360,10609,1,1060,300,1966
2122059014,277500,4,2,1700,12048,2,1700,0,1990
0110000040,278000,5,1.5,1820,8712,1,1090,730,1960
3876800580,351000,4,1,1430,8400,1,730,700,1969
3127200021,850000,4,3.5,4140,7089,2,3160,980,2003
2397101460,885000,2,2,1313,3600,1,1313,0,1904
1720069146,399950,3,2,1590,87120,1,1590,0,1998
7878400043,185000,3,1.75,1080,9262,1,1080,0,1968
9282801030,440000,5,3,2730,6000,1,1470,1260,1979
6072800265,2.395e+006,4,3.25,3800,19798,2,3800,0,1969
5267000180,299000,3,2.25,2540,9961,1,1320,1220,1969
2722049077,299500,3,1.75,1810,34500,1,1230,580,1980
1115100278,420000,3,1.5,1540,7506,1,1540,0,1961
8075400530,234000,4,1,1390,18000,1,1390,0,1955
1997200245,540000,2,1.75,1460,4800,1,850,610,1950
0926069009,649950,4,2.5,2350,63162,2,2350,0,1994
6381500110,330000,3,1,1160,7912,1,1160,0,1956
7203100850,840000,4,3.25,3500,5960,2,3500,0,2010
3529300330,370000,3,2.5,1980,6922,2,1980,0,1991
3204800330,410000,3,1.5,1250,7700,1,1250,0,1968
6411600411,257000,2,1,770,7200,1,770,0,1951
8685500145,350000,3,1,1920,6710,1,1320,600,1959
7277100610,380000,2,1,1120,7560,1,1120,0,1947
1775800750,344000,3,1,1150,12402,1,1150,0,1969
2856101105,488000,3,2.5,1590,2550,3,1590,0,1985
4443800705,465000,3,1,910,3880,1,780,130,1942
3878900464,229500,2,1.75,1870,6625,1,960,910,1948
8151600900,445000,5,3,2420,11250,2,2420,0,2013
1612500155,246000,4,1.5,2120,7110,1.5,2120,0,1919
4140500180,545000,5,2.5,2730,17240,1,1660,1070,1958
3342103174,518000,4,2.5,2560,5672,2,2560,0,2005
2078500210,565000,4,2.5,2620,10016,2,2620,0,1996
3955900910,445000,4,2.5,2760,8558,2,2760,0,2001
3472800068,968000,5,2.5,2900,9799,1,1450,1450,1959
8928100205,725000,3,2,1820,6324,1,910,910,1945
2473400110,315500,3,1.75,1870,8400,1,990,880,1977
2558720120,487585,4,1.75,2010,9211,1,1470,540,1977
2023049361,246500,2,1,940,6000,1,940,0,1954
6821101285,819000,3,1.75,1850,6000,1.5,1650,200,1913
2780910100,349900,5,2.5,2530,4229,2,2530,0,2004
9357000230,267000,3,1,940,4700,1,940,0,1942
3649100015,480000,3,2.25,1820,15000,1,1480,340,1978
1189000180,525000,2,1,1510,3360,1,880,630,1924
3905120610,578000,4,2.5,2070,5415,2,2070,0,1996
0993002177,345000,3,2.5,1380,1547,3,1380,0,2000
6384500535,499000,3,1,1270,6250,1,910,360,1955
7751800115,425000,3,1.5,1390,9680,1,1390,0,1956
4137020820,268000,4,3,1840,7510,2,1840,0,1988
9407000230,240000,3,1,1600,12566,1,1600,0,1971
3306200230,147000,3,1.5,1480,9606,1,1100,380,1964
3888100176,500000,4,2,2120,7806,1,1770,350,1949
7011201325,1.01e+006,4,2.75,2940,5400,1.5,1940,1000,1910
1424130220,991500,4,3,3820,26895,2,3820,0,1995
9165100375,510000,5,2,2740,3838,1,1370,1370,1959
1651500040,1.98e+006,4,4,4360,12081,2,4360,0,2007
8929000090,484998,4,2.5,1540,1870,2,1540,0,2014
3303850360,1.28e+006,4,3.5,4660,17398,2,4660,0,2003
2011000120,210000,3,1.75,1590,7617,2,1590,0,1986
6751100205,450000,2,1,1180,10720,1,1180,0,1955
5078400035,875000,4,1.75,2360,8286,1,1320,1040,1952
6073300530,529950,4,2.75,1860,7500,1,1220,640,1967
9818700645,415000,3,1.75,1470,4000,1,1070,400,1979
6181700625,590000,4,2,2990,12970,1.5,1960,1030,1948
8718500610,379950,3,1.5,1690,9144,1,1140,550,1956
7950302150,385000,1,1,660,3570,1,660,0,1906
0923000115,588000,3,1.75,2310,7620,2,2310,0,1942
1722800835,252500,2,1,770,2191,1,770,0,1937
7436300180,530000,3,3.5,2320,3174,2,2060,260,1997
1630700276,385000,2,1.5,1370,159865,1,1370,0,1960
2558670110,419000,3,2.25,1700,7650,1,1340,360,1975
0402000110,175000,2,1,960,5508,1,770,190,1951
0442000175,515000,2,1,1150,5664,1,870,280,1948
8825900410,945000,4,2.5,2910,4680,1.5,1850,1060,1937
0984210120,359900,5,2.25,2290,7420,1,1290,1000,1973
8044050040,419950,4,2.5,2260,5164,2,2260,0,1996
2771604370,460000,3,1.75,1300,4000,1,900,400,1953
5028602020,255000,3,2.25,1850,7151,2,1850,0,1989
0643300040,481000,4,1.75,1920,9500,1,1470,450,1966
0643300040,719521,4,1.75,1920,9500,1,1470,450,1966
0224059025,1.08e+006,3,3,4910,43560,2,4000,910,1989
3379200100,334000,4,2.5,2210,6080,1,1410,800,1965
6338000493,675000,4,2.75,2280,3200,1.5,1520,760,1931
0293000068,556000,3,1.75,1640,7437,1,1090,550,1948
6169901095,900000,4,2,1980,7200,2,1700,280,1910
4443800375,400000,3,1,900,4084,1.5,900,0,1910
9376301800,724950,4,1.75,1960,4340,1,980,980,1912
6799300150,321000,4,2.25,1800,4500,2,1800,0,2004
3271800910,1.35692e+006,4,3.5,4270,5800,2,3170,1100,1937
0042000245,171000,4,2,1520,19672,1,1020,500,1920
1625069101,1.36e+006,4,3,5430,108900,2,5430,0,1987
4046700110,323000,3,1.75,1950,15037,1,1950,0,1989
2423600100,491500,4,1.75,2190,125452,1,2190,0,1968
0621069154,226000,4,1.5,1200,10890,1,1200,0,1972
2436200025,580000,6,1.75,2180,4000,1.5,1380,800,1926
9808610410,640000,4,2.5,2320,11259,2,2320,0,1982
1370803640,619790,3,1.75,1040,5097,1,800,240,1944
3779300210,383962,4,2.5,2700,6998,2,2700,0,2001
0424049059,373000,3,2,1400,2445,1,840,560,2002
5422560850,541338,3,2.5,2060,8123,2,1010,1050,1977
0558100065,254922,2,1,780,8160,1,780,0,1953
4442800040,575000,3,2.25,2400,5000,1.5,1440,960,1926
4038600300,650000,4,3,2900,15535,1,1870,1030,1961
5070000120,269950,3,1.5,1740,9547,1,1740,0,1962
0795002450,270950,2,1,780,6250,1,780,0,1942
3579000180,495000,3,2.75,2430,14861,1,1530,900,1988
6821102170,794154,4,2,2210,8556,1,1210,1000,1954
5151900110,340768,3,1.5,1510,11200,1,1510,0,1960
5101407790,375000,2,1,900,5413,1,900,0,1947
2538400040,820000,4,2.5,3670,7000,2,3670,0,2005
1025049266,555000,2,2.25,1160,954,2,960,200,2014
4340610040,312500,2,1.5,1070,1200,2,1070,0,1999
3204300610,450000,2,1,950,4560,1.5,950,0,1925
6793300220,739000,3,2.75,2950,6667,2,2950,0,2003
1568100087,320000,3,2,1420,1716,2,1050,370,2003
4338800600,235000,3,1,1590,13000,1.5,1590,0,1944
7211400535,275500,4,1,1290,5000,1.5,1290,0,1957
8682261140,564000,2,2,1690,4500,1,1690,0,2004
4435000145,263000,4,1.75,1340,8700,1.5,1340,0,1958
0421059018,257000,3,1.75,1397,18000,1,1397,0,1965
1321059013,725000,4,2.5,3750,218506,2,3750,0,1991
2143700406,300000,3,2.25,2000,7560,1,1400,600,1979
8961950410,328000,3,2,2250,7904,1.5,2250,0,1998
1788800770,187500,3,1,840,8400,1,840,0,1959
7518507685,400000,3,1,1100,5100,2,1100,0,1900
2490200220,515000,3,1.5,1660,5100,1,1210,450,1954
0284000025,1.41e+006,2,2,2180,18525,1,1580,600,1952
0522059189,235000,3,1,1460,8400,1,1460,0,1958
7203150330,669000,4,2.5,2470,4945,2,2470,0,2012
3124089060,282000,3,1,1250,13503,1.5,1250,0,1931
7518504130,663000,3,2,1480,3876,1,860,620,1928
7893802670,279900,3,3.25,2240,5000,2,1540,700,1989
2548100180,335000,3,2,1570,7200,1,1570,0,1952
4024100915,689000,4,2.75,3250,10000,2,3250,0,2014
1026069106,413100,3,2.25,1790,231303,1,1250,540,1980
7852020720,506950,3,2.5,2080,4931,2,2080,0,2000
9828702265,500000,3,2.5,1480,1171,3,1480,0,2006
5104511250,540000,5,3,3610,9775,2,3610,0,2003
9828201885,812000,3,2.5,2040,4559,2,2040,0,1998
7525950110,1.2e+006,4,3.25,3850,19842,2,3180,670,1989
3211260120,370000,3,2.25,3230,35306,2,3230,0,1987
7250000065,338000,3,2,2440,23512,1,1640,800,1933
1446400564,185000,4,1,1490,6600,1,1490,0,1969
0224059021,450000,3,1,1150,35415,1,1010,140,1950
6392000625,451000,2,1,900,6000,1,900,0,1944
6817850110,785000,4,2.5,3210,24527,1.5,3210,0,1984
3902100175,850000,5,3,3900,5250,1.5,2620,1280,1931
7205400180,235000,3,1,1240,18000,1,1240,0,1943
7351200295,1.15e+006,3,1.75,1760,6788,2,1760,0,1940
0291310260,377500,3,2.25,1410,1377,2,1290,120,2005
3026059204,825500,3,2.5,2780,11964,2,2780,0,2009
2856102105,1.0595e+006,5,3.25,3230,3825,2,2480,750,2014
3343301343,880000,5,3.5,4600,8764,2,3180,1420,2007
8682302030,413800,3,2,1440,4421,1,1440,0,2007
1048000160,504200,2,1.5,1200,1687,3,1200,0,2008
5714200140,421500,4,3,2793,5703,2,2793,0,2009
1152200030,855169,4,2.5,2970,5050,2,2970,0,2014
3157600075,380000,3,2,1440,3218,1,850,590,2008
1972200554,580000,3,2.25,1480,1026,3,1480,0,2014
9429400060,377000,3,2.5,1870,5333,2,1870,0,2012
0301401610,329900,4,2.75,2475,4000,2,2475,0,2014
1025039326,921800,4,2.5,2950,7024,2,2950,0,2012
9385200041,529500,3,2.25,1410,905,3,1410,0,2014
7237450550,363990,4,2.5,2240,3712,2,2240,0,2014
2862500060,834950,5,2.75,3230,6500,2,3230,0,2014
4046500270,399000,3,2,2100,31550,1,2100,0,2010
2161400060,338900,3,2.25,1936,9495,1,1936,0,2013
2781230070,419950,3,2.5,3120,6000,2,3120,0,2007
4019500160,493000,4,2.5,2070,4270,2,2070,0,2010
6980500030,650000,4,2.5,3700,4500,2,3700,0,2007
1442880260,456000,3,2.5,2130,5205,2,2130,0,2013
9268851860,425000,3,2.25,1620,997,2.5,1540,80,2010
0832700320,348000,3,2.5,1490,2478,3,1490,0,2009
2937300550,1.04089e+006,5,4,4180,7232,2,4180,0,2014
2114700368,299000,2,2.5,1400,1262,2,1160,240,2008
2213000030,1.264e+006,4,3.75,3490,9170,2,3490,0,2012
2626119062,155000,3,1,1300,6098,1,1300,0,2013
7338220160,319500,4,2.5,2730,4962,2,2730,0,2006
2781280310,274000,3,2.5,1830,2517,2,1830,0,2005
3448740070,429000,5,2.5,2340,4500,2,2340,0,2009
2895800710,267800,3,1.75,1410,1899,2,1410,0,2014
0723049434,369950,3,2.5,1930,8254,2,1930,0,2014
2922059212,480000,6,5,3028,18055,2,3028,0,2005
1441000350,440000,4,3.5,3180,4869,2,2390,790,2007
8562790310,839704,4,3.25,2950,4161,2,2210,740,2014
2767604425,535000,3,3.25,1430,1276,3,1430,0,2007
0306000565,290000,2,1.5,1020,1275,3,1020,0,2008
6130500060,370000,3,2.5,1650,1793,3,1650,0,2007
3362400125,405000,3,2,1060,651,3,1060,0,2007
1442880510,499431,4,2.75,2620,6019,2,2620,0,2013
9188200505,275000,4,2.5,1830,3868,2,1830,0,2007
1865400075,320000,3,2.25,998,844,2,798,200,2007
7853320550,425000,4,2.5,2070,4427,2,2070,0,2007
9831200172,1.45e+006,4,3.5,2860,2199,3,2860,0,2013
8141300030,340000,3,2,1920,5688,1,1920,0,2007
7899800863,299900,3,2.5,1210,2046,2,920,290,2008
0745530240,865950,5,3.5,4890,12039,2,3590,1300,2014
4055700784,720000,4,2.5,3420,17038,2,3420,0,2007
1180000830,460000,4,3.5,2870,3225,2,2070,800,2006
0291310270,375000,3,2.5,1600,2042,2,1600,0,2005
1934800162,386180,2,1.5,960,1829,2,960,0,2005
2309710070,280000,3,2.75,1740,5639,1,1740,0,2010
6181500340,359000,4,2.5,2575,4725,2,2575,0,2011
7853220390,785000,5,3.25,3660,11995,2,3660,0,2006
9834201375,425000,3,2.25,1420,1230,2,940,480,2009
5214510060,575000,5,2.5,3070,7200,2,3070,0,2005
3221079050,465000,3,2.5,1920,144619,1,1920,0,2014
1266200140,1.85e+006,4,3.25,4160,10335,2,4160,0,2014
2523039346,720000,4,3.25,3276,10801,2,3276,0,2008
1624049293,390000,5,3.75,2890,5000,1,1310,1580,2006
1973700030,2.205e+006,3,2.5,3430,10177,2,3430,0,2014
1070000390,1.05469e+006,4,3.5,3390,3979,2,2610,780,2014
2524059269,915000,6,3.75,2930,14980,2,2930,0,2013
1972200326,562000,2,2.25,1300,1314,3,1300,0,2008
3796000400,349000,2,1.75,1250,1208,2,1040,210,2007
0321030070,375000,4,2.5,2310,7800,2,2310,0,2011
0476000118,479950,2,2.25,1360,1336,3,1360,0,2008
2909310060,319000,4,2.5,2020,5100,2,2020,0,2010
0832700240,325000,3,1.5,1270,1067,3,1270,0,2009
1442880570,505657,4,2.75,2790,8092,2,2790,0,2013
9542840060,340000,4,2.5,2320,4142,2,2320,0,2010
0629650370,250000,3,2.5,1750,6351,2,1750,0,2012
7967000060,349500,4,2.5,2030,4596,2,2030,0,2014
3904100041,290750,3,2.5,1270,865,2,1080,190,2008
9268850860,715000,5,3.25,2710,2356,2,2230,480,2013
1454100127,689950,4,2.75,2520,8433,2,2520,0,2014
2856101290,425000,2,2.5,1340,1263,3,1340,0,2008
2767601872,657000,2,3,1570,1281,3,1570,0,2014
0255370570,359950,4,3.5,2690,5564,2,2690,0,2007
0301401370,319900,4,2.75,2475,4276,2,2475,0,2014
1604601804,532000,3,3.75,2260,2050,2,1170,1090,2010
6749700004,291000,2,1,840,863,3,840,0,2008
1806900499,675000,3,3.25,1720,1330,2,1030,690,2004
7625703435,885000,3,2.25,2940,6500,3,2940,0,2014
7324900016,1.45e+006,5,3.5,4170,9090,2,4170,0,2008
3575303430,780000,6,4.25,4310,10000,2,2950,1360,2008
9492500140,839950,4,2.75,3010,7200,2,3010,0,2014
9268851670,645000,3,2.5,2170,1984,2.5,2170,0,2008
0301400830,263000,3,2.5,1584,3200,2,1584,0,2011
4310702918,345000,2,2.25,1110,1290,3,1110,0,2006
4305600240,505000,4,2.5,2420,5006,2,2420,0,2013
7169500200,522500,2,2.25,1430,1210,2,1340,90,2005
3943600070,400000,3,2.5,2393,4788,2,2393,0,2012
1048000060,543000,3,2.25,1240,949,3,1240,0,2008
3449500045,495000,4,2.5,2980,12075,1,1910,1070,2007
1438000200,549995,4,3.5,2970,6587,2,2260,710,2014
5424100030,327555,3,2.5,2329,5720,2,2329,0,2010
7853270710,690000,5,3.25,3340,9075,2,2600,740,2005
9161100075,673000,4,2.25,2580,2875,2,2580,0,2015
1085622860,384435,3,2.5,2029,3906,2,2029,0,2014
9578090240,780000,4,2.75,3430,6500,2,3050,380,2006
4083306045,1.375e+006,5,3.75,3330,5042,2,2470,860,2014
6666830320,950968,5,3.5,3220,5081,2,3220,0,2013
8562780160,334950,2,2.25,1240,750,2,1150,90,2008
2767704603,489000,3,3.5,1500,1249,2,1240,260,2004
5631500292,600000,3,3,3530,8345,2,3530,0,2006
2424039036,282000,3,2.25,1260,915,2,1020,240,2007
2867300030,442000,4,4,4168,8485,2,3222,946,2007
6661200260,220000,2,1.5,1030,2850,2,1030,0,1995
7238000240,489000,3,2.5,3080,5598,2,3080,0,2006
4051150070,250000,3,1.5,1072,4339,2,1072,0,2009
1442880320,484259,4,2.75,2790,5000,2,2790,0,2014
3616600003,1.68e+006,3,2.5,4090,16972,2,3590,500,2007
3862710030,450000,3,2.5,1800,4357,2,1800,0,2013
9828201361,299000,2,1.5,830,1276,2,830,0,2005
4019500030,450000,3,2.5,2280,4557,2,2280,0,2010
3630240140,585000,4,3,2110,1286,2,1710,400,2007
5695000270,660000,3,2.25,1570,1680,3,1570,0,2014
2349300069,301500,2,1.5,830,1333,2,830,0,2005
6790830060,949950,4,3.75,4120,8258,2,4120,0,2012
3630200640,759990,4,2.5,2540,5760,2,2540,0,2009
7967000160,355000,4,2.75,2050,4000,2,2050,0,2014
9492500160,889950,4,2.75,3080,7242,2,3080,0,2014
9268851740,629800,3,2.5,2390,1984,2,2220,170,2008
3342100421,745000,4,2.5,3170,5100,2,3170,0,2012
6362900138,379900,2,1.5,1240,1331,2,1050,190,2007
9358001422,335000,3,2.5,1090,1139,2,960,130,2009
7853280350,809000,5,4.5,4630,6324,2,3210,1420,2006
7853361420,569950,4,2.5,3230,5899,2,3230,0,2012
7852120030,723000,4,3.5,3510,9263,2,3510,0,2001
0731500320,282000,4,2.5,1785,2552,2,1785,0,2009
6056100102,569900,5,3.25,2360,3873,2,1990,370,2006
1823049179,385000,4,2,2340,9716,1,2340,0,2009
9268850030,420000,3,2.25,1620,1075,3,1540,80,2009
9831200159,2.25e+006,3,3.25,3890,3452,2,2890,1000,2006
8924100370,1.205e+006,4,3.5,3590,5335,2,3140,450,2006
8669150700,292000,4,3,1984,4460,2,1984,0,2012
0889000024,645000,3,2.25,1640,1023,3,1640,0,2014
9268850350,304500,4,2,1350,942,3,1350,0,2008
2619950310,489500,4,3.5,2730,5707,2,2000,730,2011
7430200060,1.583e+006,4,4,5610,11063,3,4750,860,2006
5100400251,390000,2,1,962,1992,2,962,0,2012
2597490030,815000,4,3.5,3040,4006,2,2350,690,2013
3655500030,719000,3,3.5,2540,10578,2,2010,530,2014
3751600784,331210,4,2.5,2240,4800,2,2240,0,2014
6781200013,245000,3,1.5,1260,1270,2,1040,220,2005
2619950060,465000,5,4,3210,7200,2,2410,800,2011
9523100731,580000,3,2.5,1620,1171,3,1470,150,2008
9272201318,540000,3,2,1580,1972,2.5,1180,400,2007
5676000004,399000,3,2.5,1430,1250,3,1430,0,2007
8091670070,328000,4,2.5,1850,5388,2,1850,0,2009
7853380570,701000,4,2.5,3340,5314,2,3340,0,2010
8091670200,408000,3,2.75,2670,4800,2,2670,0,2014
8084900160,2.6411e+006,5,4.25,4660,16200,2,4660,0,2005
1498300875,445000,3,2.5,1550,930,2,1060,490,2006
7853270200,672500,4,2.5,3470,6651,2,3470,0,2005
9211010320,538000,3,2.5,3010,7014,2,3010,0,2009
2867300160,450000,5,3.5,3931,9497,2,2650,1281,2014
3278605570,362500,3,2.5,1800,2700,2,1800,0,2011
4310702858,414950,3,2.5,1570,1551,3,1570,0,2008
2838000030,679950,3,2.5,2230,3939,2,2230,0,2014
1673000240,290000,4,2.5,2423,7292,2,2423,0,2005
7899800791,230000,3,2,1160,1174,2,790,370,2007
8682320160,439950,2,2,1440,4666,1,1440,0,2010
8155870200,349900,4,2.5,2052,3723,2,2052,0,2014
2858600083,550000,5,2.5,2780,9272,2,2780,0,2014
2391601195,1.05e+006,4,4.25,3720,5750,2,2960,760,2006
0976000903,655000,2,2.25,1460,1851,2,1180,280,2014
7904700128,385000,3,3.5,1370,1540,2,1100,270,2006
5609000311,729999,6,4.5,3600,6110,2,2510,1090,2012
1972201963,523950,3,2.25,1420,1282,3,1420,0,2006
9272201704,369000,2,2.5,980,895,2,670,310,2009
8648900060,509900,3,2.5,1790,2700,2,1790,0,2010
3832050890,282000,3,2.5,2010,5399,2,2010,0,2006
0255450340,387865,3,2.5,2370,4200,2,2370,0,2014
2172000890,385000,4,2.5,2560,6238,2,2560,0,2007
6127010320,536000,3,2.5,1900,6224,2,1900,0,2005
2810100023,395000,2,2.25,1350,1493,2,1050,300,2007
8011100125,545000,4,2.75,2650,6717,2,2650,0,2014
7852090390,715000,4,2.5,3020,7035,2,3020,0,2001
3630080070,348000,3,2.5,1500,2255,2,1500,0,2005
9126100765,455000,3,1.75,1320,1014,3,1320,0,2015
7853380510,575000,4,2.75,3120,7644,2,3120,0,2010
0993000136,449950,3,2.25,1540,1270,3,1540,0,2014
3278604510,364000,3,2.5,1800,2790,2,1800,0,2011
2937300060,932990,4,2.5,3640,6389,2,3640,0,2014
9510860060,710000,3,2.5,2440,4153,2,2440,0,2003
0293070310,949990,4,4,3970,7314,2,3970,0,2014
0255450400,326989,3,2.5,2060,4200,2,2060,0,2014
3845100140,335606,3,2.5,2538,4600,2,2538,0,2013
3758900075,1.5325e+006,5,4.5,4270,8076,2,3400,870,2007
3395071610,299950,3,2.5,1320,3150,2,1320,0,2005
9477580030,962000,4,2.75,3340,5700,2,3340,0,2013
8138870060,395825,2,2.5,1590,1679,2,1590,0,2012
7237450030,419354,5,2.75,2710,4500,2,2710,0,2014
3767300041,920000,4,2.75,3140,7258,2,3140,0,2006
0291310370,366000,3,2.25,1445,1028,2,1300,145,2005
7853361230,480000,4,2.5,2430,5000,2,2430,0,2009
7904700126,388000,3,3.25,1370,915,2,1100,270,2006
8085400376,2.32e+006,4,3.5,5050,9520,2,3610,1440,2007
9828702851,730000,3,2.5,1860,1290,2,1240,620,2010
8562710550,950000,5,3.75,5330,6000,2,3570,1760,2006
3278613210,358990,3,3.25,1710,2171,2,1400,310,2014
7694200340,398651,4,2.5,2650,4120,2,2650,0,2014
1839500055,530000,4,2.5,2590,7891,2,2590,0,2006
3448900320,610360,4,2.5,2610,5562,2,2610,0,2013
9267200226,436110,3,2.5,1770,1235,3,1600,170,2007
2895730070,925000,4,2.75,3730,8014,2,3730,0,2012
2970800105,449950,4,2.5,2420,5244,2,2420,0,2007
0325059277,760000,4,2.5,3330,7399,2,3330,0,2009
6817750140,293000,3,2.25,1910,3481,2,1910,0,2009
8682320640,695000,2,2.5,2170,7665,1,2170,0,2013
8669180390,285000,3,2.5,2437,5136,2,2437,0,2011
4233600260,1.25578e+006,5,4,4180,12042,2,4180,0,2014
3278611600,379900,3,2.5,1800,2791,2,1800,0,2011
7787920160,472000,5,2.5,2570,7412,2,2570,0,2006
2517101200,300000,4,2.5,2090,5195,2,2090,0,2007
6181420200,272000,4,2.5,2789,3960,2,2789,0,2007
3845100550,418395,4,2.5,2906,5893,2,2906,0,2014
7853321180,465000,5,2.5,2550,6405,2,2550,0,2008
7502800030,659950,4,2.75,3550,9400,2,3550,0,2014
3869900139,484950,3,2.25,1590,926,3,1590,0,2014
1332700200,359000,3,2.25,1950,1968,2,1160,790,1979
9211010260,519000,4,2.5,3250,4500,2,3250,0,2009
4100500070,1.71e+006,5,4.5,4590,14685,2,4590,0,2009
7708210070,535000,4,2.75,3070,7201,2,3070,0,2006
7853270520,622950,4,3.25,3030,7644,2,2830,200,2006
5126300060,515000,3,2.5,2610,5845,2,2610,0,2005
2517000260,330000,4,3.5,3150,6202,2,3150,0,2005
0832700270,318000,3,1.5,1240,983,3,1240,0,2009
3022800260,439000,3,2.5,1680,2801,2,1680,0,2011
0254000241,540000,3,2.5,2220,5279,2,2220,0,2006
7237501370,1.079e+006,4,3.25,4800,12727,2,4800,0,2011
0662440030,435000,4,2.5,3100,4699,2,3100,0,2010
2524069078,2.7e+006,4,4,7850,89651,2,7850,0,2006
8895800200,1.1e+006,4,2.75,3590,5625,2,3590,0,2012
9268850160,293467,4,2,1590,942,3,1590,0,2008
7299600700,328000,3,2.5,2242,4800,2,2242,0,2013
0291310340,550000,3,3.5,2490,3582,2,1720,770,2005
2768100510,649000,3,2,1530,1442,3,1530,0,2015
1776230060,435000,4,2.5,2150,3143,2,2150,0,2010
1772600510,625000,3,2.5,2440,4800,2,2440,0,2014
8024200677,415000,3,1.5,1270,1483,3,1270,0,2007
0982850060,400000,3,2.25,1450,4706,2,1450,0,2009
7518506715,979000,3,2.5,2690,4047,3,2690,0,2014
7202280390,625250,4,2.5,2755,4831,2,2755,0,2003
0710600160,665000,4,3.5,2650,3474,2,2230,420,2011
0952005525,589500,3,3.25,2310,3075,2,1730,580,2005
2487700274,437000,2,3,1460,1452,2,1140,320,2007
3449000060,320000,3,1,1400,9000,1,1400,0,1959
7830800473,333500,3,2.5,2196,7475,2,2196,0,2006
6056100370,430000,3,2.25,2020,2750,2,1680,340,2008
2126059295,995500,5,4.5,4280,8465,2,4280,0,2014
1442880340,427874,3,3,2340,5002,2,2340,0,2013
7694200070,334990,4,2.5,2220,4228,2,2220,0,2014
8562710640,909500,4,4,4420,5940,2,3410,1010,2006
3832050860,210000,3,2,1580,4961,2,1580,0,2006
2526059225,952990,4,2.75,3550,6558,2,3550,0,2013
1972200139,622500,2,1.75,1510,851,3,1420,90,2013
2768100186,515000,3,3.5,1360,1419,2,1040,320,2007
6791400070,350000,3,2.5,2040,13590,2,2040,0,2009
0424049284,310000,1,1.5,1120,912,3,1120,0,2011
7853280550,700000,4,3.5,4490,5099,2,3390,1100,2006
7768800270,907687,4,2.5,3560,6786,2,2930,630,2014
8682320350,741500,2,2.5,2150,5760,1,2150,0,2010
1776460140,395000,3,2.5,2130,5088,2,1840,290,2011
5045700400,559950,5,2.75,2990,6370,2,2990,0,2014
3356402702,215000,4,2.5,1847,8000,2,1847,0,2008
2140950160,390000,4,2.5,2610,7227,2,2610,0,2011
2621069017,425000,3,2.25,1670,107157,1,1670,0,2007
1422069070,472000,3,2.5,1860,415126,2,1860,0,2006
2579500181,1.33e+006,4,3.5,3440,9776,2,3440,0,2006
7852120140,695000,4,3.5,3510,9364,2,3510,0,2001
9274200324,545000,3,2.5,1740,1279,3,1740,0,2008
0422000075,389950,4,2.5,2240,5500,2,2240,0,2013
0263000253,380000,3,2.25,1550,1485,3,1550,0,2011
9268850140,288790,4,2,1390,745,3,1390,0,2008
9306500200,432500,3,3,2500,6000,2,2500,0,2012
8562770350,615000,3,3.5,2710,3326,2,1650,1060,2005
2026049326,500000,3,2.5,1720,3012,2,1720,0,2011
9126101090,615000,3,2.25,1760,1146,3,1760,0,2014
2888000030,500000,4,2.25,2270,8196,1,1150,1120,1963
8032700075,622000,3,3.5,1690,1765,2,1370,320,2006
7853440140,802945,5,3.5,4000,9234,2,4000,0,2015
1245003330,1.26e+006,4,2.5,2880,9003,2,2880,0,2008
1176001124,598950,3,2.5,1480,1531,3,1480,0,2014
7853360990,430000,3,2.5,1950,4949,2,1950,0,2009
7853320030,515000,4,2.75,2700,5150,2,2700,0,2009
7576200012,1.262e+006,2,3,2210,3917,2,1500,710,2008
7207900030,400000,4,3.5,2370,3692,2.5,2370,0,2013
0952006827,390000,3,2.5,1310,1254,2,850,460,2007
7853321090,450000,3,2.5,2410,4293,2,2410,0,2007
1042700060,804995,5,1.5,3360,5402,2,3360,0,2014
2597490140,825000,4,3.25,3040,4155,2,2350,690,2013
7852130800,435000,4,2.25,2140,6355,2,2140,0,2002
7625702967,398000,3,2.5,1720,1715,2,1240,480,2004
3845100640,411605,4,2.5,2658,3960,2,2658,0,2014
1773100922,315000,3,3.25,1480,983,2,1180,300,2013
2770602493,455000,2,2,1350,1209,3,1350,0,2013
0475000187,452950,3,2.5,1150,1194,2,1020,130,2006
6056100383,380000,3,1.75,1690,1468,2,1380,310,2008
6056111370,340000,2,1.75,1270,1916,2,1270,0,2012
9578500510,409950,3,2.5,2655,5080,2,2655,0,2013
9828701488,360000,2,1,880,1165,2,880,0,2005
6600000217,1.595e+006,4,4.25,4645,7757,2,3855,790,2006
8024200685,440000,3,1.5,1270,1443,3,1270,0,2007
2923039264,730000,2,1.75,1728,95950,1,1728,0,2012
8073900070,408000,3,2.25,1950,7221,1,1950,0,2006
2419700030,820000,4,2.5,3170,3862,3,3170,0,2008
9396700024,360000,2,2.5,1233,1244,2,963,270,2007
3845100160,339990,3,2.5,2570,4600,2,2570,0,2014
9126100814,515000,3,2,1560,1020,3,1560,0,2014
1982201595,541000,3,1.75,1630,1166,2,1020,610,2013
8151600973,375000,4,2.5,2510,7245,2,2510,0,2007
2722059322,320000,4,2.5,2223,5780,2,2223,0,2010
8562780090,325000,2,2.25,1230,1058,2,1160,70,2008
3346300356,740000,5,2.75,3050,7520,2,3050,0,2014
7237450600,450000,5,2.75,2710,6220,2,2710,0,2014
8944550100,455000,4,2.5,2090,4400,2,2090,0,2011
3438502437,292500,3,2.5,1440,1068,2,1160,280,2006
2423069039,650000,3,2.5,2500,51836,1,1510,990,2013
8011100047,530000,4,2.75,2740,7872,2,2740,0,2015
1042700300,829995,5,3.25,3360,6120,2,3360,0,2014
1776460110,395000,4,2.75,2280,5013,2,2280,0,2009
0293070090,859990,4,2.75,3520,5500,2,3520,0,2014
7548301044,342500,2,1.5,1320,826,2,1100,220,2008
7203160090,743000,4,2.75,3410,5838,2,3410,0,2012
8096800110,345000,3,2.25,2730,9388,1,1390,1340,1975
3278600900,443000,3,2.5,1780,2778,2,1530,250,2007
4051150100,260000,3,2.5,1427,4337,2,1427,0,2009
0925059311,810000,4,2.5,2910,6555,2,2910,0,2005
4305600100,570000,4,2.75,3250,5600,2,3250,0,2011
2311400195,1.5631e+006,5,3.5,3630,8100,2,3630,0,2008
1732800194,840000,2,2.5,1680,975,3,1680,0,2009
5015001452,950000,3,2.5,2280,2296,3,1890,390,2013
7853430690,572800,3,2.5,3310,4682,2,2380,930,2015
3821700038,305000,3,3,1290,1112,3,1290,0,2008
5078400215,1.695e+006,5,4.75,3940,7067,2,3230,710,2008
1773100315,445000,4,2.5,2170,6000,2,1630,540,2008
2224069165,801000,4,3.5,3290,8059,2,3290,0,2012
9510861140,711000,3,2.5,2550,5376,2,2550,0,2004
3277801431,268500,3,2.25,1140,977,2,850,290,2008
1760650750,320000,4,2.5,2300,3825,2,2300,0,2012
1607100038,500000,4,3.25,2670,5001,1,1640,1030,2013
1862400176,631625,4,2.5,2440,6651,2,2440,0,2014
5457801833,850000,2,2.5,1611,2210,2,1611,0,2005
8562770110,600000,3,3.5,2710,3290,2,1650,1060,2006
2623039019,988500,3,2.75,2015,16807,2,2015,0,2007
9578500690,430236,4,3.25,3444,5166,2,2714,730,2014
0711000110,1.26652e+006,3,2.5,3060,9576,2,3060,0,2005
2597490750,689500,4,2.5,2050,2772,2,2050,0,2013
6056100165,175003,3,1.5,1390,1882,2,1390,0,2014
2767603824,459000,2,2.5,1240,1249,3,1240,0,2006
7237550110,1.18e+006,4,3.25,3750,74052,2,3750,0,2013
2325300037,358000,3,3.25,1410,1442,3,1360,50,2006
1085623710,447055,4,2.5,2448,4949,2,2448,0,2014
0774100475,415000,3,2.75,2600,64626,1.5,2600,0,2009
1489300215,1.21e+006,4,3.25,3330,9000,2,2870,460,2004
9828702902,495000,2,2.25,1160,1010,2,1000,160,2006
6371000100,479000,2,2.25,1330,1380,2,1060,270,2005
2025069140,1.898e+006,3,2.5,2830,4334,3,2830,0,2006
2781280300,249900,3,2.5,1610,3517,2,1610,0,2005
9551201240,1.465e+006,4,2.5,2800,4000,2,2800,0,2011
2726059144,1.037e+006,5,3.75,4570,10194,2,4570,0,2006
5363200100,897000,4,2.5,2820,6120,2,2820,0,2014
1725059330,1.1e+006,4,2.5,2570,9470,2,2570,0,2006
7234601140,685000,3,2.25,1710,1193,2,1140,570,2014
3057000300,295000,3,1.5,1220,3286,2,1220,0,1982
1972200553,619000,3,2.25,1650,946,3,1650,0,2014
6371000148,439108,2,1.5,1130,1340,2,910,220,2008
0301400850,260000,3,2.25,1489,2800,2,1489,0,2011
1123049232,279000,5,2.5,2690,5557,2,2690,0,2012
3654200037,380000,3,2.25,1530,1305,2,1116,414,2007
7299601790,287000,3,2.5,1600,6315,2,1600,0,2013
2771101921,377000,2,1.5,1000,1251,2,930,70,2006
3566800485,649950,4,3.5,2440,3012,3,2440,0,2005
2767601311,445000,3,2.5,1260,1102,3,1260,0,2007
9137101696,605000,3,2.5,1660,1692,3,1610,50,2005
9528104345,475000,3,2.25,1190,1137,2,960,230,1999
3753000100,399000,3,3,1520,1884,3,1520,0,2009
6798100690,718000,5,2.75,3250,8100,2,3250,0,2014
0148000475,1.4e+006,4,3.25,4700,9160,1,2520,2180,2005
3277801417,341000,3,2.5,1480,1663,2,1180,300,2012
8682320090,818000,2,2.5,2380,9374,1,2380,0,2011
9828701507,759000,3,2.25,1640,1873,3,1640,0,2014
3362400432,547500,3,3.5,1650,2262,3,1650,0,2010
0856000195,2.7e+006,5,4.75,5305,8401,2,3745,1560,2005
9396700028,358000,2,2.5,1278,987,2,1002,276,2007
8850000018,412000,3,2.5,1200,813,3,1200,0,2010
9524100207,245000,2,1.5,690,1058,2,690,0,2005
1085623350,460940,4,2.5,3202,4964,2,3202,0,2014
7663700973,321000,3,2.25,1347,1292,3,1347,0,2010
7853420100,633634,4,3.5,2960,6000,2,2960,0,2014
1025039168,290000,1,0.75,740,1284,1,740,0,1928
0476000110,445000,2,2.25,1200,1137,3,1200,0,2007
2254100090,887250,5,3.5,4320,7502,2,3500,820,2012
8682320600,739000,3,2.5,2310,7348,1,2310,0,2010
9834201366,429900,3,2,1490,1286,3,1490,0,2014
7625702451,459000,3,2,1480,800,2,1000,480,2014
0301402120,240000,3,2.25,1481,2820,2,1481,0,2012
6382500076,566950,3,3,1730,1902,3,1730,0,2014
3758900259,1.04e+006,4,3.5,3900,8391,2,3900,0,2006
3126049446,343000,3,3.5,1130,1449,3,1130,0,2005
3744000100,572115,4,3.25,3230,4838,2,3230,0,2014
9510860750,918000,5,3.5,3920,5150,2,2820,1100,2004
7228500037,555000,2,1.5,1190,1361,2,1190,0,2007
3814900750,399440,4,2.5,2311,4396,2,2311,0,2014
1294300038,450000,3,2.5,1810,914,3,1380,430,2008
7853350090,648000,4,2.5,3290,6203,2,3290,0,2008
9211010900,580000,4,2.5,3250,5000,2,3250,0,2008
1085623250,415000,4,2.5,2544,4071,2,2544,0,2013
2025049192,527500,3,2.5,1380,1389,3,1380,0,2008
7625703354,384000,3,2.25,1430,800,2,1140,290,2011
2051200436,692000,3,2.5,3490,28213,1.5,2242,1248,2009
3880900236,455000,2,1.5,910,966,2,820,90,2006
1646502355,1.28e+006,4,3.25,3080,4120,2,2380,700,2014
2619950110,415000,3,2.5,2280,6031,2,2280,0,2011
1964700054,975000,3,2.5,1660,1344,3,1660,0,2008
1926059039,799950,4,2.5,3320,7429,2,3320,0,2014
3438500037,545000,5,4,1680,7268,1,1370,310,2008
9578501110,429900,4,3.5,2584,5005,2,2584,0,2014
8856004786,275000,3,2.5,2217,8019,2,2217,0,2009
7708200600,498000,3,2.5,2480,4136,2,2480,0,2009
9492500090,754950,3,2.5,2610,7256,2,2610,0,2014
8691440100,895000,4,3,3240,5562,2,3240,0,2013
7222000090,580000,4,3.25,3569,8327,2,3569,0,2013
3321049112,379900,4,2.5,3181,5831,2,3181,0,2014
2911000100,245000,4,2.5,1921,4888,2,1921,0,2009
3862710090,417000,3,2.5,1570,4926,2,1570,0,2014
8648900110,555000,3,2.5,1940,3211,2,1940,0,2009
8648900110,555000,3,2.5,1940,3211,2,1940,0,2009
6791400100,353000,4,2.5,2210,13721,2,2210,0,2009
2768301477,539000,3,2.25,1280,1187,2,1080,200,2008
0126039256,434900,3,2,1520,5040,2,1520,0,1977
8562780110,325000,2,2.25,1230,1078,2,1160,70,2008
8032700110,650000,3,2.5,1480,2159,3,1480,0,2007
5635100090,379950,4,2.5,2612,5850,2,2612,0,2014
2597490300,700000,3,2.5,2350,4975,2,2350,0,2012
9301300805,675000,3,2.5,1300,1590,2,1100,200,2014
3449000300,379000,4,1.5,2020,7560,1,2020,0,1960
8562770490,571000,3,2.5,2140,2867,2,1960,180,2005
3052700464,475000,3,2.25,1380,1621,2,1140,240,2007
9276200569,769900,4,3.5,2730,3047,2,2400,330,2006
7853280490,633000,4,3.5,4220,5817,2,2910,1310,2006
2883200524,635000,3,2.5,1570,1433,3,1570,0,2010
3630200300,1.238e+006,4,3.5,4670,6000,2,3820,850,2007
1383800015,524000,3,2.25,1370,1007,3,1330,40,2009
1441000090,485000,4,3.5,3273,5115,2,2671,602,2014
3760500407,1.03e+006,3,4,3880,13095,2,3700,180,2009
9528101214,650000,3,3.5,1494,1262,3,1494,0,2011
2801910100,754842,3,2.5,2930,5641,2,2930,0,2013
1085623640,428900,4,2.5,2598,5553,2,2598,0,2014
7299601460,329900,3,2.5,2242,4995,2,2242,0,2011
1070000110,1.03529e+006,4,2.5,2830,5932,2,2830,0,2014
7853360820,544999,4,2.5,2710,6937,2,2710,0,2009
7436700090,449950,4,2.75,2320,4344,2,2320,0,2012
3034200399,635000,4,2.5,2720,7991,2,2720,0,2006
0889000015,599000,3,1.75,1650,1180,3,1650,0,2014
2767704252,478000,3,3.25,1430,1348,2,1160,270,2008
2143700756,388000,4,2.5,2090,5040,2,2090,0,2014
8946780110,809950,4,3.5,3660,4903,2,2760,900,2014
6790830090,1.06e+006,4,3.5,4220,8417,3,4220,0,2012
2768100512,659000,2,2.5,1450,1213,2,1110,340,2015
9477580110,971971,4,3.75,3460,6738,2,3460,0,2013
7625702437,389000,3,2.5,1350,874,3,1270,80,2006
5416510490,355000,4,2.75,3000,5470,2,3000,0,2005
1123059125,551500,4,2.5,2950,10003,2,2950,0,2006
7237450110,417838,4,2.5,2530,5048,2,2530,0,2014
0250000090,1.75e+006,4,4.5,4650,7660,2,3640,1010,2008
2025049206,399950,2,1,710,1131,2,710,0,1943
5631500941,740000,4,2.5,3050,8000,2,3050,0,2007
8562780490,335000,3,2.5,1150,683,2,1150,0,2013
3262300485,2.25e+006,5,5.25,3410,8118,2,3410,0,2006
5693500846,667000,3,1.75,1370,1921,3,1370,0,2007
0925059313,920000,4,2.5,3540,7009,2,3540,0,2007
2461900492,368000,3,2.5,1370,1350,2,1010,360,2007
6817750110,307000,4,2.5,1714,3080,2,1714,0,2009
3574770100,550000,4,2.75,3650,4534,2,2940,710,2014
8564860110,594491,4,2.5,2990,6037,2,2990,0,2013
1085622460,460458,4,2.5,3284,6516,2,3284,0,2014
1777600850,859000,4,2.25,3550,13900,1,1830,1720,2010
9284801500,399950,3,3,1860,2875,2,1710,150,2009
7217400389,547500,3,3.25,1720,1977,2,1360,360,2007
3832051140,310000,3,2.5,2540,4775,2,2540,0,2006
0925059137,939000,4,2.75,3270,12880,2,3270,0,2014
6021503706,329900,2,2.5,980,1021,3,980,0,2008
0475000176,436000,3,2.5,1150,1193,2,1020,130,2006
1220000367,320000,3,2.5,1820,1855,2,1570,250,2008
3278605590,375000,3,2.5,1580,3825,2,1580,0,2011
7203140110,392137,3,2,1460,3696,2,1460,0,2010
3818400110,520000,4,2.5,2900,4950,2,2900,0,2004
7702080110,535000,5,2.75,2620,6389,2,2620,0,2007
0952002250,407000,2,2.5,1340,999,2,940,400,2008
9578500820,424950,4,3.25,3266,5398,2,3266,0,2014
3448000542,290000,2,1.5,1076,1060,3,1076,0,2006
9358000552,399000,3,3.25,1680,1478,2,1360,320,2009
2770601696,439990,3,2.5,1930,1348,2,1300,630,2005
9834201145,635000,4,2.5,2880,3091,2,1940,940,2014
3575305452,635000,4,2.25,2240,5000,2,2240,0,2013
6181500100,351000,3,2.5,2594,4455,2,2594,0,2012
2767604074,437500,2,1.5,1210,1232,3,1210,0,2007
2872100345,919204,4,3.5,3760,5000,2,2860,900,2014
2937300440,923990,4,2.5,3600,6055,2,3600,0,2014
2597490660,639888,4,2.5,2050,2772,2,2050,0,2012
3528900768,675000,3,3.25,1510,2064,2,1220,290,2008
3885802135,899900,4,2.5,2580,3909,2,2580,0,2013
3336500190,252000,3,2.5,1670,4020,2,1670,0,2009
2425059174,925000,4,2.5,3190,10034,2,3190,0,2007
1890000170,552000,3,2.5,1280,1920,3,1280,0,2009
5137800130,388500,4,2.5,2718,6197,2,2718,0,2006
2767603753,548000,2,2,1370,1878,3,1370,0,2004
6181410950,254950,3,2.5,1794,4769,2,1794,0,2005
3226069049,1.2375e+006,4,4.5,5120,41327,2,3290,1830,2008
6056110430,629000,3,2.5,2160,1912,2,1970,190,2014
2916200091,734000,4,2.5,2180,7204,2,2180,0,2014
1773100980,309000,3,2.25,1490,1294,2,1220,270,2010
1123059126,554950,3,2.5,2950,10254,2,2950,0,2006
0825079024,785000,3,2.75,2990,207781,2,2990,0,2000
8029770470,550000,4,2.5,2700,5150,2,2700,0,2007
1563102965,1.01e+006,4,3.5,3130,5000,3,3130,0,2014
5021900635,1.575e+006,3,2,3620,14250,2,3220,400,2007
9264450460,309000,5,2.75,2481,4045,2,2481,0,2014
7694200430,328423,3,2.5,1730,3600,2,1730,0,2014
7548301041,345000,3,1.5,1420,1192,2,1140,280,2008
0726059483,660000,5,3.5,3160,5175,2,3160,0,2014
2771102144,385000,3,3.25,1320,1327,2,1040,280,2008
7011201476,459000,2,2.25,1010,1107,2,710,300,2006
0053500020,248000,3,2.5,1870,4046,2,1870,0,2007
8920100066,1.481e+006,4,3.5,5220,15411,2,3550,1670,2006
8091670020,379000,4,2.5,2260,5824,2,2260,0,2011
1176001310,2.945e+006,5,4.5,4340,5722,3,4340,0,2010
3629960680,395000,2,2.25,1620,1841,2,1540,80,2004
8562770250,535000,3,2.5,2280,2289,2,1880,400,2006
1102000514,970000,5,3.5,3400,9804,2,2550,850,2008
1773100275,205000,2,1.5,830,1020,2,830,0,2006
0321030010,310000,4,2.5,2310,7384,2,2310,0,2010
5393600509,334500,2,1.5,830,1858,2,830,0,2005
2895730280,995000,5,3.25,4130,7197,2,4130,0,2012
7967000130,370228,4,3,2050,4000,2,2050,0,2014
7570060290,383000,4,2.5,2050,4953,2,2050,0,2014
0291310170,384500,3,2.5,1600,2610,2,1600,0,2005
0923000425,865000,5,2.5,3190,8160,2,3190,0,2014
3630200780,1.051e+006,4,3.75,3860,5474,2.5,3860,0,2007
9578060660,502000,4,2.5,2040,5616,2,2040,0,2012
0250000010,1.75e+006,4,3.5,3845,8400,2,3845,0,2013
1438000010,569995,4,2.5,2650,6875,2,2650,0,2014
6626300095,749950,4,2.5,3430,64441,2,3430,0,2013
8562901100,550000,3,2.5,2430,5400,2,2430,0,2007
6979970080,525000,3,3.5,2876,5086,2,2360,516,2007
7853320470,516000,4,3.5,2550,8698,2,2550,0,2007
1424069056,1.35e+006,4,3.75,4100,61419,2,4100,0,2014
3448740250,440000,4,2.5,2730,4526,2,2730,0,2009
8129700728,660000,3,2.5,1780,1729,2,1080,700,2008
3832080440,261950,3,2.5,1880,5000,2,1880,0,2010
9512200050,551000,5,3.75,3090,4943,2,3090,0,2010
4027700014,665000,3,3.5,2460,14155,2,1900,560,2014
7853400250,610000,4,3.5,2910,5260,2,2910,0,2012
7853400250,645000,4,3.5,2910,5260,2,2910,0,2012
7853420480,536751,3,1.75,1930,6360,1,1930,0,2013
8943600020,260000,3,2.25,1413,3403,2,1413,0,2009
4221900305,1.312e+006,3,3.25,4030,6300,2,3630,400,2006
1112630130,429900,4,3.25,2880,5929,2.5,2880,0,2014
0123039376,535000,4,2.75,2360,15100,1,2360,0,2014
2767603962,462550,2,1.75,1070,1276,3,1070,0,2006
4083306552,602000,3,3.25,1460,1367,3,1460,0,2008
0745500010,730000,4,2.75,3800,9606,2,3800,0,2008
7899800851,300500,2,1.5,1190,801,3,1190,0,2010
7853350170,675000,5,2.5,3200,6455,2,3200,0,2009
6056100380,415000,3,2.25,1970,2377,2,1680,290,2008
0626059127,614000,3,2.5,2830,5831,2,2830,0,2010
1459920190,385000,4,2.5,2630,5701,2,2630,0,2010
3574750020,594000,4,2.75,2720,4613,2,2720,0,2005
2547200190,860000,4,2.75,3160,8097,2,3160,0,2014
9206500250,1.1045e+006,4,4,3770,8899,2,2940,830,2006
7202300480,775000,4,2.75,3500,6226,2,3500,0,2004
7237450190,430760,5,2.75,2710,4685,2,2710,0,2014
8682320420,755000,2,2.5,2170,6361,1,2170,0,2009
6003500743,640000,2,2.25,1540,958,3,1540,0,2007
0328000182,613500,3,3.25,1876,1531,3,1876,0,2009
0821079102,780000,4,3.5,3720,213073,1,3720,0,2007
1622049242,550000,4,2.5,3148,9612,2,3148,0,2014
7203120050,789500,4,3.25,3240,4852,2,3240,0,2010
7853360250,592000,5,3.5,3340,5000,2,2580,760,2012
1327600190,454950,4,2.5,2413,5701,2,2413,0,2014
4187000250,475000,4,2.5,2500,4500,2,2500,0,2010
2902201300,659000,2,1.75,1180,904,2,780,400,2014
1635500250,570000,4,2.5,2890,5801,2,2890,0,2005
6031400094,347500,5,3,2230,6551,1,1330,900,2014
6601200250,205000,4,2.5,1767,4500,2,1767,0,2006
9358001403,380000,3,3.25,1450,1468,2,1100,350,2009
4216500020,718000,5,2.75,2930,7663,2,2930,0,2013
1438000440,515805,5,2.75,2710,4136,2,2710,0,2014
6061500130,1.02928e+006,4,3.25,3600,18645,2,3000,600,2013
3862710050,437718,3,2.5,1800,3265,2,1800,0,2014
7604400114,450000,4,2.5,2290,5515,2,2290,0,2006
9828702649,515000,3,2.5,1510,1178,2,1060,450,2007
2946003947,204000,2,2.5,1090,13444,2,1090,0,2007
0993000307,360000,3,2,1270,1323,3,1270,0,2006
3362400094,550000,3,2.25,1540,1005,3,1540,0,2008
7853380480,650880,3,2.5,2930,6050,2,2930,0,2008
3893100462,1.78995e+006,5,3.75,4360,8504,2,3530,830,2014
2326600130,895900,4,3.5,3640,4983,2,2790,850,2014
3424069008,585000,4,2.5,2430,4747,2,2430,0,2008
3277801586,380000,3,2.25,1520,1464,2,1240,280,2010
5045700250,565997,5,2.75,2730,5820,2,2730,0,2014
3278603000,459000,3,3,2440,2076,2,1930,510,2006
7548800050,550000,3,3.75,1580,1303,2,1340,240,2010
1972201964,500000,3,2.25,1420,983,3,1420,0,2006
3395070980,461500,5,3.25,2820,3275,2,2230,590,2006
5710000005,2.15e+006,4,5.5,5060,10320,2,5060,0,2008
9319800050,790000,4,2.5,2650,5000,2,2650,0,2007
3303700221,735000,3,2.25,1490,1212,2,1040,450,2011
3304300080,588000,4,2.5,3060,7710,2,3060,0,2009
0642800130,724500,3,3.25,3240,4185,2,2770,470,2011
6192410480,749000,3,2.75,2820,5348,2,2820,0,2008
6127000480,720000,5,3.5,4140,7642,2,4140,0,2003
6145601599,250000,2,1.5,982,846,2,806,176,2006
3630200460,790000,3,2.75,2460,3600,2,2460,0,2007
3845101100,392440,4,2.5,2547,4800,2,2547,0,2014
6792200066,280000,4,2.25,1834,7460,2,1834,0,2012
5317100294,1.333e+006,4,4.5,3130,5126,3,2450,680,2014
8150600250,649000,4,2.5,2730,4847,2,2730,0,2008
9376301112,457000,2,2.5,1380,1329,2,1050,330,2008
0856000635,2.225e+006,4,4.25,4700,10800,2,3910,790,2002
9320350130,453000,3,3,2330,4284,2,1920,410,2004
7694200380,329780,3,2.5,1730,3600,2,1730,0,2014
0635000009,1.05e+006,2,2.5,2350,2390,3,2000,350,2007
7853440050,771005,5,4.5,4000,6713,2,4000,0,2015
8563010130,1.3e+006,3,2.5,3350,7752,1,2180,1170,2009
2767604592,607500,3,3.25,1530,1612,3,1530,0,2006
1332700020,278000,2,2.25,1610,1968,2,1610,0,1979
1442870440,475000,4,2.75,2620,6178,2,2620,0,2013
5347200179,270000,3,2,1300,1920,2,850,450,2006
8924100372,1.302e+006,4,3.5,3590,5334,2,3140,450,2006
6666830170,778983,4,2.5,2490,5647,2,2490,0,2014
3336000052,221000,3,2.5,1320,1780,2,880,440,2005
2895800380,338800,4,2.25,1800,2752,2,1800,0,2014
1042700250,834995,5,1.5,3360,5225,2,3360,0,2014
7787920250,550000,4,2.5,3220,9328,2,3220,0,2006
3026059363,575000,3,3.5,2514,1559,2,2024,490,2007
3590000050,649000,4,2.75,3130,9711,2,3130,0,2014
7853361410,545000,4,2.5,2720,4738,2,2720,0,2012
1355300009,625000,2,2.25,1390,916,2,1165,225,2007
8835800010,1.042e+006,4,4.5,4920,270236,2,3820,1100,2006
9268851680,611000,3,2.5,2134,1984,2.5,2134,0,2008
8096800500,300000,3,2.5,1741,5701,2,1741,0,2012
7202261060,577000,3,2.5,2560,5238,2,2560,0,2001
7237450130,349990,4,2.5,2220,3561,2,2220,0,2014
3630130010,650000,3,2.5,1910,4363,2,1910,0,2006
0567000381,378000,2,1.5,980,853,2,820,160,2009
1760650290,313200,3,2.5,1950,4197,2,1950,0,2013
1024069215,1.20669e+006,5,4.25,4150,12015,2,4150,0,2014
1105000373,252500,2,1.5,1110,986,2,950,160,2009
1773100561,308000,3,2.5,1250,1150,2,1080,170,2009
9510860840,803100,4,2.5,3310,5404,2,3310,0,2004
4187000660,415000,4,2.5,2020,5501,2,2020,0,2010
7203120020,785000,4,3.5,3310,4850,2,3310,0,2010
8559300020,499950,4,2.5,2798,4473,2,2798,0,2012
3356402705,216000,4,2.5,1847,8000,2,1847,0,2008
0662440020,380000,4,2.5,2420,4981,2,2420,0,2009
0255370020,345000,4,2.5,2020,3600,2,2020,0,2012
0293810190,456500,4,2.5,2400,6811,2,2400,0,2007
8091670190,382495,3,2.5,1760,5390,1,1760,0,2014
1760650280,324950,4,2.5,2110,4178,2,2110,0,2013
6306800010,436472,4,2.5,2692,8392,2,2692,0,2014
0982850010,365250,3,2.25,1490,4522,2,1490,0,2009
6705600020,919990,5,3.25,3960,6352,2,3960,0,2014
9478550430,316475,4,2.5,1740,4642,2,1740,0,2012
5498100010,425000,4,2.5,1940,4517,1,1190,750,2010
7625702901,302860,2,1,970,3279,2,790,180,2007
0301401410,298000,3,2.5,1852,4000,2,1852,0,2014
0251500080,3.204e+006,4,4,4810,18851,2,4810,0,2007
0521049227,950000,4,4,5635,9695,2,4360,1275,2011
0100300500,333000,3,2.5,1520,3041,2,1520,0,2009
8669160460,289950,3,2.5,2099,4275,2,2099,0,2010
2810100007,419950,3,2.25,1250,811,3,1250,0,2014
6749700006,306000,2,1.5,1090,1183,3,1090,0,2008
1085623730,498445,4,2.5,3216,5902,2,3216,0,2014
6666830430,775950,4,2.5,2970,4400,2,2970,0,2014
7852110380,605000,3,2.5,2610,6405,2,2610,0,2001
8080400177,520000,2,1.75,1340,1368,2,1060,280,2006
0293070010,849990,4,2.75,3300,4987,2,3300,0,2014
9144100007,767450,3,2,1630,7599,1,1630,0,2006
7234601142,665000,3,2.25,1590,929,2,1060,530,2014
1972200426,525000,2,2.75,1310,1268,3.5,1310,0,2007
7768800280,870515,4,3.5,3600,5697,2,2940,660,2014
9512200420,390000,4,2.5,2154,4153,2,2154,0,2012
7132300525,500000,3,1.75,1530,825,3,1530,0,2015
7515000143,399950,3,2.25,1360,1041,2,1094,266,2006
3395070440,305000,3,2.5,1320,2480,2,1320,0,2005
0629650380,255000,4,2.5,1660,6724,2,1660,0,2009
1115600130,415000,4,2.5,2891,6499,2,2891,0,2014
8562790950,716500,3,2.5,2340,2155,2,2120,220,2012
3413700130,425000,3,2.5,2320,2267,3,2320,0,2009
9532000170,540000,4,2.5,2190,3855,2,2190,0,2010
0255450380,324747,3,2.5,2060,4742,2,2060,0,2014
7203140420,385000,3,2.5,1740,4145,2,1740,0,2010
1760650670,270000,3,2.25,1400,3825,2,1400,0,2012
5556300098,1.24e+006,5,4,4410,14380,2,4410,0,2006
8129700743,672000,3,2.5,1780,1647,2,1080,700,2008
3023000050,310000,3,2.5,1760,10137,2,1760,0,2010
0518500480,3e+006,3,3.5,4410,10756,2,3430,980,2014
1725059127,2.35e+006,6,4.25,5550,11547,2,4270,1280,2014
9511120050,427000,3,2.5,2432,9391,2,2432,0,2005
8943600430,389950,3,2.5,2283,3996,2,2283,0,2008
9429400170,309620,3,2.5,1860,3730,2,1860,0,2012
3845101150,399895,4,2.5,2701,4500,2,2701,0,2014
1085623560,442515,4,2.5,2930,4875,2,2930,0,2014
0263000255,375000,3,2.25,1540,1561,3,1540,0,2010
7299600130,309780,3,2.5,2242,4500,2,2242,0,2014
7853320280,425000,3,2.5,1950,4345,2,1950,0,2007
4253400098,405000,2,3,1160,1073,2,880,280,2007
3814900380,356250,3,2.5,2060,5115,2,2060,0,2014
6821101732,550000,3,2.25,1230,875,3,1230,0,2013
3644100086,340000,2,1.5,1160,1438,2,1160,0,2001
7237450080,362865,4,2.5,2245,4301,2,2245,0,2014
6389970010,1.36e+006,4,3.5,4120,12626,2,3970,150,2014
9578090050,830000,4,2.5,3400,9692,2,3400,0,2007
1489300005,1.598e+006,5,3.75,4270,7500,2,3210,1060,2014
7768800290,855000,4,3.5,2890,5911,2,2370,520,2014
1245003220,1.205e+006,5,3.5,3220,8000,2,2900,320,2008
5608000010,1.385e+006,4,3.5,4010,15365,2,4010,0,2006
5379805260,400200,4,3.5,2260,30250,2,2260,0,2013
3278600670,235000,2,1,1140,1730,1.5,1010,130,2007
2781240050,349950,3,2,1640,4714,1,1640,0,2009
7502800050,659950,4,2.75,3510,9400,2,3510,0,2014
9544700500,785000,3,2.75,3010,1842,2,3010,0,2011
2771603314,475000,2,2.25,1060,925,2,980,80,2006
4181200680,263900,3,2.5,1658,2700,2,1658,0,2014
9347300010,342000,3,2.5,1960,3540,2,1960,0,2012
0255450020,367899,3,2.5,2420,4725,2,2420,0,2014
7230200585,657044,3,3.5,3420,23786,1.5,3420,0,2014
9828702771,359950,2,1.5,893,965,2,893,0,2007
9492500170,879950,4,2.75,3020,7203,2,3020,0,2014
9265880170,550000,4,2.5,2470,5954,2,2470,0,2013
7299600920,279000,4,2.5,2009,4800,2,2009,0,2012
8690600050,255000,3,2.5,1530,1116,2.5,1530,0,2005
1176001119,609500,3,1.75,1590,1113,3,1590,0,2014
3449850050,420000,5,3,2630,3149,2,1670,960,2013
9211000170,570000,4,2.5,3230,7187,2,3230,0,2008
6056111350,439000,3,2.25,1430,2343,2,1430,0,2012
7299601630,310000,3,2.5,2242,5744,2,2242,0,2012
7133300380,635000,4,2.5,2500,4000,2,2500,0,2014
2770601775,399950,3,2.5,1230,922,2,1080,150,2009
3630200630,805000,4,2.5,3020,3600,2.5,3020,0,2009
4385700250,1.8e+006,4,3.5,3480,4000,2,2460,1020,2015
6430500182,1.205e+006,4,3,3330,7650,1,1830,1500,2008
8029770190,745000,4,2.5,3400,4840,2,3190,210,2006
5393600507,329445,2,1.5,830,1119,2,830,0,2005
0207700050,588000,5,3,3110,4464,2,3110,0,2007
8138870470,494815,3,2.5,1910,2091,2,1910,0,2014
7853370020,591975,3,2.75,3230,5250,2,2680,550,2014
3304300380,600000,5,2.75,3380,8179,2,3380,0,2011
3528960020,673000,3,2.75,2830,3496,2,2830,0,2012
1853080840,889950,5,3.5,3700,7055,2,3700,0,2014
7852130460,500000,4,3,2520,4104,2,2520,0,2002
2768301357,500000,3,2.25,1530,1396,2,1240,290,2007
8562710250,890000,4,4.25,4420,5750,2,3410,1010,2006
6824100014,437000,3,3,1460,1180,3,1460,0,2006
7905200061,419700,3,2.25,1450,1486,2,1160,290,2006
3524039228,394000,3,2,1160,3441,1,580,580,1930
2781240040,342000,3,2,1640,4802,1,1640,0,2010
1222029064,420000,3,1.75,1444,249126,1.5,1444,0,2008
9523100730,580000,3,2.5,1620,1173,3,1470,150,2008
5649600464,343000,2,1.5,1100,1228,2,900,200,2007
7548301050,390000,2,1.5,1340,1402,2,1120,220,2008
9542840450,274000,3,1.5,1450,4694,2,1450,0,2011
0126039467,700000,4,2.5,3040,7200,2,3040,0,2008
7936000463,838000,4,2.5,2560,7210,2,2560,0,2006
3021059304,300000,6,3,2744,9926,2,2744,0,2006
3362401758,467000,3,2.25,1420,990,3,1420,0,2008
0886000090,395000,2,1,700,7457,1,700,0,1943
1196003740,734000,5,4.25,4110,42755,2,2970,1140,2000
5045700090,480000,5,2.75,2670,4780,2,2670,0,2013
1604601801,539000,3,2.75,2130,1400,2,1080,1050,2010
5057100090,459950,5,2.75,3078,6371,2,3078,0,2014
3869900146,306500,2,1,840,892,2,840,0,2006
3862710180,408474,3,2.5,1800,2731,2,1800,0,2014
1023059246,437000,3,2.75,2580,5200,2,2580,0,2008
6056100150,160797,3,1.5,1270,2356,2,1270,0,2012
3342700464,729000,4,3.5,3065,5440,3,3065,0,2014
3026059362,499000,3,2.5,1861,1587,2,1578,283,2007
1327600150,359950,4,2.75,2260,5705,2,2260,0,2014
2895730540,929000,5,3.25,4150,7100,2,4150,0,2013
2768200209,529950,2,2.5,1500,1174,2,1140,360,2014
9268851380,461000,3,2.25,1620,998,2.5,1540,80,2012
7625703007,271115,2,1.5,830,1325,2,830,0,2005
7202280580,653000,4,2.5,3120,5137,2,3120,0,2003
1972202187,565000,3,2.5,1870,1058,3,1380,490,2007
2767600985,529950,3,2.25,1240,1250,3,1240,0,2014
5631501202,585000,4,2.5,2820,5612,2,2820,0,2007
1972200556,609000,3,1.75,1630,1526,3,1630,0,2014
0301400930,267000,3,2.25,1584,2800,2,1584,0,2012
9265880040,557000,4,2.5,2840,4500,2,2840,0,2012
7853280610,709950,4,3.25,3910,6293,2,3130,780,2006
1972200847,625000,3,2.5,1730,1301,3,1730,0,2011
8562790940,599000,3,2.75,1840,2060,2,1700,140,2013
1623089165,920000,4,3.75,4030,503989,2,4030,0,2008
6788200596,1.285e+006,4,3.5,3440,3800,3,3440,0,2014
1760650610,324500,4,2.5,2110,3825,2,2110,0,2012
7853360850,471500,3,2.5,2430,5866,2,2430,0,2009
2526069092,1.015e+006,4,3.75,4690,207141,2,4030,660,2007
2424059061,998000,4,3.5,3500,43560,2,2850,650,2014
7661600206,262000,4,2.5,2070,8685,2,2070,0,2006
8149600065,844000,4,3.5,3350,6350,2,2610,740,2009
6666830120,745641,4,2.5,2440,4850,2,2440,0,2013
3034200087,659950,5,3,3010,7357,2,3010,0,2008
0255450410,339989,3,2.5,2060,4200,2,2060,0,2014
3438501327,352500,2,2.5,1570,2399,2,1180,390,2009
9828702389,525000,3,2.5,1580,1161,2,1010,570,2008
8691440330,1.13899e+006,5,3.5,4280,6530,2,4280,0,2014
1085623740,491000,5,3.5,2815,4900,2,2815,0,2011
1424069110,675000,4,2.5,2620,6114,2,2620,0,2011
0993001914,344000,3,2.25,1250,1033,3,1250,0,2007
9211010220,530000,4,2.5,3250,4500,2,3250,0,2008
2143701015,290500,4,3.25,2510,7686,2,2510,0,2003
6056111430,335000,2,1.75,1270,1685,2,1270,0,2012
1925059254,2.998e+006,5,4,6670,16481,2,4960,1710,2007
3278606200,379000,3,2.5,1580,3075,2,1580,0,2013
3126049501,385000,3,1.5,1360,2030,3,1360,0,2008
4305600360,500012,4,2.5,2400,9612,1,1230,1170,1962
6632300212,366750,3,3,1571,2017,3,1571,0,2008
1189000492,405000,2,2,1405,1073,2,1140,265,2007
3319500628,356999,3,1.5,1010,1546,2,1010,0,1971
2436700625,590000,2,2.5,1450,1281,2,1220,230,2006
3679400474,294000,3,1.75,1420,1361,2,960,460,2014
7203190110,731500,4,2.5,2650,4644,2,2650,0,2013
1853080850,837219,5,2.75,3030,7679,2,3030,0,2014
1125079111,1.6e+006,4,5.5,6530,871200,2,6530,0,2008
0518500610,798800,3,2.75,2670,3738,1,1720,950,2013
0293670040,482500,2,2.5,1170,809,2,1170,0,2007
3303970100,820000,4,2.5,3260,26772,2,3260,0,2007
3834000594,319000,3,1.5,1480,1722,3,1480,0,2007
3342100569,950000,3,2.5,2700,6947,2,2700,0,2013
7237501380,1.2675e+006,4,3.5,4640,13404,2,4640,0,2007
2325300093,378000,3,2.5,1601,2491,3,1536,65,2007
9808100150,3.345e+006,5,3.75,5350,15360,1,3040,2310,2008
3332500085,489950,3,2.5,2540,5237,2,2540,0,2011
3869900150,345000,2,1.75,1030,1106,2,765,265,2006
2011400401,510000,3,2.5,2730,7136,2,2730,0,2012
9578501030,432500,4,2.5,3172,5033,2,3172,0,2014
8029770410,650000,4,2.5,3160,8530,2,3160,0,2006
6639900242,750000,4,2.5,2850,12429,2,2850,0,2008
2919700735,870000,4,3.5,2780,3100,2,2120,660,2014
8691440410,900000,4,3.5,3860,6543,2,3860,0,2014
2902201301,664950,2,1.75,1180,900,2,780,400,2014
0291310150,391000,3,2.25,1410,1290,2,1290,120,2004
0323079101,1.8e+006,4,3.5,6370,205603,2,6370,0,2008
5057100110,479349,5,3,3223,6371,2,3223,0,2014
9268850940,661000,4,3.25,2600,2074,2,2150,450,2011
0993000315,379000,3,3.25,1380,1234,3,1380,0,2006
9268851800,415000,3,2.25,1620,998,2.5,1540,80,2010
4310702837,375000,3,3.25,1370,1227,3,1370,0,2007
4310703083,355000,3,2,1220,1186,3,1220,0,2007
1890000166,540000,3,2.5,1280,1889,3,1280,0,2009
7904700146,290000,2,1.5,770,850,2,770,0,2006
1931300308,500000,3,2.5,1210,1200,3,1210,0,2008
8091670730,416000,4,2.5,2890,6322,2,2890,0,2011
3278612370,349900,3,2.5,1580,2765,2,1580,0,2011
0007600065,465000,3,2.25,1530,1245,2,1050,480,2014
3630200900,950000,4,2.5,3670,7680,2.5,3670,0,2007
3278611450,496800,4,2.25,1850,2340,2.5,1850,0,2014
2026049184,680000,4,2.5,2440,6581,2,2440,0,2014
9103000455,920000,4,3.25,2190,4265,2,1540,650,2015
8691440220,1.28999e+006,5,4,4360,8030,2,4360,0,2015
7202300540,825000,4,2.75,3990,6637,2,3990,0,2003
1453601038,292000,3,2.5,1270,1283,3,1270,0,2007
9211010330,576000,4,2.5,3340,6924,2,3340,0,2009
1972201773,670000,2,2,1500,761,3,1500,0,2008
7974200948,953007,4,3.5,3120,5086,2,2480,640,2008
2700200040,399000,4,2.5,2480,4334,2,2480,0,2012
7625702264,399000,2,2,1110,1155,3,980,130,2008
2428100100,847093,4,2.75,2760,5670,2,2760,0,2014
1176001123,599950,3,2.5,1510,1493,3,1510,0,2014
3052700472,499000,3,2.5,1460,1614,2,1180,280,2007
1623089086,760000,4,2.75,3980,285318,2,3980,0,2006
2311400145,1.69999e+006,4,3.75,3320,8234,2,3320,0,2014
8895800090,1.03389e+006,4,3.25,3270,5187,2,3110,160,2014
0847100021,515000,4,2.5,2670,8765,2,2670,0,2006
0291310120,355000,3,2.25,1410,1332,2,1290,120,2004
0301401390,319900,4,2.75,2475,4000,2,2475,0,2014
7519001068,460000,3,3.5,1600,1431,2,1240,360,2006
7203101590,305000,2,1,1290,3383,2,1290,0,2008
7299600530,280000,3,2.5,1608,4818,2,1608,0,2012
7625703357,394950,2,2.25,1300,2104,2,1010,290,2011
7889601270,382000,4,3.5,2530,3000,2,1850,680,2014
4083306553,560000,3,2.5,1390,1411,3,1390,0,2008
9828701508,772000,3,2.25,1640,1204,3,1640,0,2014
8946390150,324950,4,2.5,2229,5723,2,2229,0,2012
8648900040,530000,3,2.5,1790,3078,2,1790,0,2010
4092300211,384000,3,2.25,990,736,2.5,880,110,2009
3343902510,719950,5,2.75,3240,6863,2,3240,0,2013
2919700107,319950,2,2.5,1280,819,2,1060,220,2006
2781280230,292000,3,2.5,1610,3848,2,1610,0,2006
3232200085,1.5e+006,6,3.5,3670,3959,2,2410,1260,2008
1972200259,425000,2,2.5,1150,1027,3,1150,0,2008
1926059236,799950,5,3.75,3760,4702,2,2780,980,2014
2768200210,499000,2,2.5,1320,1157,2,990,330,2014
3304300210,572000,4,2.75,2700,7992,2,2700,0,2012
9826700930,459000,2,2,1480,804,3,1480,0,2008
9385200042,529500,3,2.25,1410,905,3,1410,0,2014
3876590090,374500,4,2.5,3135,5811,2,3135,0,2005
2902200142,584000,3,2.5,1480,1485,2,1280,200,2007
8085400401,1.898e+006,4,4.5,4020,9656,2,4020,0,2007
2902200237,505000,2,2.25,1060,1209,2,940,120,2006
7658600082,565000,2,2.5,1950,2457,3,1950,0,2009
6891100330,799000,4,2.75,3340,5677,2,3340,0,2011
6821102367,547000,3,2.5,1570,1452,2.5,1240,330,2007
1900600015,550000,3,2.5,1930,6604,2,1930,0,2014
1545808120,250000,3,2,1590,8100,1,1060,530,1996
2126059294,960000,4,4.5,3720,7746,2,3720,0,2014
1370800515,2.95e+006,4,4.25,4470,5884,2,3230,1240,2010
3319500334,441000,2,1,1290,1289,2,1030,260,2005
0301400940,265000,3,2.25,1489,2800,2,1489,0,2012
2722069077,430000,3,2.5,2075,39553,1,2075,0,2012
8943600720,286800,3,2.5,1413,3600,2,1413,0,2011
7660100236,375000,3,2.5,1300,1362,2,880,420,2008
1773100921,312500,3,3.25,1480,983,2,1180,300,2013
8679200100,850000,4,2.75,3320,5559,2,3320,0,2012
3654200039,390500,3,2.25,1530,1279,2,1116,414,2007
2771602428,455000,3,2.5,1180,932,3,1180,0,2010
1225039067,455000,2,2,1190,1303,2,800,390,2009
0625049359,515000,3,2.25,1300,1180,3,1300,0,2008
3278606050,362500,3,3.5,1710,2212,2,1400,310,2013
5112800291,460000,3,2.5,2390,47480,2,2390,0,2007
7853360300,540000,4,3.5,3510,6005,2,2750,760,2010
6056111063,230000,3,1.75,1140,1165,2,1140,0,2014
2767704649,425000,2,2.5,1320,1329,2,1180,140,2007
7683800205,298450,5,3,2100,9752,1,1200,900,2007
9406530150,344000,4,2.5,2400,4848,2,2400,0,2004
2979800409,416286,3,2.5,1408,989,3,1408,0,2005
1085622540,379500,4,2.5,2560,5102,2,2560,0,2013
4310701421,350000,2,2.5,1260,1347,3,1260,0,2005
2895800770,258800,2,1.75,1290,1624,2,1290,0,2014
3034200067,620000,4,2.5,2730,9260,2,2730,0,2008
3438501320,295000,2,2.5,1630,1368,2,1280,350,2009
8691450120,908990,4,2.75,3530,6844,2,3530,0,2014
6306810110,485230,4,2.5,2714,12558,2,2714,0,2014
3629990110,475000,3,2.25,1630,2520,2,1630,0,2005
0715010110,1.24042e+006,5,3.25,5790,13726,2,4430,1360,2014
3629700090,635000,3,3,2230,1407,2.5,1850,380,2013
3277801411,350000,3,2.5,1380,1590,2,1160,220,2012
8822901175,345000,3,3.5,1320,1161,3,1320,0,2010
6926700654,700000,2,2,1490,713,3,1490,0,2014
2768301482,490000,3,2.25,1280,1520,2,1080,200,2008
8895800110,1.29989e+006,5,4,3870,5929,2,3870,0,2014
3879900750,579000,2,2.5,1280,1051,2,1080,200,2009
7234600820,552500,3,1.5,1300,1435,2,1120,180,2007
1946000100,467000,4,2.75,2170,5024,2,2170,0,2012
8943600870,305000,4,2.25,1763,3717,2,1763,0,2012
6145600557,212000,2,1.5,1020,1525,2,1020,0,2004
7203140180,429000,4,2.5,1840,4593,2,1840,0,2010
3277801592,479950,3,2,1820,1358,3,1820,0,2014
0461003835,825000,3,3.5,2670,3000,2,1870,800,2014
0424069279,1.18e+006,6,6.5,6260,10955,2,4840,1420,2007
1760651000,250000,3,2.25,1400,3814,2,1400,0,2012
3057000070,289000,2,1.5,1160,2158,2,1160,0,1982
2895810200,265000,3,2.5,1400,3368,2,1400,0,2013
2325300060,344000,3,2.5,1232,1130,3,1232,0,2007
9151600055,749000,4,2.75,2700,6000,2,2100,600,1910
7853321260,492000,4,2.5,2550,6382,2,2550,0,2007
4219610320,552500,4,2.5,3260,6902,2,3260,0,2008
2902200016,653500,2,2.5,1680,1240,2,1120,560,2014
7518507055,855000,4,3.25,2630,2550,2,2030,600,2006
7502700060,333000,3,1.5,1260,5758,2,1260,0,1999
3448740160,415000,4,2.5,2550,4500,2,2550,0,2009
0179001455,445000,4,3.25,3450,5000,2,3450,0,2008
8669160270,273500,3,2.5,1550,3402,2,1550,0,2009
4215270070,969990,4,2.5,4150,8436,2,4150,0,2014
0170000060,1.2e+006,5,3.5,3900,4400,2,2650,1250,2014
7410200431,430000,3,3.25,1550,1444,3,1550,0,2006
6600060140,392000,4,2.5,2130,4000,2,2130,0,2014
2324059314,795000,4,2.5,2890,7798,2,2890,0,2005
9376301111,457000,3,2.5,1220,1330,2,1010,210,2008
8956200560,453000,4,2.5,2502,8306,2,2502,0,2013
6749700002,376000,3,2,1340,1384,3,1340,0,2008
1438000390,469995,4,2.5,2350,3800,2,2350,0,2014
8682301600,540000,3,2.5,1810,3930,2,1810,0,2008
7853361370,555000,4,2.5,3310,6500,2,3310,0,2012
3333001997,445000,3,2,1620,5101,1,590,1030,2006
7899800857,256950,2,2,1070,635,2,720,350,2008
7338220370,297000,4,2.5,2230,4952,2,2230,0,2011
9406530160,320000,4,2.5,1970,4558,2,1970,0,2005
7853280370,805000,5,4.5,4600,7810,2,3200,1400,2006
2937300520,799990,4,2.75,3110,6050,2,3110,0,2014
2738640310,680000,4,2.5,3490,3677,2,2850,640,2007
6056100312,395000,3,2.5,1600,1936,2,1600,0,2007
2856100260,732000,3,2.5,1960,3060,2,1960,0,2010
2724049222,163800,2,2.5,1000,1092,2,990,10,2004
2724049222,220000,2,2.5,1000,1092,2,990,10,2004
6149700197,308625,2,2,1500,1408,3,1500,0,1999
3166900200,375000,3,2.5,2424,5931,2,2424,0,2014
5137800030,300000,4,2.5,2303,3826,2,2303,0,2006
3832080070,284000,3,2.5,1880,6008,2,1880,0,2009
9828702336,610000,2,2,1210,740,2,780,430,2014
7203180370,955000,4,3.25,3720,6765,2,3720,0,2012
3901100030,982000,4,2.75,3610,8580,2,3610,0,2014
3126049500,359000,3,1.5,1360,885,3,1360,0,2008
6666830390,779380,5,2.5,2590,7084,2,2590,0,2014
1832100055,1.51e+006,5,3.25,4390,11250,2,4390,0,2007
3629700030,635000,3,3,2290,1407,2.5,1890,400,2014
3630200960,1.06e+006,4,3.75,3880,9979,2.5,3880,0,2007
7625702431,389500,3,2.5,1350,874,3,1270,80,2006
2895800390,359800,5,2.5,2170,2752,2,2170,0,2014
3753000030,399950,3,3,1296,1051,3,1296,0,2009
1773100926,320000,3,3.25,1530,1602,2,1140,390,2013
0301400320,255900,3,2.5,1489,3266,2,1489,0,2014
6600060160,380000,4,2.5,2130,4467,2,2130,0,2014
1861100267,580000,3,2.75,1430,1521,2,1130,300,2009
3438500036,545000,5,3.75,2380,7268,1,1430,950,2008
3869900036,451300,3,2.5,1420,814,2,1140,280,2008
1042700270,852880,4,3.25,3450,6184,2,3450,0,2014
6817750340,305000,4,2.5,1914,3150,2,1914,0,2009
3448001412,295000,2,1.5,988,1080,3,988,0,2007
0301400800,261000,3,2.25,1584,2800,2,1584,0,2012
7852090570,560000,4,2.5,2630,5710,2,2630,0,2001
7203180070,795000,4,3.25,3520,5250,2,3520,0,2012
5416510200,384950,4,2.5,2380,4913,2,2380,0,2006
1931300977,500000,3,1.75,1410,1197,3,1410,0,2012
7853390260,640000,4,3.5,3220,5741,2,3220,0,2013
9578500810,418000,4,3.25,3266,5969,2,3266,0,2014
6844700575,799000,3,2,2550,4794,2,2550,0,2007
3751601877,552900,4,3.5,3828,18900,2.5,3828,0,2014
3869900136,539950,3,2.25,1670,1596,3,1670,0,2014
8956200960,524225,4,2.5,3056,11385,2,3056,0,2014
2883200083,424950,2,1.5,1000,1188,3,1000,0,2005
2028700570,560000,3,3.25,1530,1786,2,1200,330,2007
4188300030,715000,5,3,3490,6091,2,3490,0,2009
7883603648,300000,5,2.5,2760,6000,2,2760,0,2006
3630080030,405000,3,2.5,1440,2163,2,1440,0,2005
0173000036,327000,3,3,1370,1001,3,1370,0,2009
2862500070,859950,6,4,3180,6551,2,3180,0,2014
7017200055,560000,4,3,2720,7570,2,2720,0,2008
3278611610,379900,3,2.5,1800,2792,2,1800,0,2011
4305500030,625000,3,2.5,3220,6409,2,3220,0,2008
0255460240,398096,3,2.5,2370,5321,2,2370,0,2014
1773100416,315000,3,2.5,1410,1325,2,1180,230,2007
2937300560,939000,4,3.5,3640,6049,2,3640,0,2014
9510860560,674000,3,2.5,1920,3624,2,1920,0,2003
1085621740,306000,4,2.5,2267,3577,2,2267,0,2014
4139300135,2.321e+006,5,4.75,5780,17004,2,4260,1520,2006
5100400241,394950,2,1,1131,1304,3,1131,0,2011
2428100070,914154,3,3.5,2940,6431,2,2940,0,2014
0726059485,496000,3,2.5,2180,4533,2,2180,0,2010
9834201370,430100,3,2.25,1400,1078,2,940,460,2009
8564860270,449990,4,2.5,2680,5539,2,2680,0,2013
8564860270,502000,4,2.5,2680,5539,2,2680,0,2013
3395071580,310000,3,2.5,1300,3612,2,1300,0,2005
3682000060,349950,4,3.5,2796,3520,2.5,2796,0,2013
1646500810,625000,2,1.75,1460,1500,2,1000,460,2008
7768800160,1.05471e+006,4,3.5,4210,6481,2,3260,950,2014
3629980860,680000,4,2.75,2330,3920,2,2330,0,2005
0629890070,828950,4,3.5,3930,5680,2,2820,1110,2013
7299600140,274950,3,2.5,1608,4000,2,1608,0,2014
1332700030,293000,2,2.25,1610,1968,2,1610,0,1979
3630220140,795000,4,3.5,3200,3250,2,2670,530,2007
0301400240,282900,4,2.5,1710,3500,2,1710,0,2014
1233100710,909950,5,3.75,3050,8972,2,3050,0,2014
0293070270,922755,4,3.5,3560,4951,2,3560,0,2014
3304030140,424000,4,2.5,2650,8685,2,2650,0,2006
5095401070,630000,3,2.5,3490,12410,2,2590,900,2009
6358900070,810000,4,3.25,4140,46173,2,4140,0,2007
8141310030,256703,3,2,1670,4441,1,1670,0,2014
7203140270,386380,3,2.5,1720,3600,2,1720,0,2010
8682320320,485000,2,2,1510,3961,1,1510,0,2010
9542840340,275000,3,2.25,1450,4040,2,1450,0,2010
3943600140,370000,4,2.5,1812,5026,2,1812,0,2011
2902200240,499950,2,2.25,1060,1208,2,940,120,2005
3274800505,502000,3,2.5,1600,3073,3,1600,0,2009
8080400136,654000,3,3.25,1530,1565,2,1280,250,2005
6371000079,575000,4,2.25,2070,1230,3,1500,570,2013
5379801920,500000,4,2.5,3630,7482,2,3630,0,2008
8562770320,554000,3,2.5,2140,4126,2,1960,180,2005
3449000200,360000,4,1.75,2010,12188,1,1150,860,1960
0255470030,619990,4,2.75,2630,4501,2,2630,0,2015
0629650030,317500,4,2.5,2233,6025,2,2233,0,2012
3574770030,564950,4,2.75,2990,4521,2,2990,0,2014
7589700055,545000,2,1.25,1240,2150,2,1240,0,2014
3832050570,333700,3,2.5,2230,5050,2,2230,0,2006
5167000140,1.48e+006,3,3.25,3700,2264,2,2280,1420,1998
9578060370,530000,4,3,2290,5105,2,2290,0,2012
2767604253,396000,2,1.5,950,865,3,950,0,2006
8562780800,305000,2,1.75,1120,758,2,1120,0,2012
0603000926,380000,5,3.5,2420,4670,2,2420,0,2013
6817750510,305000,4,2.5,1714,3250,2,1714,0,2010
0423059409,440000,4,2.5,2230,5650,2,2230,0,2011
0522049074,459000,4,3,2530,10000,2,2530,0,2013
1934800193,530000,3,3.5,1550,1233,2,1160,390,2005
0847100046,600000,4,2.75,3110,11225,2,3110,0,2012
1250200693,515000,3,3,2100,2409,2,1660,440,2008
7338220200,275000,4,2.5,2150,3721,2,2150,0,2007
1982201596,540000,3,1.75,1630,1404,2,1020,610,2014
7853270830,445000,3,2.5,2230,7934,2,2230,0,2005
9352900200,285000,3,2.5,1320,955,3,1320,0,2009
8850000517,480000,3,2.5,1590,1431,2,1060,530,2010
3395070560,440000,5,3.25,2610,3642,2,2080,530,2005
7211400576,287450,3,2.5,1440,2500,2,1440,0,2008
5169700132,507950,4,2.5,2630,6283,2,2630,0,2006
3204960200,750000,3,3.5,3390,10078,2,3040,350,2012
8024200681,425000,3,1.5,1400,1022,3,1400,0,2007
9358000550,420000,3,3.5,1900,2133,2,1520,380,2009
7625702444,394950,3,2.5,1350,1250,3,1270,80,2006
7853370260,635000,4,3.25,3420,6752,2,3030,390,2012
0522079068,513000,3,2.5,2150,161607,2,1330,820,1995
3023000200,380000,4,2.5,2110,5306,2,2110,0,2012
3758900023,1.13e+006,4,3.25,3810,8519,1,2680,1130,2007
6204050160,540000,5,3,2870,4369,2,2090,780,2007
8562780200,352499,2,2.25,1240,705,2,1150,90,2009
7702600949,603000,4,3.5,3610,6345,2,2370,1240,2008
3442000127,685000,4,2.5,2310,5100,2,2310,0,2013
0255550070,330675,4,3,1930,3031,1,1200,730,2006
7165700200,275000,3,3,1390,1080,2,1140,250,2006
8096800270,259950,3,2.5,1578,7340,2,1578,0,2010
4046500160,441000,3,2,1720,15000,1,1720,0,2011
7882600326,1.135e+006,5,3.75,4700,11237,2,2930,1770,2006
9122001230,590000,3,3.5,1970,5079,2,1680,290,2007
6373000187,497000,3,2.25,1460,1353,2,1050,410,2012
7967000200,345500,3,2.5,1930,4000,2,1930,0,2014
2902200241,562500,3,2.25,1300,907,2,1000,300,2006
0291310390,355000,3,2.25,1445,1087,2,1300,145,2005
1604601572,345000,2,2.25,860,696,2,860,0,2009
0259500270,478000,3,2.5,3040,4535,2,3040,0,2007
3166900270,391500,3,2.5,2424,6143,2,2424,0,2014
2926049582,265000,2,1.5,1084,3427,2,1084,0,1976
3438503230,395000,3,2.5,2510,5320,2,2510,0,2005
2827100075,286308,2,1.5,1220,1036,3,1220,0,2006
1702900624,370000,2,2.25,1280,835,2,1080,200,2009
2856100935,1.079e+006,5,3.5,3740,5610,2,2860,880,2014
0301401620,298900,3,2.5,1852,4000,2,1852,0,2014
3630200520,775000,4,2.5,2580,5787,2,2580,0,2007
0323079065,790000,4,3.5,3190,31450,2,3190,0,2010
7172200125,1.05e+006,3,2.5,3400,5119,2,2300,1100,2014
3057000400,249000,2,1.5,1090,2686,2,1090,0,1982
3022900070,348000,3,2,2360,6145,1,2360,0,2011
9406710060,358000,5,2.5,2460,5604,2,2460,0,2011
3353401070,260000,5,2.5,2025,7760,2,2025,0,2007
7853280570,765000,4,3,4410,5104,2,3400,1010,2006
6192410550,739000,3,2.5,2810,5400,2,2810,0,2005
8562710520,890000,5,3.5,4490,6000,2,3200,1290,2006
1543000060,462000,4,2.5,3070,6432,2,3070,0,2006
9536600810,380000,4,2.5,1984,32400,1,1564,420,1962
5428000070,770000,5,3.5,4750,8234,2,3350,1400,2013
2309000060,641000,4,3.25,2760,4104,2,1900,860,2014
8043700105,2.3e+006,4,4,4360,8175,2.5,3940,420,2007
7792000140,369000,4,2.5,3060,27251,1.5,3060,0,2008
5244801550,1.112e+006,4,3,2770,2650,2,2180,590,2014
9310300160,357000,5,2.5,2990,9240,2,2990,0,2015
6762700376,650000,3,2.75,1540,1251,2,1230,310,2002
1972200428,563500,3,2.5,1400,1312,3.5,1400,0,2007
7304301231,345000,3,2.5,1680,2229,2,1680,0,2007
9512200140,479950,3,2,2260,7163,1,2260,0,2012
7853400260,660000,4,3.5,3400,5196,2,3400,0,2012
0097600140,800000,4,2.5,2930,5000,2,2760,170,2007
2822059360,253101,3,2,1239,6036,1,1239,0,2009
6056110200,555000,3,3.5,2100,2479,2,1450,650,2011
6300000226,240000,4,1,1200,2171,1.5,1200,0,1933
6300000226,380000,4,1,1200,2171,1.5,1200,0,1933
9524100196,239000,2,1.5,680,772,2,680,0,2005
3013300685,760000,4,3.25,2690,3995,2,2060,630,2014
2619950070,430000,4,2.5,2750,7200,2,2750,0,2011
7203110240,660000,3,2.5,2450,4332,2,2450,0,2010
7694200350,399963,4,2.5,2620,4050,2,2620,0,2014
0007600136,411000,2,2,1130,1148,2,800,330,2007
1442880160,483453,4,2.75,2790,5527,2,2790,0,2014
3277801580,469950,3,2,1820,1357,3,1820,0,2014
1442880640,504058,4,2.75,2910,7467,2,2910,0,2013
3845101070,425996,4,2.5,2568,5000,2,2568,0,2014
6791900260,760005,4,2.75,3090,5859,2,3090,0,2010
9828702339,699999,2,2,1460,1085,2,950,510,2014
2255500125,749950,3,2.5,2010,2263,2,1340,670,2014
5541300135,674600,4,2.5,2610,5140,2,2610,0,2006
4083306616,450000,2,1.5,960,1000,2,920,40,2008
8096800260,272000,3,2.5,1528,7616,2,1528,0,2011
2997800024,450000,2,1.5,1310,1264,2,1120,190,2006
0952005863,643950,3,2.25,1760,2122,3,1760,0,2015
7772850060,290000,3,2.5,1420,3542,2,1310,110,2007
6130500070,378000,3,2.5,1650,2082,3,1650,0,2007
8682300400,728050,3,2.5,2320,6775,1,2320,0,2008
8956200990,499160,4,2.5,2628,11466,2,2628,0,2014
9532000070,536000,4,2.5,2520,4831,2,2520,0,2009
7570050070,419900,5,3.5,2880,5000,2,2260,620,2012
0946000295,469000,3,2.25,1440,1362,3,1440,0,2014
3831250350,374000,3,2.5,2185,6042,2,2185,0,2009
6056100160,182568,4,1.5,1500,2106,2,1500,0,2014
1402970070,334888,3,2.5,1769,7324,2,1769,0,2012
2524059267,799900,4,4,3650,18223,2,3330,320,2013
8091670030,383000,4,2.5,2160,6223,2,2160,0,2010
1825079046,580000,3,2.5,1820,374616,2,1820,0,1999
0255450390,351999,3,2.5,2370,4200,2,2370,0,2014
9301300270,1.325e+006,3,3,3180,2758,2,2240,940,2008
9347300160,312000,3,2.5,1780,4077,2,1780,0,2011
0710600070,674950,4,3.5,2650,3127,2,2230,420,2011
5556300116,1.105e+006,5,2.75,3300,7560,2,3300,0,2007
1324300126,415000,2,2.5,1160,1219,3,1160,0,2007
9279700013,1.25e+006,3,3,3460,5353,2,2850,610,2007
3336500140,208800,3,2.5,1390,2450,2,1390,0,2009
2767604212,452000,2,2.5,1260,1131,3,1260,0,2006
6719600030,837000,5,2.75,2940,5225,2,2760,180,2010
3204930510,780000,5,3.5,3190,4247,2,2430,760,2013
7582700075,1.485e+006,4,3.5,3930,6120,2,3310,620,2007
0191100435,1.6e+006,5,3.75,3570,10125,2,3570,0,2014
0255450030,369946,3,2.5,2420,4725,2,2420,0,2014
9476200710,530000,3,2.75,3400,7200,2,2470,930,2009
1329300070,386000,4,2.5,2478,6079,2,2478,0,2012
0357000135,1.9e+006,4,2.5,3070,7830,2,1970,1100,2009
7203600560,735000,4,3.5,3200,7605,2,2500,700,2013
0715010140,1.75e+006,5,3.25,5790,12739,2,4430,1360,2014
3869900138,489950,3,2.25,1590,926,3,1590,0,2014
2114700374,357500,3,3,1730,1442,2,1440,290,2008
9264450550,329995,4,2.5,2303,3680,2,2303,0,2013
3862710200,414000,3,2.5,1790,3754,2,1790,0,2013
0291310310,533500,3,3.5,2490,3517,2,1720,770,2005
3814900260,402395,4,2.5,2669,5385,2,2669,0,2014
8562790710,725000,4,3.25,2610,2552,2,2160,450,2008
3425069117,1.275e+006,6,5.25,6160,27490,2,4040,2120,2007
2895800640,239800,2,1.75,1290,1493,2,1290,0,2014
3438500253,616950,5,3.5,3560,5008,2,2810,750,2013
3630200340,1.258e+006,4,3.25,4360,6000,2,3400,960,2007
2770601769,435000,3,2.25,1230,1238,2,1080,150,2009
2225069036,925000,4,3.25,3640,60086,2,3640,0,2005
9525600030,631500,2,2.5,1780,2493,3,1780,0,1981
0993002108,399995,3,1.5,1140,1069,3,1140,0,2005
0993000327,369950,3,2,1270,1320,3,1270,0,2006
1523059239,475000,5,3.5,2780,3583,2,2180,600,2005
7967000270,353000,4,2.5,1912,5000,2,1912,0,2012
7137800310,329950,4,2.5,2300,9690,2,2300,0,2006
2211300260,367000,3,2.5,2828,4050,2,2828,0,2013
8956200070,447500,4,2.5,2425,9017,2,2425,0,2013
1257201420,595000,4,3.25,3730,4560,2,2760,970,2015
1523300140,325000,1,1,730,1942,1,730,0,2009
9831200186,690000,2,2.5,1990,1756,3,1780,210,2005
7660100238,329950,3,2.5,1300,812,2,880,420,2008
5381000477,399500,4,2.5,2560,7492,2,2560,0,2014
0207700180,555000,5,2.5,2450,5047,2,2450,0,2007
5288200072,427000,2,1.5,1440,725,2,1100,340,2011
9524100322,375000,3,2.25,1140,1557,3,1140,0,2007
1732800184,499000,2,1.5,1110,957,2,930,180,2005
1425069103,750000,3,2.5,2620,43832,2,2620,0,2013
8165500790,336900,3,2.5,1690,1200,2,1410,280,2014
7658600081,555000,2,2.75,1950,1610,3,1950,0,2009
1245003268,1.275e+006,4,3.5,3530,8126,2,3530,0,2007
8010100220,999950,4,3.5,3310,4684,2,2290,1020,2014
7974200452,975000,5,3,2620,5477,2,2620,0,2009
8943600360,299000,3,2.25,1350,3582,2,1350,0,2010
3026059361,479000,2,2.5,1741,1439,2,1446,295,2007
6130500120,428000,3,2.5,1650,2201,3,1650,0,2007
3575305485,409000,3,2.5,1890,6500,2,1890,0,2012
0666000142,798500,3,3,1950,1833,3,1610,340,2009
7853280620,689000,4,3.5,4490,5805,2,3390,1100,2006
8946390040,375000,6,2.25,3206,5793,2,3206,0,2012
5416300230,775000,4,3.5,4130,77832,2,4130,0,2011
1604730150,639983,5,3,2800,5700,2,2800,0,2014
8669180150,300000,4,3,1984,4419,2,1984,0,2010
1081330180,627000,4,2.5,2750,11830,2,2750,0,2014
2309710230,275000,3,2.75,1740,5757,1,1740,0,2010
2895800610,352800,4,2.25,1800,2752,2,1800,0,2014
3362400092,565000,3,2.25,1540,1005,3,1540,0,2008
3052700385,765000,4,2.25,2030,2222,2,1610,420,2015
2738640040,644000,4,2.5,3310,4839,2,3310,0,2007
8024200674,461000,3,1.5,1270,1416,3,1270,0,2007
3353400092,270500,5,2.5,2406,7093,2,2406,0,2006
6003500749,640000,2,2.25,1540,965,3,1540,0,2007
8956200530,457000,4,2.5,2820,6983,2,2820,0,2013
0133000271,355000,5,2.5,2540,5100,2,2540,0,2014
6749700063,356000,2,2.25,1230,989,3,1230,0,2007
3278613060,425000,4,2.5,1900,2766,2,1900,0,2014
7708200880,562500,5,2.75,2920,6327,2,2920,0,2007
2767600673,460000,3,2.5,1450,1053,2,940,510,2008
7299810040,790000,4,3,5370,69848,2,3500,1870,2005
0993000308,401000,3,2,1270,1333,3,1270,0,2006
3364900040,1.095e+006,3,2.5,2550,5100,2,2550,0,2014
9578090180,850000,4,3,3070,7150,2,3070,0,2007
9542840120,274500,3,2.25,1450,4050,2,1450,0,2010
3860900035,1.94e+006,5,3.5,4230,16526,2,4230,0,2008
7202300040,808000,4,2.5,3480,6262,2,3480,0,2003
1773100972,312000,3,2.25,1490,974,2,1220,270,2009
3626039424,320000,3,2.25,1200,1400,3,1200,0,2005
3175200220,410000,3,2.5,2150,4332,2,2150,0,2013
7852120120,725000,3,3.5,3690,8837,2,3690,0,2001
7813500040,335000,4,2.5,1900,3301,2,1900,0,2007
7242800040,519990,4,3.25,1690,1321,2,1320,370,2014
1442880650,533112,4,2.75,2790,8853,2,2790,0,2013
3355400242,274900,3,2,1936,6612,2,1936,0,2014
8562780540,325000,2,2.25,1150,711,2,1150,0,2013
0923049203,350000,4,2.5,2040,22653,2,2040,0,2011
3578600141,550000,4,2.5,2470,7539,2,2470,0,2006
0053500450,311850,4,2.5,1890,4158,2,1890,0,2014
1934800180,526000,3,2.5,1626,1583,2.5,1419,207,2007
3023000210,375000,4,2.5,2250,5306,2,2250,0,2012
1773100967,299999,3,2.25,1350,1234,2,1160,190,2007
2767704777,436000,3,2.5,1460,1238,2,1200,260,2008
1085621960,303000,3,2.5,2056,3564,2,2056,0,2014
2771602174,525000,2,2.5,1160,1458,2,1040,120,2012
6762700452,575000,3,3,1384,1287,2,1144,240,2006
5695000142,420000,2,1.5,1100,1107,3,1100,0,2008
9578140180,329950,3,2.5,2456,7566,2,2456,0,2012
2124069115,1.83e+006,4,4.25,4500,215186,2,2630,1870,2009
3864000120,1.175e+006,4,3.25,3780,10099,1,2240,1540,2006
2768200212,499950,2,2.5,1320,1157,2,990,330,2014
7852070210,1.149e+006,4,3,5940,11533,2,4950,990,2004
7853361210,400000,3,2,1650,5027,1.5,1650,0,2009
8141310040,246950,3,3,1670,4440,1,1670,0,2014
6852700097,630000,3,3.25,1610,1275,2,1220,390,2005
7708210040,561000,5,2.75,3370,10315,2,3370,0,2006
0053500760,287000,4,2.5,2660,4082,2,2660,0,2010
3528900771,600000,3,3.25,1690,1473,2,1380,310,2008
9126100813,490000,3,2.25,1620,1062,3,1620,0,2014
3679400503,330000,3,1.75,1300,958,2,840,460,2011
1760650210,286950,4,2.5,1610,4052,2,1610,0,2013
2652501565,1.55e+006,3,3.25,3530,4920,2,2660,870,2015
1237500577,880000,4,2.5,3550,8618,2,3550,0,2007
6382500084,577450,3,3,1730,1755,3,1730,0,2014
3023000410,405000,5,2.75,2400,4900,2,2400,0,2011
2767601752,510000,3,2.5,1420,1237,3,1420,0,2014
2771604196,465000,2,1.5,1220,1120,2.5,1110,110,2008
1778500620,1.3e+006,4,2.25,2360,4000,2,2360,0,2013
1823059241,609000,4,3.5,3990,11270,2,2930,1060,2007
9267200062,336000,3,2.5,1260,1211,3,1260,0,2004
3278606110,375000,3,2.5,1580,2407,2,1580,0,2013
1657530180,294500,3,2.5,1760,2688,2,1760,0,2005
2754700035,925000,5,3.5,3420,4216,2,2520,900,2008
2568200120,730000,5,2.75,2870,6593,2,2870,0,2006
6601200040,280000,4,2.5,1934,5677,2,1934,0,2013
2767601750,500000,3,1.5,1220,962,3,1220,0,2014
7853350220,605000,3,2.75,2450,5750,2,2450,0,2013
6163900628,379950,3,3.25,1860,1787,3,1860,0,2007
1689401526,605000,3,2.5,1500,1119,3,1110,390,2008
8725950360,720000,2,1.75,1570,1108,3,1570,0,2007
9826700697,549900,3,2,1280,960,2,1040,240,2014
9578500180,427000,3,2.5,3192,5653,2,3192,0,2014
9826700707,492000,3,2.5,1690,1479,3,1420,270,2005
8138870530,419190,2,2.5,1590,1426,2,1590,0,2014
4188300180,650000,3,2.5,2870,7288,2,2870,0,2012
5416510530,379950,4,2.5,2580,4818,2,2580,0,2005
4181200540,269800,4,2.75,1830,3420,2,1830,0,2012
2222059154,407000,4,2.5,2927,6000,2,2927,0,2011
8032700072,580000,3,1.5,1320,1250,3,1320,0,2008
7203140220,389700,3,2.5,1720,3581,2,1720,0,2011
1278000210,110000,2,1,828,4524,1,828,0,1968
6058600220,230000,3,1.5,1040,1264,2,900,140,2015
1442880610,533380,4,2.75,2790,6685,2,2790,0,2014
3679400484,295500,3,2.5,1410,1332,2,960,450,2014
3825310180,860000,4,4.5,4040,8400,2,3220,820,2006
3630220180,812000,4,3.5,3370,3634,2,2750,620,2007
3336500180,324500,3,2.5,1660,3990,2,1660,0,2009
2781270530,193000,2,1.75,910,2550,1,910,0,2004
0993001563,355000,3,2.25,1280,959,3,1280,0,2005
9578060540,525000,4,2.75,2360,4924,2,2360,0,2008
2222059052,370950,3,2.5,2529,9653,2,2529,0,2012
1239400650,1.242e+006,4,3.5,4700,10183,1,2660,2040,2002
8835800450,950000,3,2.5,2780,275033,1,2780,0,2006
0293070120,888990,4,2.75,3540,5500,2,3540,0,2014
1176001117,705000,3,2.5,1580,1321,2,1080,500,2014
7889601165,268000,3,2.5,1700,2250,2,1700,0,2014
7227801581,305450,3,2.5,1600,3573,2,1600,0,2013
9895000040,399900,2,1.75,1410,1005,1.5,900,510,2011
9528102993,495000,3,1.5,1580,1228,3,1580,0,2014
3746700120,857326,3,3.5,3940,11632,2,3940,0,2014
0745530040,845950,5,2.75,4450,9600,2,3650,800,2014
7299600180,303210,4,2.5,2009,5000,2,2009,0,2014
2149800278,343000,6,5,2732,7655,2,2732,0,2009
2517000650,300000,3,2.5,2090,4590,2,2090,0,2005
6021503708,334900,2,2.5,980,1013,3,980,0,2008
8559300120,477500,5,3.5,2815,5619,2,2815,0,2012
3305100230,820000,4,2.5,3170,8523,2,3170,0,2008
2135200155,580000,5,3.25,3030,7410,2,2150,880,2014
2919700109,350000,2,2.5,1280,940,2,1060,220,2006
8725950220,910000,3,2.5,2030,1160,3,1970,60,2007
1776230220,414000,3,2.5,2490,4540,2.5,2490,0,2012
9211010230,525000,3,2.5,3030,4500,2,3030,0,2009
1972201772,650000,2,2.5,1470,690,3,1470,0,2008
9268851320,450000,3,2.25,1620,997,2.5,1540,80,2012
1424059154,1.27e+006,4,3,5520,8313,2,3570,1950,2008
0626059365,699000,3,3.5,3200,10344,2,3200,0,2007
3885802136,899000,4,2.5,2580,3943,2,2580,0,2013
7967000150,353500,4,3,2050,4000,2,2050,0,2014
7853360720,485000,3,2.5,2430,5867,2,2430,0,2011
8562790150,782900,4,3.25,3060,3898,2,2300,760,2014
1226039124,529000,2,2,1540,9714,2,1540,0,2008
2767704251,514700,3,3.25,1310,1072,2,1060,250,2008
3862710210,409316,3,2.5,1800,3168,2,1800,0,2014
0255460330,388598,3,2.5,2370,4200,2,2370,0,2014
0291310610,415000,3,2.25,1445,1512,2,1300,145,2004
9126101121,521500,3,2.25,1450,1619,2,1140,310,2006
9274200322,580000,3,2.5,1740,1236,3,1740,0,2008
6666830230,882566,4,2.5,3560,5265,3,3560,0,2014
1604601803,525000,3,2.75,2130,1400,2,1080,1050,2010
7702080150,515000,5,2.75,2980,4502,2,2980,0,2007
7853400220,589410,3,3,2840,7201,2,2840,0,2014
3895100039,757500,4,2.5,3420,6845,2,3420,0,2009
7697000150,284000,3,2.5,1660,4083,2,1660,0,2013
8562780530,338500,2,2.25,1150,711,2,1150,0,2013
0291310180,379500,3,2.25,1410,1287,2,1290,120,2005
1972205633,550000,3,2,1420,1369,2.5,1340,80,2007
3023000120,294900,3,2.5,1860,5025,2,1860,0,2010
7548301056,345000,2,1.5,1340,1210,2,1120,220,2008
9826701201,450000,2,1.5,1530,1012,2,1200,330,2005
6300500476,420000,3,2.5,1509,1114,3,1509,0,2014
2597490410,740000,3,2.5,2350,3798,2,2350,0,2013
3448001411,286000,2,1.5,1010,825,3,1010,0,2007
0745530180,870000,5,3.5,4495,10079,2,3580,915,2013
3879900753,727000,3,2.5,1580,991,3,1580,0,2009
2781230230,395000,4,3,2750,7965,2,2750,0,2012
3629990180,535000,4,2.25,1890,3615,2,1890,0,2005
9352900222,255000,3,2.25,1320,963,2,1040,280,2007
7338220120,260000,4,2.5,2150,3721,2,2150,0,2006
0325059287,810000,4,2.5,3340,8384,2,3340,0,2014
7203140360,359782,3,2.5,1850,3400,2,1850,0,2010
6056110150,500000,2,2.5,1950,2162,2,1500,450,2012
7203230040,1.04999e+006,5,3.25,4240,9588,2,4240,0,2014
8121100155,810000,4,3.5,2700,2868,2,1920,780,2006
7853370620,605000,5,4,3040,6000,2,2280,760,2011
6400700264,730000,4,2.5,2460,7930,2,2460,0,2005
1760650880,327000,4,2.5,2110,3825,2,2110,0,2013
0567000382,370000,2,1,780,1133,2,780,0,2009
7852100150,459000,5,3.5,2640,6895,2,2640,0,2001
6447300365,2.9e+006,5,4,5190,14600,2,5190,0,2013
2622059197,365000,4,2.5,2420,8404,2,2420,0,2013
1389600040,255000,4,2.5,1987,6000,2,1987,0,2011
9276200220,375000,1,1,720,3166,1,720,0,1920
7904700032,375000,2,1.5,1130,912,2,1000,130,2006
3744000040,518380,4,2.5,2810,4500,2,2810,0,2014
1773100604,346000,3,3.25,1500,1442,2,1150,350,2007
9268850360,302059,4,2,1390,745,3,1390,0,2008
7853420450,575000,4,2.5,2500,4945,2,2500,0,2013
8956200770,549950,4,3.5,3906,9674,2,3906,0,2014
2424059170,900000,5,6,7120,40806,2,5480,1640,2007
1934800133,397500,3,2.5,1470,1256,2,930,540,2006
5556300109,1.075e+006,5,3.5,3230,7560,2,3230,0,2007
2326600150,775900,3,2.5,2700,5764,2,2700,0,2014
3751600409,510000,4,2.5,4073,17334,2,4073,0,2008
3814900210,471275,4,2.5,3361,5038,2,3361,0,2014
9542840730,288000,4,2.25,1610,3560,2,1610,0,2010
2937300540,989990,4,3.5,3830,7150,2,3830,0,2014
7549800543,300000,3,3.25,1470,1235,2,1180,290,2008
4058800439,664950,5,3,3190,7081,1,1890,1300,2013
7853430180,699188,4,3.25,3250,5478,2,3250,0,2014
0982850120,390000,3,2.25,1490,4539,2,1490,0,2009
9476010120,670000,5,2.75,2900,5155,2,2900,0,2008
0005200087,487000,4,2.5,2540,5001,2,2540,0,2005
7308600040,769995,5,2.75,3360,12080,2,3360,0,2014
1498301048,321950,2,1.25,860,1277,2,860,0,2007
2738630040,613500,4,2.5,3020,6068,2,3020,0,2006
6300500081,300000,3,2.5,1330,1200,3,1330,0,2002
3845100620,400950,4,2.5,2578,4554,2,2578,0,2014
0255450040,389517,4,2.5,2640,4725,2,2640,0,2014
0880000211,255000,3,1.75,1260,1133,2,810,450,2011
2163900081,1.08e+006,3,2.5,1990,1891,3,1990,0,2012
7853370440,637850,5,3.25,3340,4900,2,2500,840,2014
3448900290,636230,4,2.5,2840,6284,2,2840,0,2013
0263000006,375000,3,2.5,1530,1131,3,1530,0,2009
1972200882,586500,3,2.5,1780,1487,3,1600,180,2006
7853270630,544000,4,2.5,2340,6973,2,1930,410,2005
7852130430,425000,4,2.5,2390,5021,2,2390,0,2002
7383450250,374950,4,2.5,2090,3777,2,2090,0,2012
3449000010,294570,3,1,1140,8400,1,1140,0,1960
2690100170,300000,3,2.5,1960,1477,2,1670,290,2012
9578500920,395950,5,3.5,2738,6031,2,2738,0,2014
8562900430,800000,4,2.5,3691,11088,2,3691,0,2013
1442880380,439990,3,2.5,2340,5171,2,2340,0,2013
3204930170,680000,4,3.5,2510,3763,2,1990,520,2013
4449800480,677790,6,3,2800,4213,2,2800,0,1998
3862710010,424950,3,2.5,1650,4777,2,1650,0,2013
0301402280,223990,2,2.25,1061,2884,2,1061,0,2013
2867300170,498000,4,2.5,3402,14355,2,2846,556,2014
5635100080,359950,4,2.5,2542,6120,2,2542,0,2014
1624079024,720000,3,2.5,3150,151588,2,3150,0,2007
9211010840,530000,4,2.5,3010,9000,2,3010,0,2008
7697000020,295000,3,2.5,1660,4898,2,1660,0,2011
3832050130,255500,3,2.5,1770,5000,2,1770,0,2009
3630240020,556000,3,3,1960,1168,2,1600,360,2007
1389600080,277950,4,2.5,1889,6000,2,1889,0,2012
2781230080,431000,4,2.5,3040,6000,2,3040,0,2007
7203100660,780000,4,2.75,3420,6787,2,3420,0,2010
1806900502,649000,3,3.25,1720,936,2,1030,690,2004
3022800010,447000,3,2.5,1740,3043,2,1740,0,2012
6666830250,712198,4,2.5,2450,4247,2,2450,0,2013
7242800020,277140,3,1.5,1190,785,2,920,270,2014
2867300190,363000,4,2.5,3753,7204,2,3336,417,2008
8564860130,598992,5,3.5,3440,6037,2,3440,0,2014
2770603522,585000,3,2.5,2160,1250,3,1830,330,2010
9544200422,1.27495e+006,4,2.75,3820,8850,2,3820,0,2014
4253400104,380950,2,2,1120,1039,2,840,280,2007
1085622890,333490,4,2.5,2250,3916,2,2250,0,2014
9268851630,520000,3,3.25,1540,1487,2,1540,0,2011
8562780190,315000,2,2.25,1240,705,2,1150,90,2009
2767600686,487000,2,1.5,1160,1118,2,1020,140,2007
7207900080,424950,5,3.5,2760,3865,2.5,2760,0,2013
2770601457,542300,3,2.25,1580,1487,3,1580,0,2013
1773100920,320000,3,3.25,1480,1192,2,1180,300,2013
1024069027,1.13999e+006,4,3.25,3740,11467,2,3740,0,2014
7853361310,425000,4,2.5,1950,5000,2,1950,0,2012
6824100029,474950,3,3,1530,1568,3,1530,0,2012
0255450250,307635,3,2.5,1820,4200,2,1820,0,2014
2428100130,834538,3,2.5,2760,6187,2,2760,0,2014
1042700050,769995,5,2.75,3010,5398,2,3010,0,2014
7853280250,820875,5,3.25,3860,9387,2,3860,0,2006
7853410170,595500,4,2.5,2490,6537,2,2490,0,2013
2708450020,450000,4,2.5,3236,9608,2,3236,0,2005
7852140170,695000,4,2.5,2830,14538,2,2830,0,2003
1459920010,300000,3,2,1451,7159,1,1451,0,2010
3438500250,515000,5,3.25,2910,5027,2,2040,870,2013
1890000169,545000,3,2.5,1280,1845,3,1280,0,2009
1250200414,365000,3,2.25,1110,979,2,960,150,2008
2564900470,718500,4,2.75,2840,8800,2,2840,0,2008
2895800780,279800,3,1.75,1410,2052,2,1410,0,2014
6306800050,486940,4,2.5,3250,13360,2,3250,0,2014
6928000605,525000,4,2.75,3030,6625,2,3030,0,2011
3814900950,345000,4,2.5,1983,6002,2,1983,0,2012
8562770080,613000,3,3.25,2440,2812,2,1710,730,2005
3831250130,370000,3,2.5,2313,5700,2,2313,0,2011
3629990020,449500,3,2.25,1260,2556,2,1260,0,2005
9532000010,515000,3,2.5,2000,3837,2,2000,0,2011
8562780430,346100,2,1.75,1150,698,2,1150,0,2013
2781230020,398500,4,2.5,2820,6666,2,2820,0,2007
8658301060,310000,2,1.75,1160,2500,2,1160,0,2008
0301402140,250000,3,2.25,1481,2820,2,1481,0,2012
8923600020,1.88e+006,5,3.5,4390,6220,2,3170,1220,2013
8725950020,695000,2,1.75,1570,1207,3,1570,0,2007
1121000357,1.085e+006,4,3,3410,6541,2,2680,730,2007
1042700290,864327,5,3.25,3480,6507,2,3480,0,2014
7308600010,749995,4,3.25,3430,9870,2,3430,0,2014
7708210050,525000,5,2.75,2880,8364,2,2880,0,2006
5631500285,659950,3,2.5,2990,9413,2,2990,0,2006
0524059063,1.8e+006,5,5,4490,10279,2,3930,560,2013
7203160190,950000,5,4,4100,8120,2,4100,0,2011
1692900095,1.39995e+006,4,2.75,3870,10046,2,3870,0,2005
3438500346,265050,2,1.5,800,2119,2,800,0,2008
9268850290,450000,3,2.25,1620,1057,3,1540,80,2009
2419700080,915000,4,2.5,2910,4356,3,2910,0,2010
1235700052,963000,4,3.25,3530,8589,2,3530,0,2007
4233800020,270000,4,2.5,2701,5821,2,2701,0,2013
3278612570,294000,2,2.5,1380,889,2,1140,240,2012
6638900461,700000,3,2.5,2050,4185,2,2050,0,2011
4233600190,1.065e+006,3,4,3370,8252,2,3370,0,2014
7987400285,494900,3,2.5,2040,2500,2,1470,570,2008
9532000500,415000,3,2.5,1610,3600,2,1610,0,2010
8564860280,459990,3,2.5,2680,5539,2,2680,0,2013
8691440440,882990,4,3.5,3560,6562,2,3560,0,2014
1099950050,620000,4,3.5,3880,8244,2,3060,820,2007
3304040130,375900,3,2,1824,7120,1,1824,0,2010
8562790480,654000,3,2.5,2220,2873,2,2010,210,2012
4457300005,1.8399e+006,4,3.25,4140,11007,2,4140,0,2013
8856003839,215000,3,2.5,1322,6006,2,1322,0,2009
1972200728,630500,3,2.5,1909,1300,3,1766,143,2006
8691420050,855000,4,3.5,3460,7702,2,3460,0,2010
6601200020,235245,4,2.5,1954,5075,2,1954,0,2007
0200480020,770000,5,2.5,3000,7912,1,1610,1390,2007
7203170190,734990,4,2.5,2650,6884,2,2650,0,2012
3885802134,880000,4,2.5,2580,3436,2,2580,0,2013
9578060420,525000,4,3,2650,4924,2,2650,0,2011
3630200080,775000,4,3.5,3390,3960,2,3390,0,2008
3876900089,687015,3,1.75,1470,873,3,1470,0,2009
3630130130,663000,3,2.5,1910,5125,2,1910,0,2006
3326059253,815000,4,2.5,3030,7187,2,3030,0,2005
2224069109,1.05e+006,4,3.25,2930,25020,2,2930,0,2013
3862700020,433190,3,2.5,1650,2787,2,1650,0,2014
3629980080,725000,4,2.5,2870,5118,2,2870,0,2006
7299600950,279950,3,2.5,1608,4800,2,1608,0,2013
5528600005,272167,2,2.5,1620,3795,2,1620,0,2014
3052700419,468500,3,2.5,1350,1186,2,1120,230,2007
9542840630,298000,3,2.5,1950,3600,2,1950,0,2010
7896300592,303500,6,4.5,3390,7200,2,2440,950,2007
9268850480,308000,3,1.75,1300,1237,2,1060,240,2008
3629700020,646800,3,3,2230,1407,2.5,1850,380,2014
8648900010,530200,4,2.5,1880,3853,2,1880,0,2010
5422950170,405000,5,2.5,3370,5092,2,3370,0,2006
2768200213,529000,2,2.5,1320,1395,2,990,330,2014
0642150080,675900,3,2.5,2920,9096,2,2920,0,2013
2770601912,570000,3,3.25,1550,1280,2,1220,330,2013
3304040020,375500,4,2.5,2301,6452,2,2301,0,2010
3629960170,445000,3,3.25,1710,1960,2,1360,350,2004
1238900130,1.1e+006,4,3.75,2890,4164,2,2240,650,2013
6056100114,477000,3,2.5,2100,5060,2,2100,0,2006
4140940130,450000,3,2.75,2240,3360,2,2100,140,2014
6824100007,427005,3,3,1460,1200,3,1460,0,2006
1959700225,720000,3,1.75,1370,1990,3,1370,0,2014
0518500460,2.23e+006,3,3.5,3760,5634,2,2830,930,2014
0923059252,450800,4,3.25,2510,5311,2,2510,0,2009
3052700213,461100,2,2.25,1210,1267,2,1120,90,2010
2428100080,1.0616e+006,4,3,2990,6695,2,2990,0,2014
9276202130,590000,3,2.5,1710,2875,2,1710,0,2006
3845100670,478830,4,2.5,3274,4950,2,3274,0,2014
4319200675,760000,4,2.25,3300,8365,3,3300,0,2014
0323059327,1.025e+006,4,3.5,4370,10860,2,4370,0,2008
3448720020,385000,4,2.5,2050,5276,2,2050,0,2006
7234600832,500000,2,2.5,1310,1500,2,1160,150,2006
4045500950,425000,3,1.5,1680,8000,1.5,1680,0,2012
7234600098,552100,3,3,1330,1379,2,1120,210,2005
0666000143,785000,3,3,1950,1983,3,1610,340,2009
3343903611,615000,5,3.25,3090,7069,2,3090,0,2012
1760650950,309000,3,2.5,1950,3825,2,1950,0,2013
5100403818,369500,3,2,1108,1128,3,1108,0,2009
2325400170,391000,4,2.25,2190,3850,2,2190,0,2006
5700000446,465000,3,1.75,1590,1322,2,1060,530,2014
9492500010,879950,4,2.75,3010,7215,2,3010,0,2014
2461900446,372000,3,2,1330,1042,2,1060,270,2014
8669160170,259000,3,2.5,1550,3569,2,1550,0,2011
3644100101,374000,2,1.5,1260,1575,2,1260,0,2001
7852090680,561000,4,2.5,2550,5395,2,2550,0,2001
5693501028,610000,3,2.5,1300,1331,3,1300,0,2007
3629700080,635000,3,3,2230,1407,2.5,1850,380,2014
3278600680,235000,1,1.5,1170,1456,2,1070,100,2007
2738640470,623300,4,3.5,4170,4524,2,3500,670,2007
7853320950,412500,3,2,1680,5246,1,1680,0,2007
5635100050,380000,4,3.25,2864,8035,3,2864,0,2014
3629990280,497000,3,2.25,1630,3817,2,1630,0,2005
6306800020,452000,4,2.5,2716,7850,2,2716,0,2014
7697000170,312000,3,2.5,1750,4076,2,1750,0,2013
5057100080,469950,5,3,3223,6371,2,3223,0,2014
5276200020,775000,5,2.5,2600,4284,2,2600,0,2014
5727500006,679990,4,2.75,3320,8653,2,3320,0,2014
9268850130,288790,4,2,1350,942,3,1350,0,2008
9293000170,800000,5,2.5,3410,4726,2,3410,0,2007
7299601870,299000,3,2.5,1572,4000,2,1572,0,2013
1760650500,332000,4,2.5,2300,4482,2,2300,0,2013
7174800094,525000,1,1.5,1030,5923,1,1030,0,1940
6909200007,620000,3,1.75,1458,858,2,950,508,2014
7853321150,452000,4,2.5,2190,6896,2,2190,0,2007
1105000402,630000,4,3,3640,5096,2,2740,900,2010
1442870420,485000,4,2.75,2790,7803,2,2790,0,2013
3682000050,349950,4,2.5,2632,4117,2,2632,0,2013
1442880080,499990,4,2.75,2910,6334,2,2910,0,2013
7169500020,510000,2,2.25,1470,1101,2,1340,130,2005
2911700010,1.08e+006,3,2.5,2240,21477,2,2240,0,1995
9578060470,494000,3,2.5,2310,4729,2,2310,0,2011
1776460190,429900,3,2.5,2370,5353,2,2370,0,2009
3449500050,505000,4,2.75,2980,9825,1,1910,1070,2007
2309710130,272000,4,2,1870,6551,1,1870,0,2009
1972201511,671500,3,2.5,1770,1714,3,1770,0,2012
7852120050,729950,4,3.5,3510,10010,2,3510,0,2001
3814900660,471835,4,2.5,3281,5354,2,3281,0,2014
8141310080,249950,3,2,1670,4438,1,1670,0,2014
7207900050,424950,5,3.5,2760,3846,2.5,2760,0,2013
2424059163,1.24e+006,5,3.5,5430,10327,2,4010,1420,2007
2140950130,440000,4,2.5,2990,7928,2,2990,0,2011
1776230190,495000,4,3.5,3170,3858,2,2530,640,2008
3524039224,870000,4,2.5,3520,6773,2.5,2650,870,2006
5694500840,559000,2,3,1650,960,3,1350,300,2015
4014400381,495000,4,2.75,2656,21195,2,2656,0,2014
2838000130,722000,3,2.5,2230,4850,2,2230,0,2014
8562770430,567500,3,2.5,2280,2502,2,1880,400,2006
1402970020,440000,4,2.5,2798,5085,2,2798,0,2011
3943600020,400000,4,2.5,2398,5988,2,2398,0,2008
1438000430,459995,4,2.5,2350,3760,2,2350,0,2014
1601600167,365000,5,2.75,2410,5003,1,1410,1000,2008
1773100541,389950,3,2.25,1580,920,3,1580,0,2015
1773100924,320000,3,3.25,1450,1387,2,1180,270,2013
0982850080,415500,4,2.5,1750,4779,2,1750,0,2009
7628700050,775000,3,2.5,3020,4120,2,2360,660,2008
8673400020,590000,3,3,1740,1100,3,1740,0,2007
8725950170,950000,2,2.25,2200,2043,2,1760,440,2007
6306800080,378950,4,2.5,1867,15314,2,1867,0,2013
3362401763,441750,2,1.5,1020,1060,3,1020,0,2008
0301401630,335900,4,2.75,2475,4000,2,2475,0,2014
6056110780,229800,2,1.75,1110,1773,2,1110,0,2014
6819100352,645000,3,2.5,1900,1258,2.5,1700,200,2007
9297302031,448000,3,3.25,1560,1345,2,1260,300,2009
7203150080,706000,4,2.5,2510,5436,2,2510,0,2011
2937300050,988990,4,4.75,4150,6303,3,4150,0,2014
9521100029,716000,3,3,1660,1849,3,1660,0,2013
0832700170,319000,2,1.5,1090,847,3,1090,0,2009
6817750440,300000,4,2.5,1914,3272,2,1914,0,2009
0123059127,625000,4,3.25,2730,54014,1,1560,1170,2007
3630200430,773000,3,2.75,2470,3600,2,2470,0,2007
3448740430,392000,5,2.5,2340,5670,2,2340,0,2009
1438000190,549995,4,3.5,2660,5690,2,1920,740,2014
7853320250,480000,3,2.5,2410,4656,2,2410,0,2009
0100300280,355000,3,2.25,1430,4777,2,1430,0,2010
8862500280,208400,2,2.5,1570,1268,3,1570,0,2007
1042700080,831548,5,2.75,3010,4919,2,3010,0,2014
4051150080,279500,4,2.5,1613,4338,2,1613,0,2009
5592200010,445000,3,2.5,2380,5269,2,2380,0,2008
7787920080,492500,5,2.5,2570,9962,2,2570,0,2006
3448740190,435000,4,2.5,2550,5200,2,2550,0,2009
8822900122,325000,3,2.25,1330,969,3,1330,0,2007
4083300098,453000,2,1.5,1160,1269,2,970,190,2005
1438000170,612995,5,3.5,3240,6919,2,2760,480,2014
7853360480,540000,4,2.5,2710,9248,2,2710,0,2011
0522059130,465000,3,1,1150,18200,1,1150,0,1959
4385700185,799950,3,2.25,1860,1386,3,1860,0,2014
2768301476,495000,3,2.25,1280,1517,2,1080,200,2008
1862400541,579950,3,2.5,1810,1585,3,1810,0,2014
8562780280,331000,2,2.25,1240,720,2,1150,90,2008
9528101061,580000,4,3.5,1460,951,3,1460,0,2008
6056110460,669000,2,2.5,1640,1953,2,1640,0,2014
2154970020,2.35196e+006,4,4.25,5010,19412,2,4000,1010,2014
5694500497,539900,3,3.25,1300,1325,2,1080,220,2005
7708200670,490000,4,2.5,2510,4349,2,2510,0,2010
8562770050,627000,3,3.5,2710,3475,2,1650,1060,2005
1441000470,458000,4,3.5,3217,4000,2,2587,630,2008
6056100293,440000,3,2.5,1650,4929,2,1520,130,2007
6600000050,1.698e+006,4,3.5,3950,6240,2,3950,0,2015
1732800199,935000,2,2.5,1680,977,3,1680,0,2009
7853360470,641000,5,3.5,3420,6403,2,2700,720,2013
3438501583,452000,3,2.75,2300,5090,2,1700,600,2007
7853370250,625000,4,2.75,3010,6854,2,2570,440,2012
2387600010,1.35e+006,4,3.5,4680,12495,2,3040,1640,2008
8946780080,834950,5,3.5,3630,4911,2,2790,840,2014
9402800005,1.5e+006,3,3.5,3530,3610,2,2370,1160,2008
5422950080,305000,4,2.5,2280,3800,2,2280,0,2006
2826079027,659000,3,2.5,3090,384634,2,3090,0,2007
6003000851,353000,1,1,550,1279,2,550,0,2008
7394400080,535000,4,3.25,2840,4000,2,2330,510,2014
1238501184,999000,4,2.5,3130,10849,2,3130,0,2013
0263000009,375000,3,2.5,1440,1102,3,1440,0,2009
5101408889,685000,4,3.5,2840,4637,3,2840,0,2008
7299601410,333000,4,2.5,2623,7184,2,2623,0,2012
9266700190,245000,1,1,390,2000,1,390,0,1920
2424059174,1.99995e+006,4,3.25,5640,35006,2,4900,740,2015
8562780290,329950,2,2.25,1260,1032,2,1170,90,2008
5100400244,403000,2,1,894,1552,2,894,0,2011
3744000130,559630,4,2.5,3370,4934,2,3370,0,2014
0993001976,344000,3,2.25,1250,871,3,1250,0,2007
0525049174,435000,3,1.5,1180,1231,3,1180,0,2008
5393600562,430000,2,2.5,1520,1588,2,1240,280,2007
4187000190,417000,3,2.5,2000,4500,2,2000,0,2010
2862500190,895950,5,2.75,3180,9255,2,3180,0,2014
5045700470,563950,4,2.75,3050,4750,2,3050,0,2014
2924079034,332220,3,1.5,2580,47480,1,1360,1220,1953
8835770170,1.488e+006,5,6,6880,279968,2,4070,2810,2007
3630200480,680000,3,2.5,2570,3600,2.5,2570,0,2007
8562790080,825750,4,3.5,2950,3737,2,2270,680,2012
8165500780,338000,3,2.5,1690,1760,2,1410,280,2014
1442870050,535365,4,2.75,2790,6969,2,2790,0,2012
1704900303,608000,3,2.25,1720,5234,2,1240,480,2011
6132600655,930000,3,2.25,2890,5000,3,2890,0,2014
3421069049,565000,2,1.75,1130,276170,1,1130,0,2006
7169500130,495000,2,2.25,1460,1623,2,1260,200,2005
8732900840,667000,3,2.5,2510,3819,2,2510,0,2007
5379803372,495000,4,2.5,3390,7870,2,3390,0,2014
2937300430,928990,4,2.5,3570,6054,2,3570,0,2014
5422950020,345000,4,2.5,2280,5000,2,2280,0,2006
3797001702,1.065e+006,5,3.5,2920,3000,2,2260,660,2014
1438000130,519995,4,3,2590,6160,2,2590,0,2014
1853080130,924000,5,2.75,3210,8001,2,3210,0,2014
0741500010,295000,3,2,1230,3405,1,1230,0,2010
3123089027,472000,3,2.5,3800,104979,2,3210,590,2005
3630080190,405000,3,2.5,1500,2314,2,1500,0,2005
3782760080,410000,4,2.25,2510,4090,2,1840,670,2012
8024200684,419500,3,1.5,1400,1091,3,1400,0,2007
0982850020,382000,3,2.25,1450,4667,2,1450,0,2009
5649600462,370000,2,2.5,1390,1821,2,1180,210,2007
3449820430,553000,3,2.75,3160,9072,2,3160,0,2005
9533100285,2.065e+006,4,3.75,4350,7965,2,4350,0,2013
0923059259,455950,4,2.5,2720,5771,2,2720,0,2015
6431000748,331000,3,3.25,1290,1153,3,1290,0,2008
3753000010,417250,3,2.25,1606,1452,3,1606,0,2009
6169901185,490000,5,3.5,4460,2975,3,3280,1180,2015
2309710150,325000,4,3.25,2800,5291,2,2800,0,2011
1773600264,705000,5,3.5,3250,4800,2,2410,840,2010
6061500100,1.17466e+006,6,3.5,4310,7760,2,3260,1050,2013
1282300995,365000,3,2.25,1310,915,2,1060,250,2007
0597000593,403000,2,1.5,1240,1101,2,1080,160,2009
7853321110,409000,3,2.5,1950,7263,2,1950,0,2007
3278612450,391000,3,2.5,1800,1120,2,1800,0,2011
1438000120,542525,4,2.5,2650,5600,2,2650,0,2014
9521100301,339950,2,1,820,681,3,820,0,2006
1442870040,499990,4,2.75,2620,7001,2,2620,0,2012
0644000115,1.765e+006,4,3.25,3980,10249,2,3980,0,2011
6372000297,608000,3,3.5,1660,2298,2,1260,400,2009
6600060150,392000,4,2.5,2130,4028,2,2130,0,2014
0774101755,320000,3,1.75,1790,66250,1.5,1790,0,2003
2895800750,274800,3,1.75,1410,1988,2,1410,0,2014
2424039029,325000,3,2.25,1330,1198,2,1080,250,2007
3448740360,418500,4,2.5,2190,4866,2,2190,0,2009
3832050580,300000,3,2.5,2540,5050,2,2540,0,2006
3094000210,269950,3,2.5,2244,4079,2,2244,0,2012
0321030150,358000,3,2.5,2026,7611,2,2026,0,2010
7694200090,350000,3,2.5,1730,4086,2,1730,0,2013
3299710110,782000,4,3.5,3910,8095,2,3130,780,2007
3879900754,779000,3,2.5,1580,1487,3,1580,0,2009
8732900300,685000,4,2.5,2510,3479,2,2510,0,2007
6021503698,305000,2,2.25,1000,905,3,1000,0,2006
3333000745,350000,4,2.5,1660,2500,2,1660,0,2007
3630220220,775000,4,3.5,3060,4573,2,2410,650,2012
9478500180,317750,3,2.5,1980,4500,2,1980,0,2012
2771602427,438000,2,1,980,1179,2,980,0,2010
1498301168,325000,2,2.5,1050,1609,2,1050,0,2005
8562790580,830000,4,3.25,3080,4287,2,2230,850,2012
2325400040,353000,3,2.25,1900,3800,2,1900,0,2006
5045700330,460000,4,2.5,2200,6400,2,2200,0,2010
3126049498,370000,3,1.5,1360,1167,3,1360,0,2008
9578140360,330000,3,2.5,2238,7209,2,2238,0,2011
3343901408,569888,4,2.5,2590,6474,2,2590,0,2014
7859910110,353900,3,2.5,2517,3900,2,2517,0,2014
7852120180,695000,4,3.5,3510,9084,2,3510,0,2001
9268850180,288790,3,1.75,1290,1237,2,1060,230,2008
6031400092,334950,5,3,2230,8642,1,1330,900,2014
1853080790,869950,4,2.75,3140,7928,2,3140,0,2013
1624049291,557500,3,3.5,3350,5025,2,2670,680,2014
7237450100,389990,4,2.5,2245,4330,2,2245,0,2014
9521100214,455000,3,1.75,1420,1189,3,1420,0,2006
5693501102,598500,3,3,1560,2091,3,1560,0,2006
6891100590,750000,4,2.75,2810,5497,2,2810,0,2011
2254501095,729999,2,2.25,1630,1686,2,1330,300,2014
9478550110,299950,3,2.5,1740,4497,2,1740,0,2012
0993001961,374950,3,2.25,1390,1484,3,1390,0,2007
9274200028,386950,3,2.5,1070,1089,2,900,170,2009
7708200180,535000,5,3.25,2850,4551,2,2370,480,2006
8691430330,890000,5,3.25,4100,7578,2,4100,0,2011
8924100308,1.05e+006,4,2.5,3260,5974,2,2820,440,2007
1070000180,1.10746e+006,4,3.5,3660,4760,2,2840,820,2014
1085623630,436952,4,2.5,2708,4772,2,2708,0,2014
3278605550,365000,3,2.5,1800,2700,2,1800,0,2011
1139000062,288000,3,2.5,1150,887,3,1150,0,2007
2838000180,700000,3,2.5,2230,4006,2,2230,0,2014
2725079018,800000,4,3.25,3540,159430,2,3540,0,2007
7104100110,899000,4,3.5,2490,5500,2,1780,710,2015
0259500230,465750,3,2.5,2670,4534,2,2670,0,2007
9523100712,485000,2,2.5,1430,923,3,1410,20,2008
1438000360,494995,5,2.75,2670,3800,2,2670,0,2014
1608000120,255000,3,2.5,2555,5720,2,2555,0,2006
7853361120,530000,3,2.5,1970,6295,2,1970,0,2011
2461900448,435000,3,2,1980,2674,3,1980,0,2007
1703400910,639000,3,2.5,2010,3300,2,1610,400,2014
8024200683,440000,3,1.5,1270,1413,3,1270,0,2007
9544700730,914500,4,2.5,3950,10856,3,3950,0,2013
8682320900,580000,3,2,1870,5300,1,1870,0,2009
3278600750,250000,1,1.5,1180,1688,2,1070,110,2007
5676000008,410000,3,2.5,1420,1269,3,1420,0,2007
3744000150,531155,4,2.75,2810,5046,2,2810,0,2014
3630080120,358000,3,2.5,1400,1529,2,1400,0,2005
7853360620,425000,3,2.5,1950,5689,2,1950,0,2009
0255550100,326000,3,2.25,1930,3462,2,1930,0,2004
9268200484,650000,4,2.5,2210,4861,2,2210,0,2013
8562790720,749950,4,3.5,2630,3757,2,2200,430,2008
7140700690,239950,3,1.75,1600,4888,1,1600,0,2014
3624039183,315000,3,2.5,1480,1590,2,1150,330,2010
2254502071,375000,2,2.5,750,1430,2,750,0,2006
4310702838,375000,3,1.5,1290,1213,3,1290,0,2007
6431000749,349000,3,3.25,1340,1151,3,1340,0,2008
3362401761,450000,2,1.5,1020,1049,3,1020,0,2008
3629700120,669950,3,3,2330,1944,2.5,1950,380,2014
3226049565,504600,5,3,2360,5000,1,1390,970,2008
0567000408,400000,3,2.5,1495,936,3,1405,90,2006
0825059349,1.02e+006,4,3.5,3770,8501,2,3770,0,2008
7787920230,518000,5,2.5,2890,13104,2,2890,0,2006
5694000706,535000,3,2.75,1320,1125,3,1320,0,2008
1760650900,337500,4,2.5,2330,4907,2,2330,0,2013
2021000180,380000,4,2.5,3120,5001,2,3120,0,2005
6400700389,875000,5,3,2960,15152,2,2960,0,2004
6431000987,385000,3,2.25,1630,1598,3,1630,0,2008
2311400056,1.9875e+006,5,3.5,5230,8960,2,4450,780,2014
3224059107,649500,4,3,3150,6599,2,3150,0,2008
1245002281,1.05e+006,4,3.75,3280,11000,2,2320,960,2008
0121039156,249000,3,1,1030,24750,1,1030,0,1943
9211000110,525000,4,2.5,3130,5795,2,3130,0,2008
7625702263,402000,3,3.5,1240,1666,2,1000,240,2008
8085400586,1.75e+006,4,2.75,3560,8975,2,3560,0,2014
2895800590,359800,5,2.5,2170,2752,2,2170,0,2014
0100300530,330000,3,2.5,1520,3003,2,1520,0,2009
4092302096,433000,3,2.5,1270,1062,2,1060,210,2008
7010700308,1.0108e+006,4,3.25,3610,4000,2,2640,970,2007
7853370100,599832,3,2.75,3230,5200,2,2680,550,2014
6181500120,312891,5,3,2300,8214,2,2300,0,2013
0567000775,449000,2,2.5,1460,1296,2,1160,300,2008
3331000035,495000,3,2.5,1750,1548,3,1750,0,2013
4216500110,819995,5,2.75,3030,10335,2,3030,0,2013
2776600082,407500,3,3.5,1522,1465,2,1248,274,2006
0323079058,850000,4,3.75,3890,22000,2,3890,0,2007
1088100450,1.72e+006,5,4,4590,35046,2,4590,0,2008
0098300230,1.459e+006,4,4,4620,130208,2,4620,0,2014
0847100047,579000,4,2.75,3220,9825,2,3220,0,2012
1853080150,890776,5,2.75,3170,8093,2,3170,0,2014
6021503707,352500,2,2.5,980,1010,3,980,0,2008
9512200090,529000,3,1.75,2340,7724,1,2340,0,2010
9268850040,484000,3,2.25,1620,1425,3,1540,80,2009
7283900306,400000,3,2.5,1910,4408,3,1910,0,2007
1980200236,649950,3,2.5,2420,6847,2,2420,0,2009
2413910120,915000,3,4.5,3850,62726,2,3120,730,2013
7787920180,534950,5,2.5,3220,10572,2,3220,0,2006
1283800110,776000,4,2.5,3040,6425,2,3040,0,2008
6140100028,370000,3,1.75,1496,1423,2,1248,248,2006
1972200555,610000,3,1.75,1630,1500,3,1630,0,2014
6891100090,850000,5,3.5,4200,5400,2,3140,1060,2012
3438503021,443000,3,2.5,2430,7049,2,2430,0,2007
4233600150,1.15e+006,5,4.25,4010,8252,2,4010,0,2015
2770601782,453000,3,2.5,1510,1618,2.5,1330,180,2011
9268851020,735000,4,3.5,2340,2810,2,1730,610,2011
8682291050,810000,2,2.75,2700,8572,1,2700,0,2007
9468200109,1.555e+006,3,3.5,4360,6240,2,2960,1400,2008
2524069097,2.23889e+006,5,6.5,7270,130017,2,6420,850,2010
7625702441,377500,3,2.5,1350,886,3,1270,80,2006
9521100866,482000,3,3.25,1380,1120,3,1380,0,2008
0148000072,600000,2,2.5,1830,1988,2,1530,300,2011
1493300057,420000,3,2.5,1470,1571,2,1180,290,2007
3304030220,480000,4,2.5,2940,9172,2,2940,0,2006
7625702277,406000,2,2,1110,1095,3,980,130,2008
1023059465,505000,4,2.5,2790,5602,2,2790,0,2009
3262300818,1.865e+006,4,3.75,3790,8797,2,3290,500,2006
2937300040,942990,4,2.5,3570,6218,2,3570,0,2014
2768100206,440000,3,2.25,1230,1097,3,1230,0,2009
7904700134,390000,3,3.25,1370,913,2,1100,270,2006
9521100867,475000,3,3.25,1380,1121,3,1380,0,2008
1702901618,420000,1,2,1070,675,2,880,190,2007
7237550100,1.40876e+006,4,4,4920,50621,2,4280,640,2012
7430500110,1.378e+006,5,3.5,5150,12230,2,3700,1450,2007
0603000555,462500,6,3,2390,4000,2,2390,0,2014
3304300300,579950,4,2.75,2460,8643,2,2460,0,2011
6453550090,861111,4,2.5,3650,7090,2,3650,0,2008
2625069038,1.45e+006,4,3.5,4300,108865,2,4300,0,2014
1760650820,290000,3,2.25,1610,3764,2,1610,0,2012
9578060230,535000,4,2.5,2610,4595,2,2610,0,2008
3416600750,585000,3,2.5,1750,1381,3,1750,0,2008
2487200490,670000,3,2.5,3310,5300,2,2440,870,2008
8964800330,3e+006,4,3.75,5090,14823,1,4180,910,2013
5637500082,346000,3,2,1060,1184,2,730,330,2006
0324069112,1.325e+006,4,4,4420,16526,2,4420,0,2013
0524059322,999999,3,2.5,2100,4097,2,2100,0,2008
0889000025,599000,3,1.75,1650,1180,3,1650,0,2014
2909310100,332000,4,2.5,2380,5737,2,2380,0,2010
8562780180,336750,2,2.25,1170,1011,2,1170,0,2009
1043000100,370000,4,2.5,2531,6843,2,2531,0,2013
1865400076,324000,3,2.25,998,904,2,798,200,2007
8902000201,338500,3,2.25,1333,1470,3,1333,0,2009
0715010530,1.88158e+006,5,3.5,4410,13000,2,2920,1490,2014
4253400100,402723,3,2.75,1160,1073,2,880,280,2007
3874900085,715000,4,3.25,2630,7770,2,2630,0,2014
1972200227,459000,3,1.5,1160,1031,3,1160,0,2008
8562770720,589999,3,2.5,2140,3628,2,1960,180,2006
6669080120,405000,4,2.5,1980,5020,2,1980,0,2007
9211010300,509900,3,2.5,3030,9053,2,3030,0,2009
3277800823,327000,2,2,1490,1627,2,1190,300,2009
8835770330,1.057e+006,2,1.5,2370,184231,2,2370,0,2005
1220000371,327500,3,2.5,1820,1866,2,1570,250,2008
0880000205,249000,3,2,1260,1125,2,810,450,2011
1561750040,1.375e+006,5,4.5,4350,13405,2,4350,0,2014
0688000017,516500,1,1.25,1100,638,3,1100,0,2014
2522059251,465000,3,2.5,2050,15035,2,2050,0,2006
2855000110,388000,3,2.5,2198,6222,2,2198,0,2010
6821101731,549000,3,2.25,1230,1380,3,1230,0,2013
0476000017,553000,2,2,1400,1512,2,940,460,2006
2770603523,530000,3,2.5,1410,1250,2,1140,270,2010
2255500123,747450,3,2.5,2110,1339,2,1410,700,2014
3438501329,305000,2,2.5,1590,2656,2,1220,370,2009
0423059387,540000,5,2.5,3370,4850,2,3370,0,2007
6664500090,750000,5,4,4500,8130,2,4500,0,2007
2122059216,422000,4,2.5,2930,5973,2,2930,0,2008
9406530090,337000,4,2.5,2470,5100,2,2470,0,2005
7168100015,579950,5,2.75,3080,5752,2,3080,0,2014
5007500120,341780,4,2.75,2260,4440,2,2260,0,2014
3528900770,710200,4,3,1670,2642,2,1350,320,2008
9521100031,690000,3,3.25,1540,1428,3,1540,0,2013
0524059330,1.7e+006,4,3.5,3830,8963,2,3120,710,2014
6021503705,329000,2,2.5,980,1020,3,980,0,2008
3438501862,330000,3,2.5,1450,5008,1,840,610,2007
3345700207,608500,4,3.5,2850,5577,2,1950,900,2014
6056111067,230000,3,1.75,1140,1201,2,1140,0,2014
8562790760,785000,4,3.5,3070,4684,2,2190,880,2009
1931300090,610950,3,3,1680,1570,3,1680,0,2014
9578500790,399950,3,2.5,3087,5002,2,3087,0,2014
9253900271,3.567e+006,5,4.5,4850,10584,2,3540,1310,2007
3881900317,579000,4,3.25,1900,2631,2,1250,650,2014
0567000385,362500,2,1.5,940,1768,2,940,0,2009
7011201004,645000,3,3.25,1730,1229,2,1320,410,2008
7853420110,594866,3,3,2780,6000,2,2780,0,2013
7853420110,625000,3,3,2780,6000,2,2780,0,2013
3052700432,490000,3,2.25,1500,1290,2,1220,280,2006
2025049203,399950,2,1,710,1157,2,710,0,1943
0952006823,380000,3,2.5,1260,900,2,940,320,2007
3832050760,270000,3,2.5,1870,5000,2,1870,0,2009
2767604724,505000,2,2.5,1430,1201,3,1430,0,2009
6632300207,385000,3,2.5,1520,1488,3,1520,0,2006
2767600688,414500,2,1.5,1210,1278,2,1020,190,2007
7570050450,347500,3,2.5,2540,4760,2,2540,0,2010
7430200100,1.2225e+006,4,3.5,4910,9444,1.5,3110,1800,2007
4140940150,572000,4,2.75,2770,3852,2,2770,0,2014
1931300412,475000,3,2.25,1190,1200,3,1190,0,2008
8672200110,1.088e+006,5,3.75,4170,8142,2,4170,0,2006
5087900040,350000,4,2.75,2500,5995,2,2500,0,2008
1972201967,520000,2,2.25,1530,981,3,1480,50,2006
7502800100,679950,5,2.75,3600,9437,2,3600,0,2014
0191100405,1.575e+006,4,3.25,3410,10125,2,3410,0,2007
8956200760,541800,4,2.5,3118,7866,2,3118,0,2014
7202300110,810000,4,3,3990,7838,2,3990,0,2003
0249000205,1.537e+006,5,3.75,4470,8088,2,4470,0,2008
5100403806,467000,3,2.5,1425,1179,3,1425,0,2008
0844000965,224000,3,1.75,1500,11968,1,1500,0,2014
7852140040,507250,3,2.5,2270,5536,2,2270,0,2003
9834201367,429000,3,2,1490,1126,3,1490,0,2014
3448900210,610685,4,2.5,2520,6023,2,2520,0,2014
7936000429,1.0075e+006,4,3.5,3510,7200,2,2600,910,2009
2997800021,475000,3,2.5,1310,1294,2,1180,130,2008
0263000018,360000,3,2.5,1530,1131,3,1530,0,2009
6600060120,400000,4,2.5,2310,5813,2,2310,0,2014
1523300141,402101,2,0.75,1020,1350,2,1020,0,2009
0291310100,400000,3,2.5,1600,2388,2,1600,0,2004
1523300157,325000,2,0.75,1020,1076,2,1020,0,2008
